################################################################################################################################
#             #     #     # #   #   #       #   #               #         #   #                       #         #   #   #       
# ##### # ### ##### # ### # # ### # # ##### # # ### ##### ####### ####### # # # ### ############# ### # ####### # # # # # ##### 
#   # # #   #           #   #   # # #   # #   #   #     #     #   #       # #   #   #    S      # # #   #   #   # # # # #   #   
### # # # # ################### # # ### # ####### # ### ### ### ### ############# ### ######### # # ##### # ##### # # ##### # ##
#   #   # # #         #       #   #     # #   #     #   #   #   # # #   #     #   #   # #     # #     #   #     # # #     # #   
# ######### # ####### # ### # ########### # # # ######### # # ### # # # # ### ##### ### # ##### # ##### ####### ### # ### # ### 
#   #     #         # #   # #   #       #   #   #       # # # #   #   # # # #     # #     #     # #   #     # #     # # #   #   
# ### ### ####### # # ### # # ### ### ### ####### ##### # # # # # ##### # # ##### # # ##### ##### # # ##### # ####### # ##### # 
# #   # #   #   # # #   # # # #   # #     #           # # # # # #     #   #     #   #     # #     # # #     # #         #   # # 
# # ### ### # # ### ### # # ### ### ####### ########### # ### ####### ##### ############# # # ##### # # ##### # # ####### # # ##
# #   #   # # # #   #   # # #   #   #     #   #         # #   #       #     #             # #   #   # # #       # #     # # #   
# ### # ### # # # ### ### # # ##### # ### ### # ######### # ### ##### ##### # ### # ### ### ### # ##### # ####### # ### # # ### 
# # # #   # # # #   #     #   #   #   #     # #       #   # # # #   #     # # # # #   # #   # # # #   #   #     # #   #   #   # 
# # # ### # ### # # ############# # ### ### # ####### ### # # # # # ##### # # # # ### # # ### # # # # ### # ### # ### ####### # 
#   #   # #     # #               # # # #   # #     #   # # #   # # #   #   #   # #   # #   #       #     # #   #   #   #     # 
### ### # ####### ### # ####### ### # # # ### ### # ### ### ##### # # # ### ### # # ####### ########### ### ##### # ##### ##### 
#     #   #       #   # #     #     #   #   #     # #   #   #     #   # #     # # #     # #           # #   #   # #   #   #     
# ### ### ### ### # ##### ### ##### ####### ####### ##### ### ########### ##### # ##### # ########### # # ### # ##### # ### ### 
# # # # #   #   # # #   # # # #   # #     #     #   #     #   #     #     # #   #     # # # #   #   # # #     #   #   # # # # # 
# # # # ### ### # # # # # # # # # ### ### ### ### ### ##### ### ### # ##### # ####### # # # # # # ### # ######### # ### # # # # 
#   #   #   #   # #   #     #   #     #   #   #   #   #   #     #   #     # # #     # #   #   # # #   #         # # #   #   # # 
##### ### ####### ##################### ### # # ### ##### ####### ####### # # ### # # ### ##### # # ######### ### ### ####### # 
#   #     #   #   #     # #   #         #   # #     #                       #   # # #   #         # #       #   #   #       # # 
# # # ##### # # # ##### # # # # ######### ### ############# ### # ### ##### ### ### ### ######### # ### ### ### ### ####### # # 
# # #     # # # #     # # # #   #         #   #   #     #   #   # #   #   #   #       # #       # #   # # #   #     #   #   #   
# # ##### # # # ### ### # # ##### ######### # # ### ### ### # ##### # # # # # ####### ### ##### ##### # # ### ### ### ### ##### 
# # #     # # #   #     # # #   #   #       #   #     #   # #   #   # # # # # #     #   #   # #   # # #   # #   #     #   #     
# # ### ### # ### ####### # # # ### ### ######### ####### # ##### ##### # # # # ####### ### # ### # # ##### ### # ##### ### ### 
# #   #   # #   #         # # #   #   #   #     # #   #   # #     #     #   #         #   #   #   # #   #   #   #       # #   # 
# ### ### # ### ### ####### # ### ### ### ##### # ### # ### # ##### ################# ### ### ##### ### # # # ### ####### ### # 
# #       # #   # # #   #   # # #   #   #       #   #   #   #     #       #   #   #         #   #   #   # #   #   #     #     # 
# # ####### # ### # # # # ### # ### ### # ######### ##### ####### ####### # # # # # ####### ### ### # ##### ##### # ### ####### 
# # #     # #   #   # # #   # #   #     #         #   #         #       # # # # # # #     #   #     #     #     # # # #   #   # 
### # ### # ### ##### # ### # ### ####### # ######### ####### ### ####### # ### # ### ### ### ##### ##### ##### # # # ### # # # 
#   #   #     #   #   #     #     #     # #         #       # #   #       #     #     # #   #     # #     #   #   # #   #   # # 
# ##### ######### # ############### ### ######### ######### # # # # ################### ### ##### # # ##### # # ### ### ##### ##
#   #   #   #     # #               # #           #       # # # # #   #   #   #     #   # #         #       #   #   #       #   
# # # ##### # ##### ### ### ######### ########### # # ##### # # # ### ### # # # # # # ### ######### ######### ### ### ##### ### 
# #   #     #   # # #   # # #     #     #         # #     # # # #   #       # # # # # # # #         #     #   #   #   #     #   
# ##### ### ### # # # ### # # ### ##### ##### ### # ##### # # # ### ####### ### # # # # # # ####### ##### # ### ### ### # # # ##
# #     # #   # #   #   #   # # #     #       #   #   # #   # # #     #   #     # #   #   #   #   #           #   # #   # # #   
# ####### ### # ####### ##### # ##### ######### # ### # ##### # ####### # # ##### # ### ##### # # ##### ##### ### # ### # # ### 
# #     # #   #   #   #     #       # #   #     #   # #       #   #     # # #   # #         # # #   # # #       #   #   # #   # 
# # ### # # ##### # # ##### ####### ### # ########### ### ### ### # ##### # ### # ### ##### # ##### # # # ##### ##### ####### # 
#   #   # #     #   # #     #     # #   # #         #   #   #   # # #   # #     #   # #   # #       #   #   #   #   #       # # 
##### ### ### ##### # # ######### # # ### # ####### ### ######### # # # # ####### # # # # ### ############# # ### ####### # # ##
#   # #       #   # # #       #   #   # # # #     # # # #     #   # # # #   #   # # # # #   #     #     #   #   #     #   # #   
# # # # ####### # ### ####### # ####### # # ##### # # # # ### # # # # ##### # # ### # # ### ####### ### # ##### ##### # ### ### 
# #   #       # #   # #     #   #   # #   # #     # # # # # #   # # #     # # #     # # #           #     #         #   # # #   
# ########### # ### # # ### ##### # # # ### # ##### # # # # ##### # # ##### # ######### ############# ##### ### ### ##### # # ##
#   # #   #   #   # #   #   #   # # # #     #     #   #   #       # #       #         #   #           #     #   #       #   #   
### # # # # ##### ####### ### # ### # ########### ### ########### # ####### ######### ### ##### ####### ####### # ##### ### ### 
#   #   # #     #         #   #     # #             #           # # #     #     #       #   #   #   #   #       #   #         # 
# ### ### ##### ########### ######### # ########### ### ##### # # # # ### ##### ########### # ### # # ### # # ##### ### ####### 
#   # # #     # #   #       #         # #         #     #   # #   # # # #     #   #         #     # #   # # # #     #   #       
### # # ### ### # # # ####### ##### ### # ####### ##### # # # ### # # # # ### ### # ######### ######### ### # # ### # # # ######
#   # #   #   # # # #       # #   # #   #       #       # #   #   #   # # #   #     #   # #   #       #   # # #   # # # #     # 
# ### ### ### # # ######### # ### # # ########### # ##### ############# ### ####### # # # # # # ##### ### # ##### ### ####### # 
# #   #     #     #     # #   #   # #   #   #     #     #     #       #   #     #   # # #   # # #   #     # #G  # #   #       # 
# # ### ########### # # # ##### ### ### # # # ######### ##### # ##### ### ##### ##### # ####### # ######### # # ### ### ####### 
# #         #       # #   #       # #   # # #   #           # # #     # #     #     # #     #   #   # #     # # #   #   #       
# ### ##### # ####### ##### ####### # ##### ### # ##### ##### # # ##### ##### # ### # ##### # ### # # # ##### ### ### ### ######
#     #   # #       #       #   #   #     #   # #   #   #   # # # #   #     # # #   # #   # # #   #   # #   #     # #   #       
##### # # # ####### ######### # # ####### ### ##### # ### # # # # # # # ### # ### ### ### # # # ####### ### ####### ### # ##### 
#   # # # # #     #     #     # #   #   # #         #     # # # # # # # #   #   #   #     # # #   # #     # # #       # # #   # 
# # # # # ### ######### ##### # ### # # # ######### ####### # ### # # # # ##### ### ####### # ### # # ### # # # ####### # # # # 
# # # # # #   # #     #     # # #   # # #         # #   #   #     # #   # #   #   # #   # #   #   #   #   #         #   # # # # 
### # # # # ### # # ####### # # # ##### ######### ### # ### ######### ##### ##### # # # # ##### ####### ### ##### ### ### # # # 
#     # # # #   # #   #   # # # #     #   #   # #     #   #   #     #     #     #   # #   #   #         #   #   # #   #   # #   
# ##### ### ### # ### # # # ### ##### # # # # # ######### # # ##### # ### ##### ##### ### # # ########### ### # ### ##### # ####
#       #   #   #   #   # # #   #   #   #   # #   #   #   # #   #   # # #       #     #   # # #       # #   # # #   #     # #   
# ####### ### ##### ##### # # # ### ######### # # # ### ### ### # ### # ######### ##### ### # # ### # # ### # # # ####### ### # 
# #     # # # #   # #     #   #           #   # #   #   #     #   #   # #   #         #     # # # # # #       # # #   #   #   # 
# # ### # # # ### # ############# ### ### # ####### # ##### # ##### ### # # # # ##### ####### # # # # # ##### # # ### # # # ### 
#   # #   #       #       #   #   #   #   #     #   #     # #   #   #     #   #     #       # #   # # # #   # # # #   # #   #   
# ### ######### ######### # # # ### ##### ##### # # ##### # # ### ########### ############# # ##### # ### # # ### # ####### ####
#   #   #   #   #   #   # # # # #   #         #   # # #   # # #   #         # #       #     # #     #     # #   # #   #   # #   
### # # # # # # # ### # # # ### # # # ####### ##### # # ### # # ### ####### ### ##### # ##### # ########### ### # ### # # # # # 
# #   #   # # # #     # # #   # # # #       #         # #   #   # #     # #     #     # #   #   #       #   # # #     # # #   # 
# ######### # # ####### # ### # # ################### # ##### ### ##### # ### ### ##### # # ########### # ### # ######### ##### 
#         #   #             #   #     #             # #     #       #   #   #   # #   #   #         # # # #         #     #   # 
######### ##### ##### ##### ### ### # # ########### # ##### # ### ### ##### ### # # # ############# # # # # ####### # ##### # # 
#     # #       #   # #         # # # #     #     # #   #   # #   #   #   # #   # # #         #     #   # #   #   #   #     # # 
# ### # ##### ### # # # ##### # # # ####### ### ### ### # ### # # # ##### # ##### # ######### # ##### ### ##### # # ### ##### # 
# # # # #   # #   #   #   #   #   #       #   #   #   # # #   # # # #     # #     #   #   # # # #       #       # #     #   # # 
# # # # # ### # ######### ############### ### ### ### # # ##### # # # ##### # ####### ### # # ### ##### ######### ####### # # # 
# # #   #   # #         #       #       #   # #     #   #   #   # #     #   #   #           #     #   #         # #     # #   # 
# # # ##### # ######### ##### # # ### ##### # # ### ### ### # # ##### ### ##### # ##### ####### ### ######### ### # ### # ##### 
#   # #   #       #     #   # # # # #     # # #   # #   #   # #   #   #   #     # #   #   #   #           # #     #   # # # #   
##### # ##### ### # ##### # # # # # ##### # # ##### # ### ### ### # ### ### ##### # # ##### # # ##### # # # ####### # ### # # ##
#     #       #   #   #   #   # # #   #   # #     # # #   #     #   # #     #   #   # #     # #   # # # #     #   # #   # # # # 
# ### ### ### # ##### # ######### ### # # # ##### # # # ##### ####### ####### # # ### # ##### ### # # # # ##### # # ### # # # # 
#   #     #   # #     # #       #   #   # #     # #   # #   # #     #   #   # #   #   # # #   #   #   # #   #   #   # #   #   # 
### ####### # ### ##### # ##### ### ############# # ### ### # # ### # # # # # ##### # # # # ### ####### # ### ####### ##### ### 
#   #     # # #   #   #   #   #     #       #   # #   # #   #   # #   # # # #   #   # # #   #   #       # #   #           #   # 
# ### ### # ### ### # ##### ######### ##### # # # ### # # ### ### ##### # # ### # ##### ##### ##### ##### # ### ### ##### ### # 
# #   # # # #   #   #     #   # #   # #   #   # # #   #   #           # # # #   # #   #   #   #     #     #   # # # #       #   
# # ### # ### ### ### ####### # # # # ### ##### ### ######### ##### # # ### # ##### # ### # # ### ########### # # # # ######### 
# #     #     #   # # #           # #   # #     #   #       # #     # # #   #   #   #   # # #   # #     #     # #   #   #       
# ############# ### # # ########### ### # # ##### ### # # # # # ##### # # ##### # ##### # ##### # # ### # ##### ######### ######
#         #   #     #     #       #   # #     #       # # #   # #   # #   #   # # #   #   #   # #   # #   #   #     #   #   #   
# ####### ### # ######### # ##### # ### ##### ########### ##### # ### ####### # # ### ##### # # # ### ####### ### ### # ### # # 
# #     #       #   #   # #   #   #   #     #   #         #     #   #         # #   #   #   #   #             #   #   #     # # 
# # ### ####### # # # # ##### # ##### ##### ### # # ####### # # ### # # ####### ### # # ######### ### ##### ### ### ######### ##
# # # #   #   # # #   #       # #   #     #   #   # #   #   # #   #   #   #     # # # #     #       #     # #       #     #     
# # # ### # # ### ############# # # ######### ####### # # ####### ##### ### # # # # # ##### # # ######### # # ####### ### # ### 
#   #     # #   #   #         #   #         #       # # #       # #         # #   #   #   # # #   #       #   #         #     # 
# ######### ### ### # ####### ##### ####### ##### # # # ##### ### # ### ##### ######### # # # ##### ####### ### # # ### ####### 
# #   #   #   # #   #       #       #     #     # #   #     # #   #   #   #   #   #     #   #   #   #       #   # #   # # #     
# # # # ##### # # ####### # ####### # ### ##### # ######### ### ### ### # # ### # # ############# ##### ##### ### ##### # # ####
#   # #   #   # #   #   # #   #   # # # #   #   # #       #   # #   #   # #     # #       #       #   #       #   #   # # # #   
# ### ### # ### ### # # ####### # # # # ### ### ### ##### # # # ##### ### ####### ####### # # ### # # ### ##### ### # # # # # # 
#   #     # # #     # #         #   # #   #   #     #   # # # #   #   #   #   # #       # # # #   # #   # #     #   #   # # # # 
# # ####### # ####### ############### # # ### # ##### # # ### ### # ####### # # ### ### # ### # ### ### # # ############# # # # 
# # #     # #               #         # #   # # #   # # # #   #   # #     # # #   #   # # #   # #   #   # #   #       # # #   # 
# # # ### # # ### ######### # ######### # # # ### # ### # # ### ### # ### # # ### ### ### # ##### ####### ### # ##### # # ##### 
# # #   # # #   #   #     # # #   #   # # # #     #   #     #   #   # # #   #   #   #     #   #   #     #   #   #     #         
# ##### # # # ##### # ##### # ### # # # # ########### ######### # ### # # ##### # # ######### # ### ### # ####### ############# 
# #     #   # #     # #     #   #   # # # #         #   #       #   # # # #   # # #   #     # #     #   #       # #         #   
# # ########### ##### ### # ### # ##### # # ### ### ### ##### ####### # # ### # # ### ##### # ####### ### ####### # ##### # ### 
# # #         #     #     # #   #     # #   # #   #   #     # #       # #     # #   # #   # #         #   #       # #   # #   # 
# # # ####### ########### ### ####### # ##### ### ######### ### ####### ####### ### # # # # ########### ### ####### ### # ### # 
# #   #     #       #     #   #     #   # #     #     #   # #   #     # #       # # # # #       #         # #     #   # # #   # 
# ##### ### ####### ####### ####### # ### # ### ##### ### # # ### # ### # ####### # # # ####### ######### # # ### ### # ### ### 
# #       #       #   #     #   #   #   #   #   #   # #   # #   # # #   #   #   #   # # # #   #         # # # #     # # #   #   
# # ##### ########### # ####### # ##### # ####### # # # ### ### # # # ##### # ####### # # # # ######### # # # # ##### # # ### ##
#       #           #                             # #     #       # #       #           #   #             #   #       #   #     
