################################################################################################################################
################################################################################################################################
#         #         #       #       #   #   #           #                 #   # #       #   #           #   #   #               
# ####### # ####### ####### # # ### # # # # ##### ### # ################# # # # # # ##### # # ##### ### ### # # # ### ####### # 
# #     # # #   # #     #     # # # # #   #     # #   # #   #             # # #   #       #   #   #   #   #   # # #   #   #   # 
# ##### # # # # # ##### ### ### # # # ######### ### ### # # ##### ####### # # # ############### # ### ### ##### # # ### # ##### 
#   #       # #     #   #   #   # # # #       #     # #   #     #       # # # # #     #     #   # #   #   #     # #     #   #   
# # ### ##### ##### # ### ### ### # # ####### ####### ######### ### ### ### # # ### # # ##### ### ##### ### ##### ######### # ##
# #   # #   # #   # # #     #     # # #       #     #         #   # #   #   # #     #   #   # # # #   #     #   # #         #   
##### ### # ### # # # ##### ####### # # ####### ### # ####### ### # ##### ### ######### # # # # # # # ####### # # # ############
#     #   #   # # #   #         #   #   #     #   #   # #   #   # #     # # #     #   #   #     # # # #     # #   #             
# ##### ##### ### # ### ####### # # ##### ### # # ### # # # ##### # ### # # ##### # # # ####### # # # # ### # ################# 
#   #   #   #     #   # #   #   # #       # # # #   #   # #      G#   # #   #   #   # # #     # #   # # # # #   #           # # 
### # ### # ######### ### # ##### ######### # # ### ##### ######### # ##### # ####### # # ### ######### # # ### # ##### # # # # 
#   # # # #     #   #     #     # #       #     #   #   # #     #   #       #         #     #           # #     #   # # # #   # 
##### # # ##### # ############# # # ##### # ######### # # ##### # ######### ########### ##### ########### ####### # # # ####### 
#     # #     # #     #         # #     #   #         # #   # # #     #   #       #         #                   # # # #   #   # 
# ##### ####### ##### # ########### ######### ######### ### # # ### ### # ####### # # ##### ##### ### ### ####### # # ### # # # 
# #   # #   #   #     # #   #       #   #     #     # # #   # #     #   #       #   #   #   #   #   #   # # #     # #     # #   
# # ### # ### ### ### # # # ##### ### # # ####### # # # # ### # ##### ######### ####### # ### # ### ### # # # ##### ####### ### 
# #   #   #   # #   # #   # #     #   #   #       #   # # #   # #   # #   #     #   #   #     # #   # # # # # #   #   #   # #   
# ### ### # ### # # ####### # # ### ########### ##### # # # # # # # # # # # ##### # # ### ##### ### # # # # # ### ### # # # ####
# #           # # # #     #   # #   #     #     #   # # # # # # # #   # # # #     # #   #     #   #   # #   # #   # #   # #     
# # ######### # # ### ### ##### # ##### # # ##### ### # # # ### # ####### # # ##### ### ####### # ##### ##### # ### ##### ##### 
# #     #   #     #   # # #     #       # # #   #     #   # #   #       # #   #     #   #     # #     #       #         #   #   
# ####### # # ##### ### # # ############# # # # ##### ##### # ######### # ##### ##### ### ### ### ### ##### ##### ####### # # ##
#         #             # #   #     #     #   # #   #   #             #   #     #     # # # #   #   #     #       #       # #   
############# ####### # # ### # # ### ########### # # # # ##### ##### ### ######### ### # # ### # # ##### ######### ####### ### 
#       #   # #   #   # #     # #     #           #   # #   #   #         #   #   #     #   #   # #     #         # #       #   
# ### ### # # # # ##### ####### ####### # ### ######### ### # ######### ### # # # ########### ### ####### ####### # ##### ### ##
# # # #   #   # #     # #     # #       # #   #       #     # #       #   # #   # #       #   #     #   #     #   #   #   # # # 
# # # # ####### ##### ### ### # ### # # # # ### ########### # # ##### ### # ##### # ##### # ######### # ####### ##### # ### # # 
# # #   #     #   # #     # # #   # # # # #   #           # # # # #   #   #     #   #   #   #   #     # #       # #   #     #   
# # ##### # ##### # ####### # ### # # # # ### ########### ### # # # ### ####### ##### # ##### # # ##### # ####### # ### ########
# # #     # #   # #       # #     # # # #   #       #     #   # #   #         #   #   # #     # # # #   # #         #           
# # # ##### # ### ### ### # ####### # ##### ### ##### ##### ### # ######### # ### ### ### ####### # # ### ##### ############### 
# # # #   #   #   #   #           # #     #   #   #   #   #   # # #         # #   #   #   #   #   # #   # #   # #       #       
# # # # ####### ### ### ####### # # ##### ### ##### ### ####### # ### ####### # ### # # ### # # ### ### ### # ### ##### # ######
#       #     #   # #   #       # #     #   # #   # #     #     # #   #   #         #   #   # # # #   #     #         # #     # 
# ### ### ### ### ### # # ####### ##### ### # # # # # ### # ##### # ##### # # ####### ### ### # # # ################### # ### # 
#   #   #   # #   #   # #   # #   #     #   #   #   # # # # #     #       # #   #   #   # #   # # #     #     #     #   # # # # 
# # ####### # # ### ### ### # # ### ##### # ######### # # # ### ########### ##### # # # # ##### # ##### ### # # ### # ### # # # 
# #   #   # #   # # #   #   # #   #   #   #         #   # #   #           # #   # #   #   #     #           # #   # #   #   # # 
# ### # # # ##### # # ### ### ### # ### ### ##### # ### # ### ########### ### # ### ##### # ################# ### ##### # ### # 
# #   # #   #   # # # #   # # #   # #   #     #   #     #   #         #   #   # #   #   # # #       #   #   #   #   #   #   #   
# ##### ##### # # # ### ### # # ##### ### ##### ### ##### ########### # ### ### # # # # # # # ##### # # # # ### ### # ### ######
# #   #       # #   #   #   # #       #   #     #       #   #       # #     # #   # # # # #   # #   # #   #       #   #   #   # 
# # # ######### ### # ### ### ######### ### ########### ### # ### ### ####### ##### # # ####### # ### ####### ### ##### ### # # 
# # # #   #   #   # #   #   # #     #   #   #         #   #   #   #   # #     #     # #     #     #   #       #   #     # # #   
# # # ### # ##### ### # ### # # ### ### # # # ####### ######### ### ### # ##### ##### ### ### ##### ### # # ### # # ### # # ### 
#   #     #     #   # # #   # # # #     # # # #   #   #     #   #   #   #     # #   # #   #   #     #   # # #   #   #   #   # # 
# ######### ### ### ### # # # # # ### ### # # # # # ### ### # # # ##### ##### # # ### # # # ### ### ##### # # ####### ####### # 
#       #   #   # #   # # # # #   #   #   # # # # #   #   # # # # #                 # # # # # # #   #   # # # # #   # #       # 
# ##### # ### ### ### # ### # ##### ### ##### # # ### ### ### # # # ############# # # # ### # # # ### # # # # # # ### # # ##### 
# #   #   #   #   #   #   # # #   #   #   #   # #   #   #     # # #       #     # # # #     # # #   # #   # # #   #   # #     # 
# # # ##### ### ### ##### # # # # # # ### # ### ### ### ######### ####### # ### # # # ####### # ### # ##### # # ### ### ##### # 
# # # #   #   # #   #   # #     # # # # # #     #   # #   #     # #   #   # #   # # # #     #   #   # #     # #   # #   #   #   
# # # # # ### # # ### # # ####### # # # # ####### ### ### # ### # # # ##### # ### # # ##### ##### ### ##### # ### # # ### ######
#   #   #   # # # #   # #   #       # # #       #   #   #   #   # # #       # #   # #     # #   #   #   #   #   #   # # #   #   
# ######### # # # ##### ### ####### # # ####### ### # ####### ##### ######### # ######### # # # ### ### ### ### ##### # # # # # 
#       #   # # #     #   #       # #   #       #   # #     #       # #     # # #         #   #     # # #   # #           #   # 
####### # ### # ##### ### ####### # ##### ####### ### # ### ######### # ##### # # ################### # # # # ################# 
#       #   #   #   #   #         # #   # #   #   #     #           #   #   # # #     #         #   #   # # #       #   #   #   
# ######### # ##### ### ########### ### # # # # ######### ######### ### # # # # ##### # ##### # # # ##### # # ####### # # # ### 
#   #       #       # #       #         #   # #     #     #   #   #     # #   # #   # # #   # #   # #     # # #     # #   #   # 
### # ####### ####### ####### # ### ######### ##### # ##### # # # ##### # ##### # # # ### # ####### ### # # # # ### ######### ##
# # # #   #           #       #   #         #   #   # #     # # # #     # #       #   #   #   #   #     # #   #   #         #   
# # # ### ####### ##### ######### # ############# # ### ##### ### # ### # ##### ####### ##### # # ##### # ####### ##### ####### 
#   #     #     # #     #       # #   #   #     # # #   # #   #   #   #   #   #       # #     # # #     #       #   #   #       
# ######### ### # # ##### ### # # ##### # # ### # ### ### # ### ####### ### # # ##### # # ##### # # # ############# # ### ######
#           # # # #     # #   # #   #   #   # #   #   #   # #   #     #     #       #   #     # #   #     # #       #     # #   
# ########### # # ##### # # ### ### # ####### ### # ##### # # ### ### ####### ############### # ####### # # # ############# # ##
#     #     #   # #     # #   #     #   #     #   #       #   #     #           #       #   # #       # # # # #       # #   #   
# ### # ########### ######### ### ##### ##### # # ####### ##### ############# # # ##### ### # # ####### # # # # ##### # # # ### 
#   #     #       # #         #   #     #   #   #   #     #   # #         #   #   #   #   # # # #       #   #   #   # # # # #   
# # ##### # ##### # ####### ####### ##### # ####### # ##### ### # # ##### # # ##### ##### # # # # ################# # # # ### ##
# #     # # #   # #     #   #   #   #   # #   #   # #   #   #   # # #   #   # #   #       #   # #        S          # #         
# ##### ### # ### ##### ##### # # ### # ##### # # ##### # ### # # ### # ##### # # ######### ######################### ######### 
# #   # #   # #       #       # #   # #     #   # #   # #     # #   # #     # # #       #   #     #     #             #       # 
# # ### # ### # # ### ######### ##### ##### ##### # # # ####### ### # ##### # # ####### ### # ### # ### # ############# ##### # 
# #     # #   # #   #   #     # #   # #   #     # # # # #       #   #   #   # #       #   # #   # # # #   #   # #       #     # 
# ####### ### # ### # ### ### # # # # # # ##### # ### # ######### # ### ### # ########### # ### # # # ##### # # # ############# 
#       #   # # # # # #   #   #   # #   # #   # #   # # #       # #   #   # # #     #     #   # # #         # #   #       #   # 
# ##### ### # # # # ### ### ####### ##### ### # ### # # # ##### # ####### # # # ##### ######### # ########### # ### ##### # # # 
# #   # #     # # # #   # #       # #     #   # #   # #   #     # #   #   # #   #   # # #       #             #     #   #   # # 
# # ### # ##### # # # ### ####### # ####### ### # ### ##### ####### # ##### # ### # # # # ########################### # ##### # 
# #     # # #   #   # #         #   #   #       #               #   #       #     # # # #   #     #     #     #     # #         
# ####### # # ####### # ####### ##### # # ####### ##### ####### # ########### ##### # # ### # ### ### # # ### # ### ########### 
# #     # # # #       # #     #     # #   #       #   #   #   # # #     #         #     #   # #   #   # # # #   # #         #   
# # ### # # # # ####### # ### # # ### ##### ### # # # ##### # # # ##### # ####### ### ### ### # ### ### # # ##### ######### # ##
# # # #   # #   #   #   # #   # # #   #     #   #   #       # #   #             #   #   #   # #     # # # #       #       # #   
# # # ##### ##### # # ### # ### # # ### ### ################# # ### ##### ######### ####### # ####### # # # ####### ####### ### 
# # #         #   # # # # # #   # # #     # #   #           # #     #   #   #     #     # #   #   #     # #       #     #   #   
# # ##### ### # ### # # # # ### # # ### # ### # # ######### # # ### # # ### # ### # ### # ####### # ##### ### ### ##### # ##### 
# #       #   # #   #   # #     # #   # #   # #   #       # # #   # # #   #   #   #   #       #   # #   # #   #   #   #   #   # 
# ######### ### # ##### # ##### ##### # ### # ######### ### # ### ### ### ##### ############### ### # # # ##### # # # ##### # # 
# #   #     #   #     # #     # #       #   #         # #   # #   #   # #     #                 #   # #   #   # #   #       # # 
# # # # ##### ####### # ##### # # ################### # # ### ##### ### ##### # ##### ########### ### ##### # ############### # 
#   # # # #     #   # #     # # # #         #   # #     # #         #     #   # #   #       #   #   # #   # #           #     # 
##### # # # ##### # ####### # ### # ####### # # # # ##### # # ########### # ### # # # ####### # ### # # # ############# # ##### 
#     # #     #   # #   #   #     # #   #   # #   #   #   # #             #   # # # # #       # #   #   #     #       # # #   # 
# ##### # ##### ##### ### ######### ### # ### ### ### # ####### ##### ### ### # # # ### ####### # ########### # ####### # ### # 
#   #   #   #   #         #       #   #   #   #   # # # #     # #   #   #   # # # #     #     # #     #       #         # #   # 
### # ##### # ### ##### ### ##### ### # ### ### # # # ### ### # # ##### ##### ### ####### ### # ##### # ### ### ######### # ### 
# # # #           #     #   #   # #   # #   #   #       # # # #   #   # #   #   #   #   # #   #       #   #                   # 
# # # ############# ### # ##### # # ### ##### # ####### # # # ##### # ### # ### ### ### # # ########### # ########### # # ### # 
#   #   #     #   #   # # #     # # # #   #   # #       # # #       #     #   #     #   # #           # #   #   #   # # # #   # 
# ##### # ### # # ### # # # ##### # # ### # ### # ##### # # ################# # ##### ### ########### # ### # # # ### # # # ### 
# #   #   # #   #     # #   #   #   #   #   # # # # #   # # #       #         #       #   #   #       # # # # # #     # # #     
# # # ##### ########### ##### ######### ##### # # # # ### # # # ### # ######### # ##### ### # ####### # # # # # ######### ##### 
#   #   #     #             #                   # #     #   # # #   #       #   #     #   # #   #     #   # # #   #       #   # 
# ####### ##### ############### # ##### ######### ### # ##### # # ######### # # ### # # # # ### # # ##### # # ### # ####### # # 
# #     #     # # #   # #     # # #   #   # #     # # #       # #     #   # # # #   #   # # # # # #   # # #     # # #     # # # 
# # ### ##### # # # # # # ##### # # # ### # # ##### # # ####### ##### # # # # # ##### ### # # # ### # # # ####### # # ### # # # 
# # # #     # # #   # # # #     #   # #   # # #     # #     #   #     # #   # #   #     #   # #   # #   # #   #   #   #   # # # 
# # # ##### # # ##### # # ### ####### # ### # ### ### ##### ########### ######### # # ####### ### # ##### # ### ##### # ##### # 
# # #       # #     # # # #   #       #     #   # #   #   # #           #         # #           # #     # #   # #   # #       # 
# # # ####### ##### # # # # # # # ############# # # # ### # # ########### # ####### ####### ### # ####### ### # # # ########### 
# # #   #     #     # # # # # # # #     #   # # # # #     # #   #   #   # #   #   # #     # #   #       #   # #   #   #         
# # ### # ##### ##### # # # # # ### # # ### # # # # ### ### ### # # # # ### # # ### # ##### ########### ### # ####### ####### # 
#   #   #     # #     # # # # # #   # #   #   # # #   #   #   # # # # #   # # # #   #     #       # #   #   # #     # #   #   # 
##### ####### # ### ### # # # # # ### ### ### # # ### # ##### # ### # ### # # # # ####### ##### # # # ### ### # ##### # # # ### 
# #   #   #   #   # #   # # # #   # #   # #   # #     # #   #   #   # # # # # #   #             #   # #   #       #   # # #   # 
# # ### ### ##### # # # # # # ##### ### # # ### ######### # ##### ### # # ### ####### ########### ### # ### ####### ### # ### # 
# # # #   # #   # #   # #   #         # #     #     #   # #   #   #   #   #   # #     # #       #   #         #   # # # #   # # 
# # # ### # # ### ##### ######### ### # ########### # # # # ### ### ####### ### # # ### # ##### ############### # # # # ##### # 
#                                 #   #           #   #   #     #           #     #     #     #                 #   #         # 
################################################################################################################################
