################################################################################################################################
################################################################################################################################
     #         #   #       #       #   #   #             # #     #       #   #     # #                   #         #     #     #
 # # # # ### # ### # ##### # ##### # # # # # ####### ### # # ### ##### # # # # ### # # ####### # ####### # # ### # # ### ### # #
 # # # #   # #         # # #   #   # # # #     #   #   #   # #   #   # # # #   # #   # #       # #     #   #   # # # # #   # # #
 # # # ##### ######### # # ### ##### # ####### # # # # ##### ##### # # # # ##### ##### # ##### # # ### ####### # # # # ### ### #
 # #     #   #   #   # # # #   #   # #     #   # # # # #   #     # #   # # #   #       #   #   #   #   #   #   # #   #       # #
## ### # # ### ### # # # # # ### # # ##### ### # # ### # # ##### ####### # # # ####### ### # ####### ### # # ### # ######### # #
   #   # # #   #   # # # #   #   #   #   #   # # #   #   #     #         #   #         #   #       #     # #   # # #   #   #   #
 ### ##### # ### ### # # ##### ####### ##### # # ### # ##### # ######### ################# ##### # ####### ##### # # # # # ### #
 #   #   #     # #   #   #     #           #   #   # #   #   #     #   # # #     # #     #   #   #       # #     # # # # # #   #
 # # # # ####### # ##### # ####### ##### ##### ### # ### # ######### # # # # ### # # ### ##### # ######### # ####### # # # # # #
 # # # #   #     #     #   #     # #   # #   # # # #   # #     #     #   # #   # # #   #       # #   #   # #       # # # #   # #
 # ### ### # ######### ##### ### ### # # # # # # # ### ####### # ######### ### # # ### ######### # # # # # ####### # # # ##### #
 #   #   # #   #   # # #     #   #   #   # # #   # # #       # #     #       # # # #   #       # # # # #         # # # # #   # #
 ### ### # ### # # # # # ### # ### ### ### # ### # # ####### ####### # ##### # # # # ### # ### # # # # ##### ### # # # # # # # #
   # #   #   #   # # # #   # #     #   #   #     #   # #     #     #   #     # #   # # # # # #   # # #     #   # # # # # # #   #
 # # # ### # ##### # # ##### ####### # # ############# # ##### ######### ##### ##### # # # # ### # ####### ### # # ### # ### ###
 # #   # # #   #   # #     #   #     # # #           #         #         #     #   # #   # #   # # #       #   # #     #   # # #
## # ### # ##### ### ##### ##### ##### # # ### ##### ### ##### # ######### ##### # # ### # ### # # # ############### ##### # # #
   #     # #     #   #   # #   #     # #   #   #   #     #   # #       # #   #   #   #   #   #   #   #   #     #   # #   # #   #
 ### # ### # ##### ### # # # # ####### ##### ### # ####### # # ####### # ### # ####### # ### ### ##### ### ### # # ### # # ### #
 #   #   # #     # #   # #   #       #       #   #   #     #       # # #   #   #     # #   # #       #   #   # # # #   # #   # #
 # ####### ##### # # ### ########### # ####### ##### # ######### # # # # # ##### ##### ##### ### ### # # ### # # # # ### ##### #
 #   #   #   #   #     #           # # #     # #     #         # # # # # # #   #       #     #   #   # # #   #   #   #   #   # #
 ### # # # ### ### ######### # ##### ### ### # ##### ### ####### # # # # # # # ##### ### ##### ### ### # # ########### ### # # #
   #   # #   #   # # #     # # #   #   # #   # #   #   # #       #   # # #   #       #   # #     # #   # # #   #   #       #   #
## # ####### ### # # # ### ### # # ### # # ### # # ### ### ####### ### ####### ####### ### # # # ### ##### # # # # ########### #
 # #   #   #   # #   # #   #   # #   #   # #   # # #       #   #   #   #     # #       # #   # # #   #     # #   #   # #     # #
 # # # # ##### # ### # ##### ### ### ##### # # # # # ####### # # ### ### ### # # ####### ### ### # ### ############# # # ### # #
   # # #       # #   #     # #   #       # # # # # # #     # # #   #     #     #   #         #   #   #               # #   #   #
#### # ######### ### ##### # # ### ####### # ### # # # ##### # ### ####### ####### ### ### ### ##### ################# ### #####
   # # #       #   #   # # # # #   #       #   # # # #   #   #   # #       #S    #   #   #   #     #   #         #   #         #
## # # # ##### ### ### # # # # # ### ####### # # # ##### # ##### # # ##### # ### ### ### ####### # ### # ####### ### # #########
   # #   #   #   # #       # # # #   #       # # #     #   #     #   # #   # # #     #   #       # #   # #       #   # #       #
 ### # ### # ### # ##### ### ### # ### ####### # ### # ##### ######### # ### # ####### # # ####### # ### # ####### ### # ##### #
 #   #   # #   # # #   #   #     # #   #     #   # # #   #   # #     #   #   #         # # #   #   # #   # #       #   # #     #
 # ### # # ##### # # # # # ####### # # # ### ##### # # # # ### # # # # ### ######### # # # # # ##### # ### ##### ### ### ### ###
 #   # # #       #   # # #   #     # # #   #   #   # # # #   #   # #   #   #   #     # # # # # #    G#   #     #       #   # # #
 ### # ################# ### # ##### # ### # ### ### # # ### ### # ### # ##### # ### # ### # # # ####### ##### ### ####### # # #
 #   #   #   #   #   #   # #   # #   #     #     # # # #   #   # # # # # # #   # #   #   #   #         #     #     #     # # # #
 # ##### # # # # # ### ### ##### # # ############# # ######### # # # # # # # ### # ##### ######################### # ##### # # #
 # #     # #   # # #   #           #       #       #   #       # # #   # # #     #     #   #   #   #           #   # #   # # # #
 # # # ### ##### # # ############### # ### # ######### # ######### ### # # ####### ### ##### # # # # ### ##### # # # # # # # # #
 # # #   #   #   #   #               # # #   #       # # #         #   # #           #   #   # # #   # # #   #   # #   #   #   #
 # # ### ### # ### ### # ############# # ##### ##### # # # ########### # ##### ### ####### ### # ##### # # # ##### ########### #
   # #   #   # #   #   # #     #   # #       # #   # #   # #     #     #     #   #     #   #     #       # #     #   #       # #
###### ### ### # ### ### # ##### # # # ####### # # # ##### # ### # ######### ### ##### # ################# ##### # # # ####### #
     # #   #   #   #   #   # #   # # #   #     # #   #   # #   # #   #   # # #   #     #       #     #   # #   #   #     #   # #
 ### ### ### ##### ### ##### # ### # ### # ##### ##### ### ### # ### ### # # ##### ########### ##### # # # # ########### # # # #
 #     # #     #     #       # # # #   # # #   #     #   #     #   #     # #   #     #       # #     # #   #   #       # # # # #
 ##### # ##### ##### ####### # # # ### # # # # ##### # # ######### # ##### ### ### # # # ### # # ##### ### ### # ##### # # # # #
 #   # #     #   # #     #   # # #   #   # # #     # # # #   #   # #     # # #   # #   #   # # # #   #   #   # #   #   #   # # #
 # # # ######### # ##### ##### # ### ##### # ####### # # # ### # # # # ### # ### ######### ### # ### ### ##### ##### ### ##### #
 # # # #     #   #     # #   # #   # #   # #     #   # # #     #   # #   # #   #   #     #   # #     # #       #     #   #   # #
 # # # # ### # ##### ### # # # # ### # # # ##### # ### ############# ### # ### ### # ####### # ##### # ######### ##### # # # # #
 # # # # #   # #   #     # # # #   # # #   # #   # #       #           #       # # #         #   # # #       #   # #   # # #   #
 # # # # # ### # # # ####### ### # # # ##### # ### # ####### ### # ######### ### # ########### # # # ### ##### ### # # ### #####
   # # # #     # # # #     # #   #   # #     # # # #   #     #   #     #   #     #   #       # #   #   #   #   #     #     #   #
#### # # ######### # # ### # # ####### # ##### # # ### # ####### ##### # # ##### ### # ##### # ### ### ### # ######### ##### # #
     # #     # #   # #   #   # #     # #     # # # #     #       #     # #     #   # # #   # #   #   #   # #         #   #   # #
 ##### ##### # # ### # # ### # # ### # ##### # # # ########### ### ##### ##### ##### # # ### ### # # ### # ######### # # # ### #
     # #               #   #     #   #   #   #   #       #   # #   #         # #   # # #         # #   # #     #   # # #   #   #
###### # ### ######### ### ### ### ##### # ### ######### # # ### ### ######### # # # # ######### ##### # # # ### # # # ####### #
           # # #     #   #   #   #       #     #   #   # # #   #   #   #   #   # # # #   #   #   #   # # # # #   # # #       # #
 ######### # # # ### # # ### ####### ##### ##### # # # # # ### ##### ### # # ### # # ### # # ##### # ### # ### ##### ##### # ###
 #       # #   #   # # #   # #     #         # # #   # #     #       #   #   #   #     #   # #     #     #         #     # #   #
 # ##### # ######### ####### # ### ##### ### # # ##################### ####### # ########### # ################# # ##### # ### #
 # #     #         # #     # # # #     #   #   #       #     #   #   # #       #         # #   #   #     #     # # #   # #   # #
 # # ######### ### # # ### # # # ##### ### # ######### # ### # # # # # # ##### ######### # ####### # ##### ### # # # ### ### ###
   #     #   #   # #   #   #   #   #   #   #   #   #   #   #   #   #   # #     #       #   #     # #     # #   # # #   #   #   #
 ####### # # ### # ##### ### ##### # ######### # # # ##### ############### ### # ##### ##### ### # ### # ### ### # ### ### ### #
       # # #   # #       #   #     #         #   # #       #     #   #     #   # #   # #       # #   # #     #   #     #   #   #
 ##### ### ### # ########### # ############# ### # ######### ### # # ### ### # # # # # # ##### # ### # ####### ######### ### ###
 #   #   # # # #   #   #   #   #   #   #   #   # # #   #     # # # # #   #   # #   # # # #   # #           #       #   # #     #
 # # ### # # # # ### # # # ##### # # # # ##### # # # # # ##### # # ### ### # ####### # # # ### ####### ##### ##### # # # ##### #
   #   # #   # # #   #   #   #   #   # # #   # # # # # #     # # #     #   #       # #   #   # #     #     # #     # # # #   # #
###### # ##### ### ######### # ####### # # ### # # ### ##### # # ####### # ####### # ####### # # ### # ### # # ##### # # # # # #
 #     #       #   #   #     #   #   # # #     # #   #     # # # #     # #   #     #   #     #   # # #   #   #     # # #   # # #
 # ############# ### # # ####### # # # # ####### ### ##### # # # # ### # ##### ####### # ######### # # # ######### # # ##### # #
     #     #   # #   # #   #     # # # # #       # #     #   # #   # # # #   #       # #         # # # #       #   # #   #   # #
#### # ### # # # # ### ### # ### # ### # # ### # # # # # ##### ##### # ### # ### ### # ######### # # # ####### # ### # ### ### #
   #   #   # #   # # # # # # #   # #   # # #   #   # # # #           # #   #   #   # # #     #   #   # #     # #   # #   #   # #
 # ##### ### ##### # # # # # # ### # ### # # # ##### ### # ######### # # ##### ### # # # ### # ######### ### ##### # ### ### # #
 #     # # #     #   #   # # # #   # #   # # #     #   #   #     #   # # #     # # # #   #   #       #   # # #   # # # #     # #
 ##### # # ### ##### ##### # ### ### # ### # # # ##### ##### ### ##### # ####### # # ##### ### # ##### ### # # ### # # ####### #
   #         # #   #   #   #     #   #     # # # #   # #   # # #       #       #   #   #   #   # #     # #   #     # #     #   #
#### ##### ### # # ### # ######### ######### # # # # # # # # # ############### ##### # # ### # ### ##### ######### # # # # # # #
       #   #   # #   #   #         #   #   # # #   # #   #   #       #       #     # #   # # # #   #           #   # # # #   # #
 # # # ##### ### ### ##### ######### ### # # ####### ######### ##### # ########### # ##### # ### ##### ####### # ### # # ##### #
 # # #       #   # # #   # #         #   # #   #             #   # # # #   #   #   #   #     #   #     #   # # # #   # #   #   #
 ### ######### ### # # # # # ######### ### ### # ### # # ####### # # # # # # # # ##### # ##### ######### # # # # # ######### ###
   #         # #   #   #   #   #   #   # # #   # #   # #       # #   #   #   # #     #     #   #     #   #       #         #   #
## ######### # # # ########### # ### ### # # ### # # # ### ### # ##### ############# ##### # ### ### ####### ############# ### #
 #         #   # # #     #     # #   #   #   # # # # #   #   #   #                 #     # #     #       #   #           #     #
 # ############# # ### # # ##### # ### ####### # # ##### ##### ####### ################# # ############# ##### ######### ##### #
 #     #     #   #     # # #   # #   #       # # #     #     # #     #           #       #       #     # #   #     #   #   #   #
 ##### # ### # # ####### # ### # ### ####### # # ##### ##### # ##### ####### ##### ############### ### # # # ##### # # ### # # #
 #   # # #   # #     # #         #   #       # # # #       # #     #   #     #   # #             # #   #   # #   # # # # # # # #
 # ### ### ######### # ### ##### # # # ####### # # # ####### # ### ### # ##### # # ### # # ##### # # ####### # # # # # # # ### #
 # #   #   #     #   #   # #   # # # #   # #   # #   #       #   #     #     # #   #   # # #     # # #     #   #   # #   #   # #
 # # ### ####### ##### # # # # ### ##### # # ### # ### ####### # ########### # ##### ##### # ##### # # # # # ########### ### # #
 # #   #     #       # #   # #   #       # #     # #   #       #             #   #   #   # # #   # # # # # # #         #       #
 # ### ##### # ### # # ##### ### ######### ####### # ### ##### # ##### # ####### ### # # # # # # # # ### # ### ####### ####### #
     #     # #   # #   #   #   #           #       # # # #     # #     # #     # #   # #   #   # # #     #     #     #         #
#### ### ### # # ####### # ### ############# ##### # # # # ##### ### ##### ### # # ### ######### # ############### ########### #
   # # # #   # #   #     # # #       #     # #     # #   #   #     # #     # #   # # # #       # #       #   #   # #   #   #   #
 ### # # # ### ### # ##### # ####### # # # # ##### # ####### ### # # # ##### ##### # # ####### # ####### # # ### # # # # # # ###
     # #   #   #   #     #       #   # # # #     # #       #   # # # # #   #         #       # #         # #     #   # # # #   #
 ##### ##### ########### ####### # ### # # ##### ######### ### # # ### # # ####### ######### # ########### ########### # # ### #
     #           #     # #     # #   # # #     #     #   #   # # #   #   #     #   #   #     # #           #           # #   # #
#### # # # ##### # ##### ### # # ### ### ##### # ### ### ### # ##### ######### # ### ### ##### # # ####### # ########### # # # #
 #   # # #   #   # #   #   # #     #   # # #   #   #     #   #     # #         #   #     #   #   #       # #       #   # # # # #
 # ### # ##### # # # # ### # ##### ### # # # ############# ### ### # # ################### # # ######### # # ##### # ### # ### #
 #   # #   #   # #   #     # # #     #   # # #       #     #     # #   # #   #       # #   # #   #     # #   #   #   #   #   # #
 ### # # # # ### ########### # # ### ##### # # # ### # ##### # ### # ### # ### ##### # # ####### ##### # ##### # ##### ##### # #
     # # # #   #       #     # #   # #     # # #   #   #     #   # #       #   #     # # # #   #       # #     #     # #   # # #
 ####### # ### # ##### # ### # ### # ### ### # ### ####### ##### # # ### ### ### ##### # # # # ####### # # ####### # # # # # # #
         #   # # #   #   #   # #   #   # #   # #   #   #   #     # #   #   #   #   # #     # #   #   # #   # #   # # # # # # # #
########## # # ### # ##### ### # ##### # # ##### ##### # ### ##### ### ### ####### # # ##### # # ### # ##### # # ### # # # # # #
   #   #   # #     #     #   # #     #   # #     #   # # #   #   #   #   #   #     #         # #     #       # #     # # # #   #
 # # # # ### ############### # ####### ### # # ### # # ### ### # ### # # ##### ####### ####### ############# # ####### # # #####
 #   #   #       #     #   #   #       #   # # #   #   #   #   # #   # #     #       #   #     #             # #       # #   # #
 ######### ####### ##### # ##### ##### # ### # # ####### # # ### # ### ##### ####### # ### ##### ############# # ########### # #
 #         #   #   # #   #     #     # #   # # # #       # # #   # #   #       #   # #   #   #   #     #   # #   #   #     # # #
 # ######### # # ### # ####### ##### # ### ### # ### ##### # ##### # ### ####### # # # # ##### ### ### # # # ##### # # # ### # #
 #           #       #       #       #         #     #     #       #   #         #     #             #   #         #   #       #
################################################################################################################################
