################################################################################################################################
#   #     # #         #       #   #         #   #                           #   #   #   #     #         #       #     #   #     
### # ### # # ##### ### ##### # # ### ##### # # ##### ############### ##### # # # # # # # ### # ####### # ##### ##### # ### ### 
#   # # # #       #     # #   # # #   #   #   #     #       #   #   # #   #   # # # # #   #   # #S  #   # #   #   #   #     #   
# ### # # ####### ####### # ##### # ##### ######### ####### # # # # # ### ##### ### # ##### ### ### # ##### # ### ### ####### ##
# # # # #     # # #       #       #     # #         # #   #   # # # #         #     #     #   #     #       #   #             # 
# # # # ##### # # # ##### ############# # # ######### # # ##### # # ####### # ########### ######### ########### ######### ##### 
# # #     # # #   # #   # #   #     #   # # #       #   #   #   # #     #   #             #     #   # #   #   #         # #   # 
# # ##### # # # ### # # # ### # ### ##### # # ##### # ##### # ### ##### # ### ####### ### # ### # ### # # # ########### # # # # 
# #     # # # # #     # # #   #   #       #   #   # # #   # # # #     # # # #     # #   # #   # # #   # # #   #       # # # # # 
# ##### # # # # ####### ### # ### ### ######### ### # # ### # # ####### # # # # # # ### ####### # # ### # ### # # ##### # # # # 
# #   #   #   #   #         #   # # #         #   # #   #   # #   #   # # #   # # # # #         # #     #       #   #   #   # # 
# # # # ######### # ########### # # ######### # # # # ### ### ### # # # # ##### # # # ########### # ############### # ####### # 
#   #           # # #         # #     # #   #   # # #   #       # # #   # #     #   #   #   #   # #   #   #   #   # # #     # # 
##### ##### # # # ### ####### # ##### # # # ##### # # # ####### # # ##### ####### ##### # ### # # ### # # # # # # ### # ### # # 
#     #   # # # #   # #     # #   # # # # # #   #   # #       #   # #   #   #   #     #   #   #   # # # # # #   #     #   # # # 
# ##### # ### ##### # # ### # # # # # # # # ### ##### ####### ### # # ##### # # ##### ### # ####### # ### # ########### # ### # 
#   #   #   # #   # #   #   #   #   # # # #   # #   #   #   #   # # #     #   #     # #   #     #   # #   #   #   #   # #   # # 
### # ##### # # # # ######### ##### # # # ### # # # ### ### ### # # ##### ######### # # ####### # # # # ##### # # ### # ### # # 
#   # #     # # # #         #     # # #   #   # # #   #   #   # # #   #   #         #   #     # # # # #   # #   #   # #   #   # 
### # ####### # # ######### # ### ### ##### ### ### ##### # ### # ### # ### ##### ####### ### # # # # # # # ####### # ### ##### 
#   #   # #   # #         # # # #   # # #   # # #   #     # #   #   # # #   #     #       # #   # #     #         # #   #     # 
# # ### # # # # ### ####### # # ### # # # ### # # # # ##### # ####### # # ### ### # ####### ##### ########### ##### ### ##### # 
# #   # #   # #   #         # #   # # #     #   # # # # #   # #       #   # #   # # #     # #               # #   #     #   #   
# ### # ##### # ######### ### ### # # # ### # ##### # # # ### # ########### ### ### # ### # # ############# ### # ####### ##### 
#   # #     # # #       #   # #   #   #   #         # #   # # #           #     #   # # #   #   #   #     #     # #   #     #   
##### ##### # # # ##### # # # # # ##### # ####### # # # ### # ########### ####### ### # ####### # # # ### ####### ### # ### # ##
# #   #   # #   # #   # # # # # # #   # #       # # # #     #             #   #   # # #       #   # # #   #     #   # # #   # # 
# # ### # # ##### # ### # ### ### # # # ####### # ### # ################### # # ### # ####### ##### # ##### ### ### # # ##### # 
#       # #       #     #       # # #       #   #     #     #     #     #   #   #   #       # #       #   # # #     #   #   #   
####### # ######### ########### # ### ##### # ##### ### ### # # # # ### # ####### # ####### # # ####### # # # ######### # # ### 
#     # # #       # #         # # #   #   # # #   #       #   # # #   # #   #     #     #   # # #       #   #         # # #   # 
# ### # ### # # # # ##### ### # # # ### # # # # # # ##### ##### ##### # ### ##### ##### # ### # ############# ####### # # # ### 
# # # #     # # # #   #   #   #         # # #   # #     #     #   #   #   #     # #   #       # #         # # #   #       # #   
# # # ### ### # # ### # ### ############# # ##### # ### ##### ### # ##### ##### ### # # # ### # # ####### # # # # ##### ### # ##
#   #   # #   # #   # # #   # #   #       #     # # #   #   # #   #   # #     #   # #   # #   # #   # #   # # # #     # #   # # 
####### # # ### ### # # # ### # # ######### # # # ### ### ### # ##### # ##### ### # ####### # # ### # # ### # # ##### # ##### # 
#       # # # #   # #   #     # #   #   #   # # # #   #       #     # #     #     # #       # #     # # #     #     # #     # # 
# ####### # # ### # ####### ### ### # # ####### # # ### ########### # # ### ####### # ####### ####### # # ######### # ### ### # 
# #   #   #   #   #       # #   # #   #   #     # #   # #     #   # # # #   #     # #   #     #   #   # # #   #     #     #   # 
# # # ##### ### ######### # # ### ####### # # ### ### ### ### # # # # ### # # ### # ### ### ##### # # # ### # # ######### # ### 
#   #     #   #   #         #   #   #   # # #   #   # #   # # # #   #     # #   # #   #   #     # # #   #   #   #   #     #     
######### ####### # ##### ##### # # # # # # ### ### ### ### # ############# ### # ####### ##### # # ##### ####### # # ######### 
# #     #         #   #   #   # # #   #   #   #   #   # #   #         #   # #   # #     #   #   # #       #       #   #G#   #   
# # ### ####### ##### # ### # # # ################# # # # # ####### # # ### ### # # ### ##### ### ######### ########### # # # ##
# #   #       # #   # # # # # # #     #           # # # # #   #   # # #   #   # # # #     #   #   #   #     # #         # #   # 
# ### ####### # # # # # # # # ####### # ######### # # # # ##### # ### ### ### # ### ##### # ### # # ### ##### # ##### # # ##### 
# #   #     #   # # # #   # # #     # #     #   # # #     #   # # #   #   # # #   #     # #   # #   #   #       #     # # #   # 
# # ### ### ### # ### ### # # # ### # ##### ### # # ####### # ### # ### ### # ### ##### # ### # ##### ### ####### ##### # # # # 
# # # # # #   # # #   #   # #   # #   #   #   # # # #     # #     #   # #   #   #       # #       #   #   #     #   # # #   # # 
# # # # # ##### # # ### ### ##### ##### ##### # # ### ### # ######### # # ##### ######### # ####### ####### ### ### # # ##### # 
#   # # #       # #   #           #   #   # #   #   # #   #   #     # # #     #   #   #   #     #   #       # #     # # # #   # 
##### # ### ##### ### # ######### # # ### # ### ### # # ##### ### # # # ##### ### # ### ### ### # ##### ##### # ##### # # # ### 
#           #   #     # #       #   # #   #   # #   # # #   #   # # #       # #   #   #   #   # #   #   #   #   #   # # # #     
### ######### # ######### ##### ##### # ### # # ##### # # ##### # # ##### ### # ##### ### # # ##### # ### # ### # # # # # ##### 
#   #         #           #   #     # #     # #   #   # #   # #   #     # #   #   # #   # # # #     # # # # #   # # #           
# ### ##################### ####### # ##### ##### # ### ### # ### ##### # # ##### # ### # # # # ##### # # ### # # # ####### ### 
#   # #         #     #   #   # #   #     # #   # #   #   # #     # #   #   #   # #   # # # #   #   # #       # # #       # #   
### # ######### # ### # ##### # # ####### # # ### ### ### # # # ### # ### ##### # # # # # # ##### # # ########### ####### ### # 
#   #         # #   #       #   #     #         #   #   #   # #     # #       # # # # # # #       #   #         # #     #   # # 
######### ### # # ##### ##### ####### ######### ### ### ##### ##### # ##### # # # ### # # ######### ### ####### ### ### ### # # 
#       # #   # # #     #     #     # #               #       #   # # #     #   #   # # # # #       #   #       #   # #   # # # 
# ##### ### ### ### ### # ##### ##### # ####### ##### ####### # # ### # ########### # # # # # ##### # ### ####### ### ### # ### 
#     # #   #       # # #               #   #   #     #       # #     #   #     #   #   # #   #   # #   # #       #   # # #   # 
##### # # ########### # ##### ########### # # # # ### # # # # # ######### # ### # ### ### ##### # # ### # ##### ### ### # ### # 
#   # # #     # #   #         #     #     #   # # #     # # # #         # # # #   #     #   #   #     # #   #   #   #   # #     
# # # # ##### # # # # # ##### # ### # # ####### # # ##### # # ######### ### # ##### ####### ######### # ### # ### ##### # ##### 
# # # # #   # # # #   # #     #   # # # #   #   # # #   # # #   # #   #     #     # # #   # #     #   # # #   #   #   # #     # 
### # # # # # # # ##### # ####### # # ### # # ### # # # # # # # # # # ####### ### # # # ### # ### ##### # ##### ### # # ##### # 
#   # # # #   # #   # # #       # # # #   # # #   # # # # # # #   # #       # # # #     #   #   #       # #   #     #           
# ### # # ##### ### # # ##### # # # ### ### # # # ### # # # # # ### ####### # # # ### ### ############### ### ####### ######### 
# #   #   #   # #   #   #   # # # #     #   # # # #   # # # # # #   #       #   #   #   #             #               #       # 
# # ####### # # # ####### # # # # ############# # # ### # ### # # ### ##### ####### # ############### ####### ######### ##### # 
# #   #   # # #   #   #   # # # # #             # #   # # #   # # #   #   #   #     #               #       # #   #   # # #   # 
# ### # # ### ##### # # ### ### # # ### ### ######### # # # ##### # ##### # ### ##### # # ##### ### ####### ### # # # # # # ### 
#   #   #     #   # #   # #     # #   #   # #       # #   #       # #   #   #   #     # #     # #   #   #   #   # # #   # #     
# # ########### # # ##### ##### # ####### ### ##### # ### ######### # # ##### ### ##### # ### # # ##### # ### ### # ##### ##### 
# #     #   #   # #   #         #   #   # #   #   #   #     #     #   #       #       # # #   # #       #   # # # # #   #   # # 
# ### ### # # ####### # ####### ### # # # # ### ######### # # # # ############# ##### # ### ### # ######### # # # # ### # # # # 
# # #   # #   #     # #       # # #   # # # #       #     #   # #               #     #   # #   #         #   # #   #   # #   # 
# # ### # ##### ### # # ####### # ##### # # ### ##### ######### ##### # ####### # ####### # ######### # # ##### ##### ### ##### 
# # #   #       # # # # #       # #   #   #   # #     # #     #     # #       # #     # # #   #     # # # #               #     
# # # ########### # # ### ### ### # ######### # ### ### # ######### # ##### # ### ### # # ### # ### # # ### ##### ### # ### ####
# #   #     #   # # #   #   # #   #   #     # #     # # #           # #   # #   # #   # #   # #   #   #     #     #   #   #     
# ##### ##### # # # # # # # ### ##### # ### # ####### # ############# # # ##### ### ### ### # ############### ##### ### # ##### 
#     # #   # # # # # # # #     #   # # #   # #   #     #     #       # #     #   #   # #   # #   #   #   #   #     #   # #     
##### # # # # # # # ### # ######### # # # ### # # # ##### ##### # ##### ##### ### # # # # ### # # # ### ### ### ##### ### # ####
#   # #   #   # # #     #       #   #   # # #   # #     #   #   # #     #         # # #   #     # #   # #   #   #     #   # #   
# # # ######### # ####### ##### # ### ### # ##### ##### ### # ### # ################# ####### ### # # # # ### ####### # ### # # 
# #   #       # #     #   #   #   #     #   #     #   #   #   #   # #       # #       #     # #   # #   #   #       # # # # # # 
# ##### ### ### # ### # ### # # ### ### # ### ##### # ### ####### # # ##### # # # # ##### # # # ### ##### # ### ### # # # # ### 
#       # #   # #   #   #   # #   # #   #   #   #   # #         # # # #   # #   # # #   # #   #   #   #   #   #   # # #   #   # 
# ####### ### # # # ##### ### # # # # ######### # ### # ##### # # # # # # # ##### # # # ######### ### ####### # ### # ####### # 
# #   #   #   # # #       #   # #   #   #     #   #   #   #   #   # #   # # #     #   #         #   # #   #   # #   #   #   #   
# # # # # ##### ########### ### ####### # # ####### ##### # ##### # ##### # # ################# ### # # # # ##### ### # # # ### 
# # #   #     #         #   #         # # #       #     # #     # #     # # #                 #   # #   #   #     #   # # #     
# # # ####### ######### # ### # ##### ### ### # # ##### # ##### ##### ### # # ############### ### # ########### ####### # ######
#   # #         #     #   #   #     #   # #   # #   #   #     #   # # #   # #         #   #   #   #     # #     #     # # #     
# ##### ####### # ### ##### ### ### ### # # ######### ### ### ### # # # ### # ### # ### # # ### ####### # # # ### ### # # ##### 
# #   # #   #   # #   #     #     #   #   #   #   #   #     #   #   #   # # #   # #   # # # # # #     # # # #   # #   # # #     
### # # # ### ### ##### ##### ### ############# # # ### ##### # ######### # ### # ### # ### # # ##### # # # ##### # ##### # ### 
#   # # # #       #   #     # # #         #   # #   #   #   # #           #   # # #   #   #   #     # # #     #   #     # # #   
# ### # # # ####### # ##### # # ######### # # # ####### # # ##### ####### ### # # ####### ######### # # ####### ####### # # # ##
#   # # # # #       #     # #   #         # #   #       # #   #   #   #     # # #   #   # #       # #   #       #   # # # # #   
### ### # # # ############# # ### ######### ########### # ### # ### ### ### # # ### # # # # ##### # ##### ######### # # # ##### 
# #     #   #   #   #       # # #   #   #   #         # # #   #   #   #   # # #   # # #   #   #   #       #   #       #   #   # 
# ####### ##### # # # ####### # ### ### # ### # ##### ### # ### # ### ### ### ### # # ####### ############# # # # ######### # # 
# #     #   # #   # # #           #     #   # # #   #     #   # #   #   #   # #   #           #             #   # #       # # # 
# # ####### # ##### # # ##### ############# ### # # ######### # ### ### ### # ####### ##### ### # ######### # ### # ##### ### # 
#   #     # #     #   # #       #   #       #   # # #     #   # # #   # #   #   #   #     #     #   #       #   #   #   #   # # 
### # ### # # # # ##### ######### # # ####### ##### ### ### ### # ### # # # ### # # ############### # ########### ### ##### # # 
#   #   # #   # #       #     #   #   #   #   #   #     #   #     # # #   #   #   #   #   # #     # #   #       # #       #   # 
# ##### ##### # ####### # ### # ####### # # # # # ##### # ### # ### # ##### ######### # # # # ### # ### ####### # # ##### ##### 
#             #   #   # # # # #   #     #   # # #     # #   # #     #     #   #   #   # #   #   #   #   #     # #   #           
# ########### ### # ### # # # ### # ### ### # # ##### # ### # ########### # # # # # ### ####### ##### ### # # # # ### ######### 
# #         #   #   #   # #   #   # #   #   #   #     #   # # #         # # #   # #   # #       #     #   # # # #   #   #     # 
# # ####### ### ##### ### ##### ### # ########### ##### ### ### ####### # ########### # # ####### ##### ### ### # ##### # ### # 
# #       #   # #   #   # #     #   # #     #   #   #   #   #   #   #   # #     #     #   #     #     # #   #   # #   #   #   # 
# ########### # # ##### # ### # # # # # ### # ##### # # # ### ##### # ### # ### # ######### # ####### # # ### ##### # ##### ### 
# # #         #   #     #   # # # # #   # # #   # # # # #   # #   # #   #   #   #   #     # # #   #   # #   # #   # #       # # 
# # # ############# ####### # # # ####### # ### # # ### ### # # # # ### # ### ##### ##### # # # # # ### ### # # # # ######### # 
# # #               #       # # #         #       #   #     # # #   # # #   # #   #     # # # # # #   #   #   # # # #       #   
# # ################# ######### ### # ############### ### ### ##### # # # ### # # ##### # # ### ##### ### ##### # # # ######### 
#   #   #         # # #   #     # # # #   #     #   #   #   #   # #   # # #   # # #   # # # #   #   #     #     # # #     #     
# ##### # ### # # # # # # # ##### # # # # ### ### # ### ### ### # ### # # # ### # # # # # # # ### ############### # ##### # ### 
#       # # # # #   # # # # #     # # # #     #   #     # #     # #   # # #   # #   # # # # #   #   #     #       #   # #   #   
### # ### # # # ##### # # # # ##### # ####### # ######### ####### # ### ##### # ####### # # ### ### ### # # ######### # ##### ##
#   #     #   #     #   #   #       #         #           #                   #         #               #             #         
