################################################################################################################################
################################################################################################################################
                         #   #         #         #   #         #       #   #   #           #               #       #   # #     #
###### ### # ### ####### ### # ####### ######### # # ### ##### ### ### # # # # # ##### ##### ####### # ### # ##### # # # # ### #
     # #   #   #   #   #     #       #       #   # #   # #   #   # #   # # # # # #   # #     #       #   #   #     # # # # #   #
 ### # # # ######### # # ######### ######### # ####### # # # ### ### ### # ### # # # ### ##### ####### # ##### ####### # # # # #
   #   # # #         # # #         #       # # #       # # #   #   #   # # #     # #   # #     #       #     #         #   # # #
 # ##### ### ######### # # ######### ##### # # # ####### ### ##### ### ### # ##### ### # # ##### # ##### ### ############### # #
 #   #     #   #   #   # #   #     # #     # # #       #   #     #   #   # #   #   # #   #     # # #   # # #         #       # #
#### ##### ### # # # ### # ### ### # ####### # ####### ### # ####### ### # # # # ### ######### # ### # # # ##### # # # ####### #
     #   #   # # #         #   #   #     #   #   #   #     # #   #   # #     #     # #       # # #   # # #       # # #   #     #
 ##### # ### # ##### ##### # ### ####### # # ### # ######### # # # ### ### ####### # ####### # ### ### # ######### # ##### #####
 #   # # #   # #     #   # #   #     #   # #     #   # #     # #   # #     #     # # #     # #   #   #   #   #   # #   #   #   #
## # # # ##### # ### # # ##### ##### # ### ####### # # # # ### ##### # ##### ### # # # ### # ### ### ##### # # # # ### # ### # #
   # # # #     # #   # #       # #   # # #         # # # #     #   # # #   #   # # #     #     # #   #     # # # # #   #   # # #
 ##### # # ##### # ### ######### # ### # # ##### # # # # ####### ### # # ##### # # ### ####### # # ####### # # # ### # ### # # #
       # #     # #   # #         #     #   #   # # #   # # #         # #   #   # #     #   #   # #     #   #   #   # # # # # # #
######## ##### # ### # ### ##### ######### # # ### # ### # # # ####### # # # ### # ##### # ##### ##### # ######### # # # # ### #
   #   #   #   #   # # #   #   #     #     # # #   # #       #           # #   # #   #   # #   #     # # #   #       #   #     #
 # # ##### # ####### # # ### ####### ####### # # ##### ######### ############# # ##### ### # # ##### # ### # ######### ####### #
 # #       # #       #   # #       #         # #       #       #   #     #   # # #     # #   #   #   #     #     #     #   #   #
## # ####### # ##### ##### ####### ########### ######### ##### ### # ### # # ### # ##### ####### ####### ####### ##### # # # ###
   #     # # #     #   # #       #   #       #         #   # # #   #   #   #   # # #   #       # #     #       #     #   # #   #
 ####### # # ####### # # ####### ### # ##### ######### ### # # ############### # # # ### # ##### # ### # # ### ##### ##### ### #
 #   # # #     #     #     #         # #     #   #   #   # #   #   #     #   # # #   #   #     #   # # # # # # #   #     #   # #
 # # # # ####### ######### # # ##### # ######### # # ### # # ### # # ### # # # # ##### ####### ##### # # # # # # # ##### ### # #
 # #   # #     # #           # #   # #   #         # #   # # #   # # # # # #           #   #     #     # # # #   #     #   # # #
 # ### # # ### # # ### ######### # # ### # # ######### ### # ### ### # # ##### ##### ### # # # ### ##### # # ######### ### ### #
 #   #   # #   # # #   #       # #   # # # # #       # #   #   #     # # #   # #   #   # # # #   # #     # # # #   #     #   # #
 ####### # # ### # # ### ##### ##### # # # ### ##### # ### ### ####### # # # # # # # ### # # ### # ####### # # # # # # # ### # #
       #   #     # # # #   # #   # #   # #   #     # #     # #     #   #   # # # # #     # #   # # #   #       # #   # # #   # #
###### ########### # # ### # ### # ### # ### ####### ####### ##### # ####### # # # ####### ### ### # # ######### ####### # ### #
     # #       #   #   #   #   # # #   #         #   #   #   #   # #     #     # # #     #   #   # # #   #       #       #     #
 ##### ##### # # ####### ##### # # # ########### # ### # ### # # # ##### # ##### # # ### # ##### # ##### # ######### # #########
       #   # #   #     # #     # #   #     #     #     #   #   #           #   # # #   # #     #   #   # #   #     # #   #     #
 ####### # # ##### ### # # ### # ### # ### # ############# ##### ####### ### # ### ### # # # # ##### # # # ### ### # ### # ### #
     #   # #   #   # # # #   # #   # # # #   #       #   #     # #     #     #   # # # # # # # #     #   # #   #   #   #   #   #
#### # ### ##### ### # # ### # ### # # # ##### ### ### # ##### ### ### # ####### # # # # # # # # ######### # ### ##### ##### # #
   #   #         #   # #   # #   #   #     # # #   #   #     #   # # # # #     #   #   # # # #   #       # #   # #   #   #   # #
 # ############### ### ### # ### ### ##### # # ##### ##### ##### # # # # # ### ######### ### # ######### ##### # # # ### # ### #
 #     #   # #         #   #   #               #   #   # #     # # #   # # # #   #     #     #         #     # # # #     # #   #
 ##### # # # # ####### # ################### ### # ### # ##### # # ##### # # ### # ########### ### ######### # # # # ##### # ###
     #   # #   #     # #   #             #   #   #     #     #   #       #   #   #     #     #   #         #   # # # #   # #   #
#### ##### ##### ### # ##### ########### # ### ######### # # ##### ### ##### # ####### # ### ### ####### ####### # # # # # #####
   #     #     # # # #       #     #     # #   #     #   # #         #       #       #     # #   #     #     #   # # # # #     #
## ##### ##### # # # ############# # ##### # ##### # # ########### # ############### ##### ### # # ### ##### # ### # # # ##### #
   #   #   # # # # #       #       # #     # #   # # # #           # # #           # #   #     #     #     #   #   # # #    G  #
 ##### ### # # # # ####### # ####### # ##### # # # # # # ########### # # ######### # # # ######### ####### ##### ##### ####### #
 #       # #     #     #   #     #   #     #   #   #   # #         # # #   #   #   #   #   #     # #   #   #   #     # # #     #
 # ##### # ####### ### # ### ### # ####### ############# # ######### # ### # # # ######### # ### # # ### ##### ##### # # # ### #
   #     #   #     # #   #   # #   #     # #   # #     # #   #     # #   # # #   #       #   # # # #   #     # #   # # # #   # #
#### ####### # ##### ##### ### ##### ### # ### # # ### # ### # ### # ### # # ######### # ##### # # ### ##### # # # ### # ### # #
   # #     # # #       # #   #         #         #   # # #   # # # #   # # #         # # #     # #     #   # #   # #   #     # #
 # # # ### ### ####### # ### ### ##### ######### ### # # # ### # # ### # # ######### # # # ### # # ##### # # ##### # ######### #
 #   # # # #   #     # #       #     #     #   # #   # # #     # #     #   #   #     # # # #   # #   #   # #   # # #       #   #
 ##### # # # ### ### # ####### # ### # ##### # # # ### # ####### ########### # # ####### # # ### # # ##### ### # # ####### # ###
 #   # # #   #   # #   #   # # # #   #     # # #   #   #   #             #   # # #         #   # # #       # # #   #       #   #
 # # # # ##### ### ##### # # # # ######### # # ####### ### # ########### ### # # # ##### ####### # ######### # ### # ######### #
   # # #     #           # #     #     #   # #       #   # # #   #   #   #   #     #   # #       #   #     # #   #   #   #   # #
#### # ### # ############# # ##### ### # ### ####### ### # # # # # ### ### ########### # # ####### ### ### # ### # ### # # ### #
     #     #     # #   #   # # #   # # # #   # #   #   # # #   # #     #   #         # # # #           # # # #   # #   # #   # #
 ### ########### # # # # ### # # ### # ### ### # # ### ### ##### ####### ### ####### # # # ####### ##### # # # # ### ### ### # #
 # #     #   #   #   #         # #   # #   #     #   #     #     #   #     # #   #   # # # #   #         #   # # #   # # #     #
 # ##### # ### ##### ########### ### # # ########### ####### ##### # ##### # ### # ### # # # # ##### ### ##### ### ### # ##### #
 # #   # #   # #     #           #   # #           #   #   # #   # #   #   #     # #     #   #   #   # #     #     #   #   #   #
 # # ### ### # ##### # ########### # ##### ####### ### ### # # # # ### # ######### ### ######### ##### # # ######### ##### # ###
 #     # #   #   #   # #           #     #       # #     # #   #   #   # #       # #   #       #   #   # #     #   # #   # #   #
 ##### # # # ### ### # ########### ##### ##### # # ##### # ######### ### # ##### # # # # ######### # ### ##### # # # ### # ### #
   # # # # #         # #         # #   #   #   # #   #             #   # #   #   #   # #           #   #     #   # # #   # #   #
## # # # # # # ##### # # ####### # # # ### ######### ############# ### ####### ####### ############### ##### # ### # # ### #####
 # #   #   # # #     #   #     #   # #   #           #   #     #   # #   #               #       #     #     #   #   # # #     #
 # # ##### # ### ### ##### ######### ### ############# # # ### # ### ### # # ######### # # ##### # ##### ####### ##### # ##### #
   #       #   #   #           #     #   #   #         # # # #   #   # # # # #       # # # #     #       #   #     #       #   #
######## ##### ############### ### # # ### ### # ##### # # # ##### ### # ### # ##### # # ### ############### # ### # # ### # # #
         #     #         #   #     # # #       # #   # #               # #   # # #   # # #           #       #   # # # #   # # #
 # # ##### ### # ####### # # ##### # # # ######### # ### ##### # ####### # # # # # ##### # ####### # # ####### # # # # ##### # #
 # # # #   #   #       # # #       # # # #         #   #     # #     #   # # #   #     #   #     # # #   #   # # #   # #     # #
## # # # ############# # ##### # ### # # # ########### # ### ####### # ##### ### ##### ##### ### # ##### # # ### # ### # #######
   #   # #         #   #   #   # #   # # #   #           #   #     # # #       # #   #     # # # #       # #     #   # # #     #
 ####### # ####### # ##### ##### # ### # ### # ####### ####### ### # # # ##### # # # ##### # # # # ####### ####### ### # # ### #
       #   #   #   # #   # #   # #   # # #   #     #   #     # # # # # # #   # # # # #   #   #   #       #   #     #   #     # #
#### ####### ### # # # # # # # # ### # # # # ####### # # ### # # # ### # # # # # # # ### ######### # # ##### # ##### # ####### #
   #         #   # # # # # # # # #   #   # # #     # # # #   # # # #   #   # # # # #               # # #     #     # # #   #   #
 # ##### # # # ### # ### # # # ### # ##### # # ### ### # ##### # # # ### ### ### ######### ######### # # ########### # ### # ###
 #   #   # # #   # #   # #   #     # #     # # #     #   #     # # # #   # #   #   #     # #   #     # # # #         #     #   #
 ##### ### # ### # ### # ########### # ####### ##### ### # ##### # # # ### ### ### # ### ### # ######### # # ######### ####### #
     # #   #   # # #   #   #         #       #     #   # # #   # #   #       #     # # #   # #           # # #       #   # #   #
#### # # # ##### ### ##### # ############### ##### ### # # ### # ##### ############# # ### # ############# # # ### # # # # # ###
   #   # # #     #   # #   #       #       #   #   #   #   #   # #   #   #   #   #   #       #               # #   #   #   #   #
 # ##### # # ### # ### # ######### # ##### ##### ### ### ### ### # # # # # # # # # ########### # # ########### # ############# #
 # #   # # # #   #   #             #     # #   #   # #   # #   #   #   #   # # # #       #   # # # #       #   #             # #
 ### ### # # ####### ################### # # # ### # # ### ### # ########### # # ####### ### # # ### ##### # ########### ##### #
         # #   #   #             #       #   #     # # #   #   #   #   #   #   #       #   # # #   # #   # #     # #   # #     #
 ####### # ### # # ############# # ################# # ### # ### ### # # # # ### # ### ### # # ### # ### # # ### # # # # # #####
 #     # #   #   #   #     #     #   #   #   #   #   #               # # # # #   #   #   # #     # #     # #   #   # # # # #   #
 # ### # # # ####### # ### # ### ### # # # # # ### ####### ########### # # ### ######### # ####### ####### ### ##### # ### # ###
 # # # # # #     #   #   #   #     # # # # # #   #       #     #     #   #   #         # #       # #     # # # #     # #   #   #
## # # # # ##### # ##### ### ##### # # # # # ### ####### # ### # ### # ##### # ####### ######### # # ### # # # # ##### # ### # #
   # # # #   #   # #   # #   #   # # # # # #     #   #   #   # # #   #   #   # #     #         # # # # # # #   # #   # # #   # #
 ### # ##### ##### # # # # ### # ### # # # ##### ### # ##### # ### ####### ##### ### ##### ### # # # # # # # ### # # # # # ### #
 #       #   #     # #   # #   #   # # #   #   # #   # #     #     #     #   #   #   # #   #   # #   #   # # #   # # #   # #   #
 ####### # ### ### # ####### ##### # # ##### # # # # # # ####### ### ### ### # ####### # # ##### # ####### ### ##### ##### # ###
 #     # # #   # # #         #   # # #       # #   # # # #     #   # #     # #       # # # #     #       #     #     #     #   #
 # ### # ### ### # ############# # # ### ########### # # # ### ### # ##### # ####### # # # # ########### ####### ### # ####### #
 #   # #     # # #     # #       # #   #   #   #   #   # # #   #   #     # # #     # #   # # #         #   #   # #   # #   #   #
 ##### ####### # # # # # # ####### ### # ### # # # # ### # ############# # ### ##### ##### # # ####### # # # ### # ### ### # ###
 #     #     # #   # #   #     #     # # #   #   # # #   # #     #   #   #   #     # #   # #   #     # # # #     # #   #   #   #
 # ######### # ##### ######### # ### # ### ####### # ### # # ### # ### ##### # ### # # # ### ### ### # # # ####### # ### # ### #
   #     #   #           #   # #   # #       #   # #     # # #   #     #       #   #   #   #   # #   # # # #       #     # # # #
#### ### # # ##### ### # # # # ### ########### # # ##### # # ########### # ##### # ####### # # # # ### # # # ############# # # #
     #   # #       #   #   # #     #   #       #   #   #   #         #   # #   # # #     # # #   # #   # #   #   #     #   #   #
 ##### ####### ##### ####### ####### ### ########### # ### ######### # ### # # ### # ### # # ##### # ### # ### # ##### ### #####
   # #         #     #     #   #   #     #     # #   #   # #   #   #   #   # #   # #   #   # #   # #   # #     #   # #   # #   #
## # ######### # ##### ### ### # ######### ### # # ##### # # # # ##### # # # ### # ### ####### # ##### # # ####### # ### # # # #
   #         # #     #   #   # #   #     #   #   # #   # #   # #       # # #   # #   #         #       # #     #   #   # # # # #
 ########### # ##### ### ##### ### # ### # ##### # # ### ##### ### ### # ##### # # ##################### # ##### ### # # # # ###
     #         #   #   #     # #   #   #   #   # # #   #   #       #   #   #   #   #             #   #   # #     #   #         #
#### ########### # ### ##### # # ### ####### # ### ### ### # ####### ##### # ##### # # ######### # ### ### # ################# #
   #   #         #   # #   #   # #   #       #   #     # # # #       #     #   # # # #     #   # #     #   #   #       #     # #
 # ### # ######### # # # # ##### # ### ######### ##### # # # # ####### ####### # # # ##### # # ######### # ### # ##### # ### # #
 #     #         # # # # # #     #   #     #   # #     #   # # #   #   # #   # #   #   # # # # #         #   # # #   # #   #   #
 ### ### ##### ### # # # # # ####### ##### ### # # ######### # ### # ### # # # # ##### # # # ### # ### # ### # # # ### ####### #
 #   #   #   # #   # #   #   #       #   #     # # #       # #     # #   #S# # # # #   # # #     # #   #   # #   #     #       #
 ##### ### # ### ################### # # ##### # # # ##### # ####### # ### ### # # # ### # ####### # ##### # ########### #######
     # # # #     #               #   # #   #   #   # #   #         # #   #   # # # # #   #       # # # #   #         #   # #   #
 ### # # # ####### ############# # ### ### # ####### # ########### # ### ### # # # # # # ######### # # # ### ######### ### # # #
   #     #                     #       #   #         #             #       #   #       #           #   #   #                 # #
################################################################################################################################
