################################################################################################################################
       #           #     #   #                       #   #     #             #         #   #                   #   #   #   #   #
 ####### ######### # ### # # ####### ####### ### ### # # # ### # ####### ### # ### ##### # # ##### # ##### # # # # # ### # # # #
         #     #   # #   # #   #   #     # #   # # #   #   #     #       #   # #   #   # #   #     #     # # # # # #   # # # # #
########## ### # ### # ### ### # # ### # # ##### # ######### ##### ####### ##### ### # # ##### ##### # # # ### ### ### # # # # #
 #       #   #   #   #     # # # #   # #     #   #   #   #   #     #     #         # #   #     #   # # # #   #         # #   # #
 # ######### ##### ######### # # ### ######### ### # # ### # # ##### ####### ####### ########### # # # ##### ########### ##### #
 # # #     #       #   #     # # #   #         # # # #     # # #     #       #         #     #   # # # #     #   #       # #   #
 # # # ############# # ### # # # # ### ######### # # ####### # # ##### ####### ######### ### # ### # # # ##### # # ####### # ###
     #     #   #     # #   # #   # #     #     # # # #   #   # #     # #       #   #   # #   #   #   # #     # # #     #   # # #
 ### ##### ### # ##### # ### ##### ##### # ### # # # # ### # # ##### # # ####### # # # # # ### # # ####### # # ####### # # # # #
 #     # #     #   # # #   #     #     # #   # # # #       # #   #   # # #   #   # # #   # #   # # #     # # #     #   # # # # #
## ### # ##### ### # # ### ##### ##### # ##### # # ######### ### # ### # ### # ##### ##### ##### ### ### # # ##### # ### # # # #
   #   #   # # #   # # #   # #   # #   #   #   #   #       #   #   #   # #   #   #   #   #     # #   #   # #       #   # # # # #
 ### ### # # # # ### # # ### # ### # ##### # ### ### ##### ########### # # # ### # ### # ##### # # ### ### ####### ### ### # # #
   #   # #   # #     #   #         #       # #   #   #   #         #       #   # #     #   # # # #   # #     #   #   # #   # # #
 # ### ### ### ########### # ##### ######### # ### ### ########### # ######### # ######### # # ##### # ####### # ### # # ### # #
 #   #   # #   #     #     # #     #       # #   # # #           #   #   #               #   #     # # #     # # #   # #   # # #
#### ### # # ### ### ### # # # ### ### ### # ### # # ########### ### # # ####### # ##### ### ##### # ### ### ### # ### ### # # #
     #     #   # # #     # # #   #     #   #     # #           # #   # #   #     # #   #   # #     #   #   #     #   #   #   # #
 ######### ### # # ### ### # ### ####### ####### # ########### # # ### ### # ####### # ### # ######### ### ####### # ### ### # #
 #   #           #     #   #   #       # #       # #       #   # # #   #     #       # #   #   #   #   # # #   #   #   #   # # #
 # ### ### # ########### ### ######### # # # ##### # ##### # # # # # ######### ####### # # ### # # # ### # # # ####### ### # # #
   #   #   # # #       #   #       #   # # # #     #   # # # # #   #         # #       # #       #       #   #   #     #   # # #
#### ### # # # # ##### ### # ####### ### # ### ####### # # ### ### ######### ### ####### ############### ####### # ##### ### # #
     #   # # # #     #     # #     #   #   #   #     # #   #               #     #     #       #   #   #   #   # #   #   # #   #
 ######### # # ##### ######### ### ### ##### ##### # # ##### ### ####### # ########### ######### # # # # # # ### ##### ### ### #
 #     # # # # #     #   #   # #     #     # #   # # # #     # # #   #   # #     #   #   #     # # # # # #   #   #     #     # #
 # ### # # # # # ##### # ### # ##### ##### # # # # ### ####### # # # # ##### ### # # ### # ### # # # # ##### # ### ##### ##### #
   #   #   #   #       #   # #     #       #   # #   # #     #   # # #         # # # #   #   # # # # #     # #     # #       # #
#### ##### ############### # ##### ### ######### ### # # ### ##### # ######### # ### # ##### # # ### ##### # ####### # ##### # #
 #   #       #           #   #   # # # #       # #   #   # # #     # #       # #     #   #   # #   #   # # #     #   # #   # # #
 # ### ### # # ### # # # ##### # # # # # ####### # ####### # # ##### # ##### # ####### # # ### ### ### # # ##### # ### ### # # #
 #   #   # #   #   # # # #     # # #   #   #     # #   # #   #     #   #     #         # # # # # #     #       # # #   #   #   #
 ### ##### ##### ### # ### ##### # ### ### ### ### # # # # ####### ##### # ############# # # # # ##### ####### # # # ### #######
     #     #   #   # #   #   #   # #     # #   # #   #   # #   #   #   # # #     #       # # # #       #   #   # # # #       # #
###### ####### ### # ### ### ##### # # ### # ### # ####### ### # ### # # ### ### # ##### # # # ##### ### # # ### # # # ### # # #
   #   #     #   # #   #     #     # #   #   #   # #       #   # #   # # #   #   #   #   # # # #     #   # # #     # # # # #   #
 # # # # ### ### # ### ####### ##### ### ##### ### # ####### ### # ### # # ### ##### ##### # # # ##### ### # # ##### # # # # ###
 #   # #   # #   #   # #       #       # #         #       #     # #   #   # #     #     #   # #   #   # #         # #   # #   #
 ######### # # ##### # # # ########### # # ############### # ##### # ####### ##### ##### ##### ##### ### # ####### # # ### # # #
 #       # #   #     # # # #   #   #   # # #       #   # # #       #   #         #     #     #       #     #     #     #   # # #
 # ### ### ##### ##### # ### # # # ##### # # ### ### # # # ########### # ####### ##### ### ######### ##### # ### ####### ### # #
 #   #     #   # #   # # #   #   # #   #   #   #     #   #     # #     # #       #   #   # #   # #   #   # # # #     #   #   # #
 ### ####### # # ### ### # ####### # # # ### ################# # # ##### ####### # # ### ### # # # ### # # # # ##### # ##### ###
     #   #   # #     #   #     # # # # #       #             # #             #   # # # #   # # #   #   # # # # # #   #     #   #
 ##### ### ### ####### ####### # # # # ####### # ##### ####### ### ######### # ### # # ### # # ### # ### # # # # # ### ### # # #
 #     #   #   # #   # #     # # #   # #     #   #   # #     #     #   #   # #     #   # # # #   # #   # # # # #   #   #   # # #
 # ### # ### ### # # # # ### # # ##### # ### ##### # # # ### ##### # # # # # ####### ### # # ### ####### # # # # ####### ##### #
   #   #   #   #   # # # #   # #     #   #   #     # # # # # #   # # #   # #       #     #   #   #       # # # # #       #   # #
 ### ######### ##### # # # # # ##### ##### ### ##### # # # # # # # # ##### ####### # ### ##### ### ####### # # # # ######### # #
   #         #       #   # # # # #   #   #   # #   # # # #   # #         #     #   # #       #     #       #   # #         #   #
 # ######### ####### ##### # # # # ##### ### # # ### ### # ############# ##### ##### ####### ####### # # ####### # ####### #####
 #       # # #   #   #   # # # #   #       #   # #       #     #     #   #   #   #       #           # #     #   #   #     #   #
## ##### # # # # # ### # # ### # ##### ### ##### # ########### # ### ### # # ### ####### ########### # ### # # ##### # ### # # #
   #     # #   # #   # #   #   #     #   #   #   #   #   #       # #   # # #   #       #     #     # #   # # #     # # #   # # #
 ### ##### ##### # ### ##### ####### ##### # # ##### # # ######### ### # # ### ####### ##### # ### ##### # # ##### # # ### # ###
   #       # #   # #   # #   #   # # #   # # #       # # #     # #   # # #   # #     #     # # #   #     # #   #   # #   # #   #
## ##### ### # ### # ### # ##### # # # # # # ####### # ### ### # # ### # ### # ### ####### # # ##### ##### ##### ### ### # ### #
 #     #   # # #   # #   #       # #   #   #   #     #   # #   #   #   #   # #   # #   #   # #   #   #       #   #     # # #   #
 ##### ### # # # ### # ########### ####### # # ##### ### # # ### ### ### ### ### # # # # ####### # ######### # ##### ### ### ###
     #   # # # # # #   #     #     #     # # #         #   #   # #   #   #   #   # # # # #   #   #         # # #   # #   #   # #
#### ### # # # # # ##### ### ##### # # # # # # ############### # # ### ### ### ### # # # # # # ########### # # # # # # ### ### #
 #   #   # # #   # #   #   # #     # # #   # # #   #   #     # #         # #   # #   # # # # # # #     #   # #   # # # #   #   #
 # ### ### # ##### # ### ### # ##### # ##### ### # ### # ### # ### ####### # ### # ##### # # # # # # # # ### ##### ### # ### ###
 #     #   # #       #   #   #       #   # #     # #   # #   #   #         # #   #     # # #   # # # # # #       #   # # # #   #
 ####### ### # ####### ### ####### ##### # ####### # ### # ##### # ######### # ####### # # ##### # # # # ########### # # # # # #
 #       #   # # #   #   #   #     #     #   #   #   #   # # #   #   #     # #       # #   # #   # # # #         #   #   # # # #
 # ### ### ### # # # ### ### # ##### ####### # # ##### ### # # ##### # ### # ####### # ##### # # # # ########### # ### ### # # #
 #   #   # #   #   #   #   # #   # # #       # #     # #   #     #   #   #   #                 #   #       #   # # #         # #
 ### ### # ### ####### ### # ### # # # ####### ##### # # ####### # ##### ##################### ########### # # # # ### ####### #
     #   #   #       # #   #   #   #   #     #   # # # #       #     #   #         #     #   #         #   # # # #   #   #     #
#### # ##### # ##### # # ##### # ####### ### ### # # # ####### # ### # ### ####### # ### # # ######### ##### ### ### # ### #####
     #       # #   # # # #   # #       # # #     # # # #   #   #   # #     #     #   #   # # #         #   # #     # # #   #   #
###### ######### # # # # ### # ##### ### # ####### # # # # # ### # # ####### ######### ##### ####### ### # # # # # # ### ##### #
     # #   #   # # #   #   # # #   # #   # #     # # # # #   #   # #       #   #       # #   #     #   # #   # # # #   #     # #
 ### # # # # # # # ### ### # # # # ### ### # ##### # # ####### ### # ### # ### # ####### # ### ### ### # ##### ### ### # ### # #
 #   # # #   # # # #   #   # # # #     #     #     # #   #     #   # #   #     #     #   #     # #   #       #   # #   # # # # #
 # ### ####### # # ### # ### # # ####### # ### ##### ### # ##### ### # ############# # ######### ### ####### ### ### ### # # # #
 #   #         # #   # # # #   # #   #   #         #   # #   # #   # #     #       # # #   # #   # # #   # #   #   #   # # # # #
 ### # ############# # # # ##### # ### ############### # ### # ### ####### # ##### # # # # # # # # # # # # # ##### ### # # # # #
 #   #           #   # #   #     #     #       #     #   # # #   # #     #       # # # # # #   #   #   # # # #   #   # #   #   #
 # ### ####### # # ### ### # ##### ##### ##### # ### ##### # # ### # ### ######### # # # # ####### ##### # # # ##### # # #######
 # #   #   # # #       #   # #       #   #   #     #           #   # #             # #   #           #   #     #   # # #       #
 # ##### # # # ######### ### # ##### # ##### ##### ############# ### ##### ####### # ### ######### # # ##### ### ### # # ##### #
 #     # # #   #   #   #           #         #   # # #   #     # #   #   # #   #   #   # #   #   # # #     #       # # # #   # #
 ##### # # ##### # # # ### ######### ##### ### # # # # # # ### # # ### # ### # ### ### # # # # # # ####### # ##### # # # # # ###
 #   # # #       #   # #   #       # #   # #   # #   # # # # # # # #   #     #   # #   # # #   # #       # # #   # #   #   #   #
 # # # # ############# # ### ##### ### # ### ### ##### # # # # # ### ########### ### ##### ##### ####### # ### # # ########### #
 # # #   #       #   # #     #   #     #   # # # #   # # #   # # #   #     #   # #   #   # #   # #     #       #       #   #   #
 # ############# # # # # ##### ########### # # # # # # # ##### # # ####### # # # # ##### # ### # # ### ############### # ### # #
 #   #       #   # #   # #       #       #     # # #   #     # # # #         # # #     # #   #     # # #         #     # #   # #
 ### # ##### # ### ##### # ##### # ############# # ##### ##### ### # ######### # # ### # ### ####### # # ####### # ### # # ### #
   #   #   #   #   #     # #     #   #   #     #       #       #     #   #     # #   # #   # #     # #   #     #   #   #   # # #
 # # ### # ### # ### ##### ######### # # # ### ####### ######### ##### # # ##### # # # ### ### ### # ##### ### ### ### ##### # #
 # # #   #   # # #   #   # #         # # # # #   #   # #   #   # #   # # # #     # # #   # #   # # #       #       #       #   #
## # # ##### ### # ### # # # ######### ### # ### # ### # # # # # # # # # ### ##### ##### # # ### # ####### # ##### # ##### ### #
   # #   # #     #     #             #   # #   # #     # #   #   # #   #   #     #     # #   #   #       # # #     # #     #   #
 ### ### # ############# ####### # ##### # # ### ### ### ######### ####### ##### ##### # ##### ######### # # # ##### ##### ### #
   #   # #       #   #   #     # #     #   # #   #   #   #     # # #     # #   # #   # #     #         # # # #   #   #   #     #
## ### # # ### # # # # ### ### # ########### # ####### ### ### # # # # # ### # # # # # ##### ##### ### # # # ### # ### # ##### #
   #     # #   # # #   #   #   #     #         # #     #   #   # # # # #     # # # # # #   #     #   #   # # #   #     # #   # #
 ####### ### ### # ##### ### ######### ######### # ##### ### ### # ### ####### # # # # # # ##### ### ##### # ########### # # # #
 #     #     #   #     # # #           #   #         #   #   #   #     # #   # # # #   # #   #   # # #   # #           #   # # #
 # ### ####### ### ### # # ############# # # # ##### # # # ### ######### # ### # ####### ### # ### # # # ####### # ### ##### ###
 #   # #     # #   #   #   #           # # # # #   # # # #   #   # #   # #   #   #       # #   #   #   # #       #   #     #   #
 ##### # # ### # ### ##### ##### # ### # # ### # # # ### ### ### # # ### ### ##### ####### ####### ##### # ########### ####### #
       # #     # #   # #   #     #   #   #   # # # # #   #   #   # #   #   #       #     #     #   # #   #     #     # #   #   #
######## ####### # ### # ### ####### ####### ### # # # ### ##### # ### ### ########### ####### # # # # ######### ### # # # # # #
 #       #   # # #     # #   #       #     #   # # # # # # #   #     # # # #     #     #     #   #   #           # # # # #   # #
 # ####### # # # ####### # # # ######### # ### # # # # # # ### ##### # # # # ##### # ### ### ####### ############# # ### ##### #
 # #       # # # #   #   # # # #         #   #   #   #   #   # #         # # #     # #   # #       #   #     #     #     #     #
 # # ##### # # # # # # ##### # # ########### ##### ######### # ######### # # # ##### # ### ####### ### # ### ### ######### ### #
 # #     # # # # # #   #   # # #       #     #         # #   #                 #   # # #       #     #   # #   #           #   #
 # # ##### # # # # ##### # # # ####### # ### ##### ### # # ########### ######### # # # ### ### # # ####### ### ### # # ### # ###
 # # #   # #   # #     # #   #   #     #   #     #   # # #           #G#   #     #   #   # #   # # #         #     # #   # # # #
 # ### # ##### # ##### # ### ### # ####### ##### # ### # ########### ### # ### ######### ### ### ### ##### ######### ##### # # #
       #     #     #   #   #   # # #     #     #   #   #         #   #  S#   # #     #   #   #   #   #     #     #     #   #   #
############ # # # # ##### # ### # # ### ##### ##### ##### # ### # ### ##### # # ### # ### ### ### ######### ##### # ### #######
   #   #   # # # # #   #   # #   #   #   #   # #   # #     #   #       #   # # #   # #   #   # # # # #     # #     # #   #     #
 # # # # ### ### # ### ####### ### ### ##### # # # # ### ############### ### # ##### ### ### # # # # # ### # ### ### # ####### #
 #   # #         #   #         #     # #     #   # #   # #   #   #     #   # # #     # #     #   # # # # #   #   #   # #       #
 ##### ######### # # ############# ### # ######### ### # # # # # # ####### # # # ##### ##### ##### # # # ##### # # ### # #######
     #     #   # # #               #   #     #     # # # # #   # #       # # # #                               # # #   #   #   #
#### ##### ### # # ##### ### ##### # ### ##### ##### # # # ##### ####### # # # ### ############### ########### ### # ##### # ###
   #     #   #   # #     #   #     #     #     #   # # # # # #   #     # # # #     #         #   # #         # #   #       #   #
 ####### ### ##### # ##### ############### ##### # # # ### # # ### ### # # # ##### # ####### # # ### ####### ### # ######### # #
         #         #     #               #       #   #     #   #     #             #       #   #     #           #           # #
