################################################################################################################################
#   #     #   #     #   #     #   #       #                     #   #         # #   #   #                   #                   
### # ##### ### ### ### # ### # # ####### # ########### # # ### # # ##### ### # # # ### # ### # ########### ##### ######### ### 
#   #     #   # #         #   # #   #   # # #   #       # #   # # #     # # # # # #   #   #   #     #     #     #       #   #   
# ####### ### # # ####### # ### ### # # # # ### # ####### # # # # ##### # # # # # ### ####### ##### ##### ##### ######### ### ##
#               #   #   # #   #   #   # # #     # #       # # # # # #   #   #   #   #   #   # #   # #     #   # #   #     # #   
####### ########### # # # ### ### ##### # ### ### # ####### # ### # # ####### ##### ### # # ### # # # ##### # # # # # ##### ### 
#       # #   #     # # #   #     # #   # #   #   #       # #       #   #   #   #   #   # #   # # # #   #   # # # # # #   #   # 
# ####### # # ####### # ### ####### # ### # ### # ####### # ##### ##### # # # # # ####### ### # ### # ### ### # # # # # # ### # 
#         # #         #   # #   #   # #     #   # #   #   # #   #     # # # # # # #   # #   # #     #   #   # # # # # # #   # # 
# ######### ############# # # # # ### # ######### # # # ##### # ### # # ### # # # # # # ##### ####### # ### # # ### # ##### # # 
#   #   # #     # #       #   # #     # #     #   # # #     # #   # # #     # # #   # #       #     # #   # # # #   #       #   
# # # # # ##### # # ########### ####### # ### ##### # ##### # ### ### ####### # ##### # ########### # # ### # # # ########### ##
# #   #   #     # #                       # # #   # #   #   # # # #   #       #       #     #         #     # # #           # # 
# ######### ##### ############# ##### ##### # # # # ### # ### # # # ### ################### # # ### ######### # ### ####### # # 
# #   #   #   # #       #     #     #       #   #   # # # #   # # #         #           # # # #   # #   #   #       #     #   # 
# # # # # ### # ####### # ### ##### ############### # # # # ### # ####### # ########### # # ####### # # # # ### ##### ### # ### 
# # #   # #   # #     #   #   #   #   #   #       #   # # # #   #       # #           # #     #     # #   #   #   #     # #     
# # ##### # ### # ### ##### ### # ### # # # ##### ### # ### ### ####### # ########### # ##### # ##### ####### ### # ##### # ### 
# # #       # #   #   #     # # # # #   #   #   #   # #   #   # #     # # #     #   # #   #       #   #     #   #   #   # #   # 
# # # ####### ##### ### ##### # # # ######### # ### ##### ### # # ##### # # ##### # # ### # ##### # ####### ### ##### # # ### # 
# # # #   #     #   #   #     # #   #       # #   # #   #     # # #     # # #     # # #   # #   #   #         # #   # #   #   # 
### # # # ##### # ### ####### # ########### # ### # # # ####### # # ##### # # ##### # # ### # # # ########### # # # ##### ######
#   # # #     # # # #     #       #       # # # # # # # #   #   # #   #   #   #   # # #   #   # # #         # #   #   #   #     
# ### # ##### # # # ##### ####### ####### # # # # # # # # # # ### ### # ######### # # ### # ### # # ####### # ####### # # # ### 
# #   # #   # # # #     # #   #         # #     # # # # # # #       # # #         #   #   #   # #         #       #   # # #   # 
# ### # # # # # # ### # # # # ######### # # ##### # ### # # # ####### # # ### # ####### ### # # ############# ##### ### # ### # 
#   # # # # # # #     # # # # #   #   # # #   #   # #   # #   #       #   # # #         #   # #       #     # #     #   # # # # 
### ### # # # # ####### # # # # # # ### # # ### # # # ### ##### ####### ### # ####### # # ### ####### # ### # # ##### # # # # # 
# #       # # #         #   #   # #     # # #   # #   # #     # # #   # #   # # #     #     #     #   #   # # #   #   # #   # # 
# ########### # ####### ######### # ##### # # ######### # ### # # # ### # ### # # ############### # ####### # ### ##### ##### # 
#       #     # #   #     #     # # #   #   #       #   # #   # #       #     # #   #   #     #   #         #   # #   # #     # 
# ##### # ####### # # ### # ### # # # # # ######### # # # # ### ############### ### # # # ### # ############# # # # # ### ##### 
#   #   #         # #   #   #   # # # #   #       # # # # # #   #   #   #     #   # # #   #   # #       # #   # #   #     #   # 
### ############### ##### ### ### # # ##### ##### # # # # # # ### # # # # ### ### # # ##### ### # ### # # # ### ############# # 
# #     # #       #     # # #   # # #     # # #   #   #   # #     # # # # #     # # #     # # # #   # #   #   #               # 
# ##### # # ##### # ### # # ##### # ### ### # # ########### ####### # # ### ##### # ##### # # # ##### # ##### # ##### ######### 
#   #   # # #     #   # #       # # #   #   #   #         #       #   #   #     #   #   # # # # #   # #     # #   #   #   #   # 
### # ### # ####### # # ####### # # # # # ############### # # # # ####### ### # ##### # # # # # # # ### ### # ### # ### # # # # 
#   #     # #  S#   # #   #   #   #   # # #             #   # # #   #   #   # #   #   # # #   # # #   # #   # # # # #   # # # # 
# ####### # # # # ####### # # # ####### # # ### ####### ##### # # # # ##### # ### # ### # ##### # ### # ##### # # # # ##### ### 
#     #   #   # #   #     # # #     # # # #   # #   #   #     # # # #       # # #   #   #       # #   # #     #   # # #     #   
##### # ####### # ### ##### # ##### # # # ### # # ### ### ### ### ########### # ##### # ########### ### # ####### # # # ##### ##
#   # #       # # #   #   # #   #       #   # # # #   #     #   #             # #     #       #     #   # #       #   #       # 
# # # # # ### # ### ### # # ### # # ####### # ### # ### # # ### ### ##### ##### # ##### ##### # ####### # ### ################# 
# # #   # #   #     #   #   #   # # #   #   #     # #   # #   #   # #   #       # #     #   # # #       #   # #               # 
# # ##### # ########### ##### ##### # # # ######### # ### ### ### ### # ### ##### ##### # # # # ### ### ### # # # # ######### # 
# #       # #           # #   #   # # #   #   # #   # #   #     #     #   #     #     # # # # #   # #     # #   # # #   #     # 
# ######### ####### ##### # ### # # # ##### # # # ### ##### ############# # ### ##### ### # ##### ### # ### ##### # # # ####### 
#   #     #         #     #     # # #     # # # # #     #   #   # #     # #   # #   #     # #   #     # #   # #   #   #         
# # ### ############# ### ####### # ### ### # # # ##### # ### # # # ### # # ### # # ####### # # ####### # ### # ### ############
# # #   #   #           #     #   #     #   #   # #   # # # # #   #   #   # #   # # #     # # # #       # # # # # #   #         
# # # # # # # # ########### # # ### ##### ####### # # # # # # ####### ##### # ### ### ### # # # # ####### # # # # # # ######### 
# # # #   #   #   #     # # # #   #     #     #   # #   #   #       # #     #   #   # # # #   #   #     # #     #   # #   #     
# # ### ######### # ### # # ##### ### ### ##### ### # ############# # # # ##### ### # # # ######### ##### ######### # # # # ####
# #   # #     #   # #   #   #   # # # #   #     #   # #     #     #   # #     #   #   #   # #       #     #   #   # #   #   #   
# ### # # ### # # # ####### # ### # # # ### ##### ##### ### # ######### ##### ### ##### ### # ##### # ##### # # # # ######### # 
# #   # #   # # # # #     # #   # #   #   # #     #     # # #       #       # #     #   # #   #   # #     # # # # #           # 
### ### ### # # ### # ### # ### # ### ### # ####### ##### # ####### # # ##### # ##### ### # ### ### ##### # # # # # ####### ### 
#   # #   # # # #   # # # #   # #   #   # #       #       #   #       # #     # #     # #   #     #     # # #   # #     # # # # 
# ### ### # ### # ### # # ##### ### ### # ####### ########### ######### # ##### # ##### # ### ### # ##### # ##### # ### # # # # 
#   #   # #     # # #   #   #   #   #   # #     # #         #     #   # #   #   #   #           # #     #   #   # # #   #   #   
### # ### ####### # ####### # ### ##### # ##### # # # ##### ##### # ### ### # ##### # ######### # ##### ##### ### ### ##########
#   # #   #       # #       #   #     # #     # # # # #   #     # #     #   #       # #       # #   # # #       #   #     #     
# ### # ### ##### # # ######### ##### # ##### # # # ### # # ##### ####### ####### ### # ##### # # # # # # ##### ### # ### # ### 
# # #       #   #                   # #   # #         # # #     # #       #     #     #   # # # # #   # # #   # # # # # #   # # 
# # ### ##### # ### ############### # # # # ### ##### # # ##### # # ####### ### ######### # # # # ##### # ### # # # # # ##### # 
# #     #   # #   # #     #     #   # # #       #   #   # #   # # # #     # # #     #       # # # #   #   #   # # # # # #     # 
# ### ### # ##### ### ### # ### # ### # ### ##### # # ### # # # # # # ### # # ##### # ####### # ### # ##### ### # # # # # ##### 
# #   #   #   # #     # #   #   # # # #   # #     #     #   # # # # # #   # #     #   #   #   #     #   #   # #   # # # # #     
# ##### ##### # ####### ##### ### # # ### ### ####### ####### # # # # # ### # ### ####### # ### ####### # ### ##### # # # # ### 
#     #     # #     #       #   # # # # #   #       # #     # # # # # #   #   # #   #   # # #         # #   # #   # #   # #   # 
##### ##### # # ### # ######### # # # # ### ######### # ### # ### # # ### ##### ### # # # # ######### # ### # # # # # ### ### ##
# #     #   # #   # # #             # #     #   #     # # # #     #   #           # # #   #     #     #         # # #       #   
# # ##### ### ### # # # ############# ##### # # # ##### # # ####### ### ### # ##### # # ####### ############# ##### # ### ##### 
# #       #   #   #   #   #     #   # #   # # # #   #   # # #     #   #   # # #     # # #   #   #   #   #   # #     #   # #   # 
# ######### ### ######### ##### # # # # # ### # # ### ### # # ### ### ### # # # ####### # # ##### # # # # # # # ##### # # # # # 
#   #     #   # #   #   #   #   # # #   #   # # # #   #   #   # #   # #   # # #         # #     # #   #   # # # #     # # # #   
### # # ##### # # ### ##### # ### # ####### ### # # # # ####### ### # # ### # ######### # ##### # ######### ### # ##### ### ####
#   # # #   # # #     #   # #   # #     #   #     # # # #         # # #   # #   #     # # #   #   #   #   #     # #   #   #     
# ##### # ### # ### ### # # # # # ####### ### ##### # # ######### # ##### ####### ### # # # # ####### # ######### # # ### ##### 
#       #   # #         # #   # #     #   #   # #   # # #       # #     #       #   #   #   # #     #   #     #   # #   # #   # 
##### ##### # ##### ####### ######### # ### ### # ### # # ##### # ##### ### ### ### ######### # ### # ### ### # ### ### ### # # 
# #   #   # #   #   #       #         # #   #   #   #G# #   #   #     #   #   # # # #       # # #   #   #   #   #   # # #   #   
# # ### # # ### # ### ####### ######### # ##### ### ### ### # ##### ##### # ### # # # ##### # # ####### ### ### # ### # # ######
# #   # # #     #   #   # #   #   #   # #         #     # # # #     #   # # #   # # # # #   # #       #     #   #     #   #     
# ### # ######### ##### # # ### # # # # ####### # ####### # # # ### # ### # # # # # # # # ### ####### ####### # ########### ### 
#             #   #   #   #   # # # # #       # #       # # # # #   # #   # # # # #   # #   #   #   #   #     #               # 
####### ####### # # # # ##### # # # # ####### ######### # # ### # ### # ### # ### ##### ### ### # # ### ##### # # ####### ##### 
#     #   #   # #   # # #     # # # #     # #     #     #       #   # #   # #     #     # #   #   #   #   #   # #   #     # #   
# ### ### # # # ##### # # ##### # # ##### # ##### ##### # ######### # ### ######### ### # ### ##### ##### # ### ### # ##### # # 
#   #   # # #       #   # #     # #     # # # #   #   #   #             #     #   #   # # # #   # #       # #     # #     #   # 
####### # # ############# # # # ######### # # # ### # ##### ######### ####### # # ### # # # ### # ######### ####### ##### ##### 
#         # #     #       # # # #         #   # #   #   #   #       #       #   #   # # #     #   #       # #     #     #     # 
# ######### # ### # ####### # ### ########### # # ##### # ### ##### # ############# # # ##### ### ##### # # # ### ##### # ### # 
#     # #   #   # # #       # #   #         # #   #     # #   #   # #   #     #   #   #   #   # # #     # # #   #       # #   # 
##### # # ##### # # ####### # # ####### ### # ##### ##### # ### # # ### ### # ### ####### # ### # # ##### # # # ######### # ####
#   #     #   # # # #     # # #   #   #   # #     #     # #   # #   #       #       #     # #   #   #   # # # #       # # # #   
# # ##### # # ### # # ### # ##### # # ### # ### ####### # ### ##### ############### # ##### # ####### # # # # ####### # # # # # 
# #     #   #     # # #   # #   #   #     #   #       # #   #     #   #       #     # #     #         # #   # #   #   #   #   # 
# ##### # ######### # # ### # # ############# ####### # # ####### ### # ##### ##### # ### ####### # ### ##### # ### # ######### 
#   #     #   #     # #   # # # #     # #     #   #   # #     #   # #   # #   #   # #   #       # # #   #     # #   # #   #   # 
### # ##### # # ##### ### # # ### ### # # ####### # ### ##### # # # ##### # ### # # ### ####### # # ### ### # # # ##### # # # # 
# # # # #   #   #   #   #   #     # #   # #       # #   #     # # # #   # # #   # #   #       #   #   #     # # #       #   # # 
# # # # # ####### # ##### ######### ### # # ####### # ### ### # ### # # # # ### # # ######### ####### ####### # # ######### # ##
#   #   #         #     # #   #         # #         # #   #   # #   # #       # # #     #   #         #       # # # #     # #   
####### ############### # # # # ######### ######### # # # ### # # ### # ##### ### # ##### # ########### ##### # # # # ### ##### 
#   #             #   # #   # #   # #     #   #     # # #   # #   #   # #   #           # #           #   #   # #   #   #   #   
# # # ### ####### # # # ### ##### # # ##### # # ### # ##### ######### ### # ##### ##### # ########### ### # # # ####### ### # ##
# #   #   #     #   # #   #   #   # #     # #   #           #   #   # #   # #   # #   # # # #   #     #   # # #   #     #   #   
######### # ### ##### ### ### # ### ##### # ##### ########### # # # ### ##### # # # # ### # # # # ##### ### # ### # ##### ##### 
#   #   # # # # #   # #   #             # #   #   #   #       #   #   #       #   # #     #   #   #     # # # # # # #   #   #   
# # # # # # # # # # # # ### # # ##### # # ### # ##### # ############# ########### # ####### ####### ### # # # # # # # # ### # ##
# #   # # # #     #   # #   # # #     # #     #       # #                   #     #       #       # #   #   # # #   # # # #   # 
# ##### # # ######### # # ### ### ##### ##### ######### ####### ########### # ### ####### ####### ### ####### # ####### # ##### 
#     # # #     #         #   #   # #                 #   #     #   #   # # #   #     # # #     #   #   #       #     # #       
### ### # ####### ##### ### # # ### # ### ##### ######### # ##### # # # # # ##### # # # # # ### ### ### # ### ####### # ### ####
#   #   #   #     #   # #   # #     #   #   #   #     #   #   #   #   # # # #   # # #   #   # # # #   # #   #         #   #   # 
# ### ####### ##### # # # ### ############# # ### ### # ####### ####### # # # # # # ### ##### # # ### # ### # # ### ##### ### # 
#   # #     # #     # # # #       #       # #   #   #   #     # #     # # # # #   # #   #   # # #   #   #   # #   # #   # #   # 
# ### # ### # # ##### # # ### ### # ####### ### ### ##### ### # # ### # # # # ##### # ### # # # ### ##### ### ### # ### # # ### 
# #   #   #   #   # #   # #   #   #       # # #   #     #   #   # # #   # #   #   # #   # # # #     #     # # #   #         #   
# # ##### ##### # # ##### # ############# # # # # ##### ### ##### # ##### ### # # ##### # ### ########### # # # ########### ### 
# #     #     # # # #     # # #   # #     # #   # #   #     #   # #           # #   #           #   #   # #   #   #       #     
# ########### ### # # ##### # # # # # ##### ##### # # ######### # # ####### ### ### # ### ##### # ### # # ######### ##### ### ##
#       #   # #   # # #   #   # #   # #     #   #   # #       #   # #     #   #   # # #   #     # #   # #           #   #   #   
####### # # # # ### # # # ##### ##### ### ### ####### # ##### ####### ### ####### # ### # # ### # # ################# # ### ### 
#         #   #     #   #           #     #           #     #         #           #     # #   #                       #     #   
