################################################################################################################################
################################################################################################################################
S  #             #   #   #   #               #   #   #           #       #     #   #   # #         #   #           #       #   #
## # # # ####### # ### # ### # ############# # # # ### ######### # ##### # ### # # ### # # # ### # # # # ######### # ##### ### #
   # # #   #     #     #   #   #       #     # # #     #         # #   #   # # # #       # #   # #   # #   #   #   # #   #     #
 ### # ##### ############# ### # ##### # ### # ######### ##### ##### # ##### # # ######### ### # ##### ### # ### ### # #########
 #   # #   #   #     #   # # # # #   # #   #             #   #       # #     # # #         # # #     #   # #     #   # #     # #
 # ##### # ### # ### # # # # # # # ### ######### ### ##### # ######### ##### # # # ######### # # # ##### # ####### ### # ### # #
   #     #   #   #     # # #   # #   #           #   #   # #   #     #     # #   #     #     # # #     #   #   # # # #   # # # #
## # ####### ####### ##### # ### ### ######### ### ### # # ### # ### ##### # ### ##### ### ### ##### # ####### # # # ##### # # #
   # # #   #   #   # # #   # #   #   #         #   #   # # # # #   #     # #         #     #   #   # #           # # #   #   # #
 ### # # ##### # # # # # ### # ### # # ##### # # # # ### # # # ### ##### # ### ##### # ##### ### # ### # ######### # # # # ### #
   # # #     # # # # # # # # # #   #   #   # # # # #   # # # #   #   # # #   # #     # #     # # # #   #   # #     #   # #     #
 ### # ##### # ### # # # # # # # ####### # ### # ##### # # # ### ### # # ### # # ### # # ##### # ### ### # # # ######### ##### #
 #   #     # #   #     # #   # # #       #     #     # #   #   #   # #   # # # # # # # #     #       # # #   # #     #         #
## ### ### # ### # ##### ##### # # ################### ##### # ### # # ### # ### # # # ##### ######### # ##### ### # ##### #####
   #   #   # #   #   #   #     # #       #         #   #     #     # #   # #     #   # #   #   #   #         # #   #     #   # #
 ### ### ### # ### # # ### ##### ####### # ####### # ### ########### ### # ####### ### # # ### # # ####### # # # ####### ### # #
 #   #   #   # #   # # #   #         # # # #       #   #       #   #   # #           # # #   #   #       # # #   # #     #     #
 # ### ### ### # # ### # ### # ##### # # # # ######### ####### # # ##### # ####### # # ##### ########### # ####### # ##### #####
 #   #     #   # # #   # #   # #   # # #   #   #     #   #     # # #   #   #     # #   #     #         # # #   #     #     #   #
 ### ####### ##### # ### ##### # ### # ####### ##### ### ##### # # # # ##### ### # ##### ### ######### # # # ### ######### # # #
   #       #   #   #   #     # # #   #   #   # #       #     # # #   #     # # # #     # #   #         # #   #   #       #   # #
## ####### ### # # ### ##### # # # ### ### ### # ### ####### # # ######### # # # ##### ### ### ### ##### # ### ### ### # ### ###
 # #   #     # # #   # #   # # #   #     #   # #   # #   #   # # #         # #     #   #   # #   #   #   # #   #   #   #   #   #
 # # # ##### # # ### # # # # # ##### ### ### # # # ### ### ### # ### ####### ##### # ### ### # # ##### ### # ####### ##### ### #
 #   #     #     #   #   #   #         # # #   # # #   #   #   #   # #     #     # #           # #     #   #         #   #     #
 # ####### # ####### ######### # ### # # # ##### ### ### ### ##### # ### # ##### # ##### ######### ### ############### ####### #
 # #   #   # #                 #   # # #     #   #   #   #   #     #     # #     # #     #       #   # #         #   # #     # #
 ### # # ### # ############### ### # # ####### # # ### ### ### ########### ####### # ##### ##### ### ### ####### # # # # # ### #
 #   # # #   #     #             # # #   #   # # #     # # #     #       #     #   #     #     #   #           # # # # # #   # #
 # ### # ### ##### ############# # ### # # # # # ####### # ##### # # ######### # ### ### ##### ### ########### # # # # # ### # #
 # # #   #   #   # #     #       #   # #   #   #         #       # #       #   #   #   # # #   #   #       #   #   #   # # #   #
 # # ##### ### ### # ### # ######### # ########### # ############# ##### # # ##### # # # # # ####### ##### ##### ####### # #####
 # # #   #   #   # #   # # #   #     #     #     # #             # #   # # #   #   # # #   #   #   #   # #     # #     # #     #
 # # # ### # ### # ### # # # # # ########### ### # ##### ### # # # # # ### ### # ### # ####### # # ### # ##### # # ### # ##### #
   # #     #     #     # #   # # #     #     #   #   # # #   # # # # #     # # # #   # #     #   # # # #   #   # #   # #       #
#### ##### ############# ##### # # ### # ##### ##### # # # ### ### # ##### # # # # ##### ######### # # # # # ####### ######### #
   #   #       #       #   #   # #   #   # #   #     #   # # #     # #     # # # # #   # #     #   # #   # #     #   #   #     #
 # ### # # ### # ##### ### ##### ### ##### # ### ######### # ####### # ### # # # # # # # # # # # ### ##### ##### # ### # # #####
 #   #   #   # # # #   # # #   #   #   #   # #   #         #       # #   #   # #   # #   # # # # #       #     #   #   # #     #
#### ##### # # # # # # # # # # ### ### # ### # # ################# # ### ##### ### # ##### # ### ##### # ##### ##### ### ##### #
   #   #   # # #   # #   #   # # #   # # #   # #         #   #   # #   #   #   #   #   #   #   # #     #     #     # #     #   #
 # # # # ### # ### # ######### # ### # # # ##### ####### # # ### # ### # ### ### ##### # ##### # # ######### ##### # # ##### ###
 # # #   #   #   # # #   #   #     # # # #     #       # # #   # #     #   # #   #   # # #   # # # #               # #         #
 ### ##### # # ### # # # ### ####### # # ##### ##### ### ##### # ######### # # ### ### # # # ### ### ####### ##### # ###########
 #   #     # # #   #   #   #     #   # # #   #G    # #   #     #           # #     #   # # #   #     #     # #   #         #   #
 # ### # ### # # ######### ##### # ### # # # ##### # # ### ######### ##### # ##### # ### # ### # ##### ### ### # ### ####### # #
   #   # #   #         #   #   # #     # # # #     # # #   # #     #     # #           #   # #   #     #   #   #   # #       # #
#### # # ############### ### # # ####### ### # ####### # ### # ### ##### # ####### ### ##### ### # ##### ### ##### # # ####### #
 #   # #       #         # # # #   #   #     #   #   # # #   # # #       #     #   #       #     # #     #   #       # #   #   #
 # # # ##### # # ######### # # ### # # ##### ### # # # # # ### # ############# # ### ##### # # # # ####### ### ### ### ### # ###
   # #   #   # # #   #       #       # #     #   # #   # #     #       #   #   # #   #   #   # # #       #   #   # #   #   #   #
## # ### # ### # ### # ######### ####### ##### ### ##### ####### ### # # # # ### # ### ##### # # ####### ####### # # ### ##### #
 # # #   #   # #     # #       #   #     #     #   #   # #       #   #   # # #   #   #       # #       #         #     #       #
 # # ####### # ####### # ##### ##### ##### ##### # # # # # ####### ####### # # ##### ### ##### ####### ############### ####### #
 # #       # #         #   # # #     #     #     #   #   #   #     #         # #   #   #     # #     # #     #   #   # #   #   #
 # ##### ### ####### ##### # # # ##### ##### # # ############# ##### ####### # ### ### # ### # # ### # # ##### # # # # # # #####
 #     #   #       # #   #   # # #   # # #   # # #       #     #   #   #   # # #   #   #   # #   #   #     #   #   # #   #     #
 ##### ### ####### ### # ### # # # # # # # ### # # ##### # ##### # ### # # ### # ### ##### # ##### # ####### ####### ### ##### #
 #       #       # #   #   # #   # # # #   #   # #     # # #     #   # # #   #     # #     # #     # #   #   #     # #   #   # #
 # ##### ##### ### # ##### # ##### # # ######### ##### # ### ####### ### ### ####### # ##### # ####### # # ####### # # # # # ###
 #     #     #   #   #   # # #   # # #         #     # #   #       #     #   #       # # #   # #       # # #       #   # # #   #
 ##### ##### ### ##### ### # ### ### ######### ##### # ### ### ### ####### ### ####### # # ### # ####### # # ########### # ### #
 #   #     # #   #       #   #   #   # #     # #     #   #   #   #   #   #     #     #   #   # #   #     #   #   #     # # #   #
 # # ##### ### ### ##### ##### ### ### # ### # ##### ####### ### ### ### ####### ### ####### # ### ### ####### # # ##### # # ###
   #     # #   #       # #   # # #     # #   # #   # # #   # #   #   #   #     # # #         # # #   #       # #   #   # # #   #
######## # # ### ####### # # # # ### ### # ##### # # # # # # # ### ### ### # # # # ######### # # ### ####### # ### # # # # ### #
 #         #   # #     # # # # #     #   #       # #   # # # # #   # #     # #   #           # # # # #     # #   # # # # #   # #
 # # ######### # # ### # # # # # ##### ########### # ### # # # # ### ##### # ########### ##### # # # ##### # ##### # ### ##### #
 # #   #       # #   #   # #     #   #   #       # #   # #   # # #   #     #     #     # #     #   # #   #       #   #     #   #
 # ### # ### ### ### ##### ####### # ### ####### # ##### ####### # ##### # ##### # ### # # ####### # # # ####### # ### ### # ###
     # #   # #   # # #     #   #   #   #   #     #       #       #       #     # # # # # # #     # # # #   #     #     #   #   #
###### ### ### ### # # ##### # # ##### ### # ############# ############# ####### # # # # # ##### # # # ### ##### ####### # ### #
         #     # #   # #     # # #   # #   # # #       #   # #           #       #   #   # #   # # #   # #     #       # # # # #
 ##### # ####### ##### # ##### # # ### # ### # # ##### # ### # ### # ##### ####### ####### # # # # ##### ##### ####### # # # # #
   # # #     #           #     # #   #   #     #     # # #     #   #   #   #   #   #   #   # #   #   #       # # #       #   # #
## # # # # ### ####### ######### ### ######### ##### # # ####### ##### # ##### # ### # # ### ####### # ### ### # # ######### # #
 # #   # #     #       #         #   #           #   # # #       #     #     #   #   # # # #   #     #   #   # # #     #       #
 # ##### ############# # ######### ### ######### # ##### # ####### ### ##### ##### ##### # ### # ##### ##### # # ##### # ##### #
 #     # # #         # # #     #     #   #       # #     # #     #   # #   #         #   # #   #         #   # #       #   #   #
 ##### # # # ####### ### # ##### ### ##### ####### # # ### # ### ### # # # ######### # ### # ##### ##### ##### ##### ####### # #
 #     #   #   #   #     #       #   #   #   #   # # # #   # #   # # # # #   #   #   # #   #     #   #   #     #   # #       # #
 # ########### # # # ######### ### ### # ### ### # ### # # # ##### # ### ### # # ##### # # ##### # # ##### # ### # ### ####### #
   #           # # #     #   #   #     #     #   #     # # #       #     #   # #     # # #   #   # # #   # # #   #   # #   #   #
## # ########### ### # # # # ### ############# # ####### # ####### ####### ### ##### # ##### # ### ### # # ### ##### # # # # ###
   #   #   #   # #   # # # #   # #     #   #   #   #     # #     # #   # # #   #   #   #   #   #     # # #   #     # # # # # # #
 # ### # # # # # # ### # ##### # # ### # ### # ### ##### # # # ### ### # # # ### # ##### # # ####### # ### # ####### # ### # # #
 # #   # # # #   # #   # #     #   # # #     # # # #     #   #     #     # #     # #   # # #       # #   # # # #     #     #   #
## # ### # # ##### # ### # ######### # ##### # # # # ### ########### ##### ####### # # ### ####### # ### ### # # ############# #
   # #   # #   #   #   #   #   #     # #   # # # # # #             #     #       # # #   # #     #   # #     # #           #   #
 # # # ####### # ### # ##### # ##### # # # ### # # # # # ##### ### # ### ######### # ### # ##### ### # ####### ########### # ###
 # # # #       #   # #   #   # #         #     # #   # #     #   #     # #   # #   # # # # #     #   #       # #   #       #   #
 ### # # ######### # ### # ### # ############### ### ##### # ######### # # # # # ### # # # # ##### ##### ##### # # # ######### #
 #   #   #         #   #   # # #   #   #     #       #   # #         # #   #   #     #   # #       #   # #   # # # #   #       #
 # ##### # ######### # ##### # ##### # # ### ######### # # ######### ##################### # ######### # # # # # ##### # #######
 #     #   #   #     #     # # #     #   # #     #     # # #   #   #               #       # #   #         # # #     # # #     #
 ##### ##### # # ### ##### # # # ######### ##### # ##### # ### ### ##### ##### ### # ####### # # # ##### # # # ### ### # # ### #
   #   #     #   #   #   # # #   #             # # #   # #         #   #   #   #   # #       # # #   # # # # #   # #   # #   # #
 # # ### ######### # # # # # ##### ### # ####### # # # # ########### # ##### ####### # ######### # # # # ### ### # # ### ### # #
 # #   # #       # # # # # #   # #   # #       #   # #   #           # #   #         # #           # # #   #   # # # # #     # #
 ##### # ##### # # # # # # # # # # # ######### ##### # ### ########### # # ##### ##### ##### ####### # ### # # # # # # ####### #
 #     #     # #   # # # # # # # # #   #       #     # #   #     #   # # # #   # #           #   # # # #   # #   # # #   #   # #
 # ######### # ####### # # ### # # ### ######### ##### # ####### # # # # # # # # # # ### ##### # # # # # ### ##### # ### # # # #
 # #         #     #   # #   # # #   #   #       #     #       # # # #   # # # #   #   # #     # #   #   #         #   #   #   #
 # # # ####### ### # ### ### # # ### ### # ####### ### ####### # # ####### # # ####### # # ##### ############### ##### # #######
 # # #   #       #     # #   #     # # # #   # #   #         # #       #   # #     #   #       #       #       # #     # #     #
## ##### # # ### ####### # ##### ### # # ### # # ########### # ### ##### ### ##### # ########### ##### ####### # # ##### # ### #
   #   # # #   #     #   #     # #   #   # # #   #     #   # #   # #   #       #   # #     #   #     # #     # # # #       #   #
 ### # # ##### # ### # ####### # # ####### # ##### ### # # ##### # # # ######### ### # ### # # ####### # ### # # # ### ####### #
 #   #   #   # # #   #   #   # # #     #   #     # # #   # #     # # #   #   #   #   # # # # #       # #   # # # # #   #     # #
 ######### # # ### # ### # ### # ##### # # ##### # # ##### # ##### # ### # # # ####### # # # ####### # ##### # # # # # # ### ###
     #     # #   # #   # #     # #     # #     #   #     # # # #     # # # # # #     #   # #     #   #       #   #   # #   #   #
#### # ### # ### # ### # ####### # ##### ### ########### # # # # ##### # ### # ##### ##### ##### # ### ############### ####### #
   # # #   #   # # # # # #       # #   #   #     #     # #   #   #     #     #     # #     #     #   #     #     #   # #       #
## # ### ##### # # # # # # # # # # # ### ##### # # # # # ##### ####### ########### # # ############# # ##### ### ### # # #######
   # #   #   #   # #   #   # # #         #     #   # #     #   #     #     #   # #   # #     #     # # #     #   #   # #   #   #
 ### # ##### ##### ### ##### # ######### # ####### # ####### ### ### # ### # # # ##### # ### # # ### ### ######### ### ### # ###
     # #       #   #   # #   # #   #   # #   #   # #     #   #   #   #   #   #   #         #   #       #         #     #   #   #
###### # ##### # # ### # # ### # # # # # ### # # ####### # ####### ##### ##### ### ### ### ######### # ######### ##### # ##### #
   #   # #     # #   #   # #   # # # # # #   # #   #     # #       #   # #   # #   # #   #     #   # #     #     #   #         #
 ### ##### ######### # ### # # # ### # ### # # ### # ##### # ####### # # # # ### ### ### ### ### # # ##### # ##### # ######### #
   # #     #         # #   # # # #   # #   # # # # #       #   #   # # # # #   #       #   # #   # #     #   #   # #           #
## # # ##### ######### # ##### # # ### # ### # # # # ######### # ### # # # ### ####### ### ### ### ##### ##### # ############# #
   # # #   #       # # #     # #   #   #   # # #   #         # #     # # # # # #       #   #   #   #         # # #       #   # #
 ### # # # ####### # # ##### ####### ### # ### ##### # ####### ####### # # # # # ####### ### ### ### ######### # # ##### # # # #
     #   #         #       #         #   #     #     #                       #         #     #   #             #       #   #   #
################################################################################################################################
