################################################################################################################################
 #       #   #                   # #       #   #     #                       #       #   #               #       #             #
 # ##### # # ##### ### ######### # # # ##### # ##### ##### ##### ### ####### # ##### # # # ############# # ##### # # ####### ###
 # # #   # #     # #   #       # #   # #   # #     #   #   #     #   #         #   #   # # #   #       # #   #   # #   #   #   #
 # # # ### ##### # # ### ####### # ### # # # ##### ### # # # ##### ### # ######### ##### # # ### ##### # ### # ### ### ### ### #
   # #     #       # #   #       #   # # # # #   #     # # #     # #   # #       #   #   # #   #   # # # #   #   #   #   #   # #
#### ##### ######### # ### ######### ### ### # # ####### # ####### ##### # ##### # # # ### # # ### # # ### ##### ### ### ### # #
           #         #   #         #       #   #     #   #   #   #     # #   #   # # #   # # #   #   #     #   #   #   # #     #
############ ######### # ######### ####### ######### ######### # ##### # ### ##### # ### # # ##### ######### # # ##### # #######
   #   #     #     #   #   #   # #     #   #       # #   #     # # #   #   #   #   #         #   # #       # # # #   # #       #
 # # # # ##### ##### ### # # # # ##### ### # ##### # # # # ##### # # ##### ### ##### ##### ### # # # ##### # # # # # # ####### #
 # # #   #   #       # # #   # # #   #   #     # #   # #   # #   #   #     #   #   # #   # #   #   #   #   # # # # # #     #   #
 ### ##### ### ####### # # ### # # # ### ##### # ##### ##### # ####### # ### ### # # # # ### ######### # ### # # # # ### ### # #
     #     #   #       # #   #     #   #     #   #   #   #   # #       # #   #   # # # #     #         #     # #   # #   #   # #
######## ### ######### # ############# ##### ### # # ##### # # ######### # ####### # # ####### ############### ##### # ### ### #
       #   # #       # # #     #     #     # # #   # # #   #   #   #     #       #   #   #   # #     #   #   # #     #   #   # #
###### ### # ### ### # # # ### # ### # ### # # ##### # # ####### # # ########### ### ### # # # # # ### # ### # ######### ### # #
     # #   #     #   # # # #   # #     #   # #       # # #   #   #   #       #     #   # # # #   #     #     #           #   # #
 ### # # ######### ### # ### ### ######### # ##### ### # # # # # ##### ##### ##### ### # # # ### ##### ############### ### ### #
   #     #         # # #     #       #   # #     #   # # # # # #     # #   #   # #   #     #     #   # #   #     #   # #   #   #
## # ##### ######### # ########### # ### # ##### ### # # ### ####### # ### ### # ### ######### ### # ### # # ### # # # # ### ###
   # #   # #         #       #   # #     # #   # #           #       # #   #   #   #     #   #     #     # #   # # # # # #     #
#### # # # # ### ### ####### # # ######### # # # # ##### ##### ####### # ### ### # ##### # # # ####### ### ### # # # ### # ### #
   # # #   #   #   # #       # #   #       # #     #   #   #   #   #   #     #   # #   #   # #   #   # #   # # # # #     # #   #
 # # # ####### ### ### ####### ### # ####### # ### # # # # ##### # # ######### ### # # ##### # ### # ### ### # ### ####### # ###
 #   #       #   #       #   # # # # #     # #   #   # # #     # # #   #     #   #   # #     #   # #   # # # #   # #       #   #
 ########### # ########### # # # # ### ### ##### # ### # ##### # # ### # ####### ##### # ##### # # ### # # # ### # # # ####### #
   #     # #   #   #       #   # # #   # #       # # # # # #   # # #   # #       #   #         # # #   # # #   #   # #   #   # #
## ### # # # ### # # ########### # # ### ######### # # # # # ##### # ### # ####### # ##### # ### # ##### # # ########### # ### #
       # # # #   #   #   #   # #   # #   #   #   #   # # # #       #   # # #     # #   #   #   # #   # # #   #   #       #     #
 ####### # # # ####### # # # # ##### # ### ### # ##### # # ########### # # # ### # ### # ##### # ### # # # ### ### ##### #######
 #     #   # #       # #   # #     #   #     # #       #   #       #   #     #   # #   # #   # #     #   #   #     #   #       #
 # ### ### # ####### # ##### ##### ##### ### # ######### ### # # # # ####### # ##### ### # # ############### ####### # # # ### #
 # # # #   # #   #   # # #   #   # #     # # # #   #         # # # #       # # #   # #     #   #   #       #   #     # # #   # #
 # # # # # # # # # ### # # ### # # # ##### # # ### ####### # # # # ####### # # # # # # ####### ### ####### ### # ####### ##### #
 # #     # #   # #     #       #   #   #   # #     #       # # # #         # #   #   # # #   #   #       #   # # #       #     #
## ####### ##### ### ############# ### # ### ####### ######### # ########### ######### # # # ### ####### # # # # ### ##### #####
   #           #     #     #         #     #       # #       # #   #             #     #   # # # #         # # # #   #   #     #
 ### ######### ##### # ### # ##### ### ############# # ### # # # # # ########### # ### ##### # # ########### # # # ### ### ### #
   # #   #           # #   #   #       #         #   #   # #   # # # # #   #   # # #   #   # # #           #   #   # #       # #
## # # # # ########### ######### # ##### ####### # ####### ##### # # # # # # # # ### ### # # # ########### # ####### ### ##### #
 # #   # # #   #     #     #     # #     #       # #     # #     #     # #   # #   # #   #     #   #   #   # # #   #     #     #
 # ##### # # # ##### ##### # ##### # ##### ####### # ### # ### ######### ##### ### # # ####### # # # # # ### # # # ##### # ### #
 #     # #   # #     #   #   #     # #   #       #   #   #   # #       #     # #   # #   #   # # #   # # #   # # # #     #   # #
 # # ### ##### # ##### # ##### ### # # # ####### ##### ##### ### ##### ####### # ### ### # # ### ##### # # ### # ### ####### ###
 # # #   #   # # #     # #   # # # #   # #     #     #     #     #   # #     # # #       # #     #   #   #     #     #     #   #
 # # # ### # # # # ##### # # # # # ##### # ### ########### ####### # # # ### # # # # ##### ######### ######### ##### # ####### #
   # # # # # # # # #     # # #   #     # # # #     #     # #       # # #   # #   # #     # # #   #   #     #         #         #
#### # # # # # # # # ##### # ####### # # # # ##### # ##### # ######### ##### ############# # # ### # # ### ### ### # ###########
     # # # #   #   # #     # #       #   #   #     # #     # #     #   #     #           # # #   # #   # # #   #   #         # #
 ##### # # ### ##### # # ##### ######### ##### ##### # ##### # ### # ### ##### ######### # # ### # ##### # # ### ### # ### # # #
     # # # #   #       # #   # #   #     #         # # #     #   # #   #   # #     # #   # #   #   #   # #   #   #   # #   #   #
#### # # # ##### ######### # ### # # ### # ######### # ### ##### # ### ### # ##### # # ### ### ##### # # ##### # # ### #########
     # # #       #       # #   # #   # # #     #     #   #     # #   #     #   #   #     # #   #     # #       # # #   #       #
 ##### # ######### ##### # ### ####### # ##### # ####### # ##### ### ######### # ####### # # ### ##### ##### ##### # ### ##### #
 #     # #       # #   # # # #   #             # #       # # #   #             # #   # #   #   # #   #       #     #   #   #   #
 # ##### # ##### # # # # # # ### ########### ### ### ##### # # ### ### ######### ### # ####### # ### ####### # ####### ### # ###
 #       # # #   #   # #   #   #     #     #   #   # # #     #   #   #         #     #   #     #   #   #     #     #   #   #   #
 ######### # # ####### ##### # ##### # ### ### ### # # # # # ### ### # ####### ####### ### ##### # ### # ### ##### # ### ##### #
 #   #   # #           # #   # #   # # # #       #   # # # #   # # # #       #       #   #     # #   #   #       # # #   #   # #
 # # # # # ############# # ### ### # # # ####### ##### # # ##### # # ####### ### # # # # ##### ##### ##### # ### # ### ### ### #
 # #   # # #   #     #   #   #     #   #   #     #       #         #     # # #   # # # #   # # #   # #   # # #   #     #   #   #
 # ##### ### # # ### ### ### ########### # # ##### # ##### ############# # # # ##### # ### # # # # # # # # ### # ####### ### ###
 # #     #   # # # #   #       #       # #   #     #     # #   #         #   # #   #   #   # #   #   # # # #   #           # # #
## # ##### ### # # ### ####### # ##### # ##### ######### ### ### ############# # # # ### ### ######### # # # ### ####### # # # #
   # #     # #   #   #   #   # #     #       #     #   #   #     #           #   # #   #   # #       # #   # #     #   # # # # #
 ### ##### # ####### ### # # # # ################# ### ### ############# ### ##### ####### # ####### # ##### ####### # # # # # #
   #     # #           # # # #   #               #   #   # #             # #   #   #     #   #       #   #   #   #   #   # #   #
## ##### # ########### # # # ### # ########### ##### # ### ############### ### # # # ### # ### ######### ##### # # ####### #####
 #     # #     # #   # #   # #   # # #       #     # #   #   #     #     #       # # #   #         #   #   #   #   #     #     #
 ##### ####### # # # # ##### # # # # # ##### # ### # ### ### # # # # # # # ######### # ### ####### # # ### # ####### ### ### ###
     # #       # # #   # #   # # # # #   # # #   #         # # # # # # #   #         #   #   #   # # #   # # #   #   #     #   #
 ### # # ####### # ##### # ### # # # ### # # ############### # # # # # ##### ########### ### # # # # ### # # # # # ####### ### #
 #   #   #       #   #   # #   # # #   #   # #   #         # # # #   # #   # #       # # # #   # # # #   # #   # #     # # # # #
## # ##### ### ##### # ### # ### # # # ### ### # # ####### # # # ##### # # # # ##### # # # ##### ### # ### ##### ##### # # # # #
   #   #   #   #   # # #   #   #     # # #     # # #  G#     # #     #   # #   #     # # #       #   # #   #     #   # #   #   #
 ##### # ### ### # # # # ############# # ####### ### # ########### ############# ##### # ######### ### # ### ##### # ### ##### #
   #   #   #     #   # # #       #   #       #   #   # #         # #     #   #   # #   #       #   #   #   #   #   # #   #     #
#### ##### ########### # # # ### # # ####### # ### ### # ####### ### ### # # # ### # # # ##### # ### ##### ##### ### # ### # ###
         #     #   #   # # # # # # #   #   # #   # # # #   #   #     #   # # # #   # # # #   #   #   #   #     # # #   # # # # #
 ############# ### # # # # # # # # ##### # # ### # # # ##### # ####### ### # # ### # # # # # ##### ### ####### # # ##### # # # #
     #     #   #   # # # # #   # # #     #       # # # #   # #       # # # # #   # # # # # #     #   #       #   #   # #   #   #
 ##### # ### ### ##### # ####### # # ######### ### # # # # # ####### # # # # ### # # # # # ######### ### ########### # ### #####
     # #   # #         #       # #   #       # #   # #   # # # #   # #   # # # # #   # # # #       #   #     #     #           #
 ### # ### # # ############### # ### # ##### # # ### ##### # # # # # # ### # # # ### ### # # ### ##### ##### # ### ######### # #
 # # #   # # # #             # # #   #     #   #   #     #   #   # # # #   # # #   #     # #   #       #   #   #           # # #
 # # ### # # # # ##### ##### # # ### ##### ### ### # ######### ### # # # ### # ### ####### ### ########### ####### ### ### # ###
 # #   # #   # #   # #     # # #   #   #   # # #   #           #   #   # #   #   #       # #   #         #         #   #   #   #
 # ### # ##### ### # ##### ### ### ##### ### # # ####### ##### # # ##### ####### ####### # # ### ##### # ### ### ### ### ### # #
   #   # #       #   #   #   #   #       #             # #     # #     #     #   #     #   # #   #     # #   #   #   #   #   # #
## # ### # ##### ### # # ### ### ##### ############### # ####### ########### # ### ######### ##### ##### ##### ### ### ##### # #
   # #   #   #   # # # #   #   #   #   #         #   #   #     # #       #   #       #     # #   #   # #     #   # # # #     # #
 ### # ##### # ### # # ### # ##### ### # ####### # # ### # ### ### ### # # ### ##### # ### # # # # # # ##### ##### # # ##### # #
   # # # #   #     # #   # # #   # #   # #       # #     #   # #   #   # # #   #   # # # #   # # # # # #   #       # #   #   # #
## # # # # ####### # ##### # # # # # ### # ############# ### # # ### ##### ##### # # # # ##### # ### # # ########### ### ##### #
   #   # # #   #   #   #   # # # # #   # #       #     # # # # # #   #   # #   # #   #   #   # #     # #     #       # #     # #
 ####### # # # # ##### # ### ### # # ### ######### ### # # # ### # # # # # # # # # ##### # # # ####### ##### # ####### ##### # #
 # #   # #   # #     # # #   #   # # #   #       # #   #     #   # # # #   # #   # #   # # # #   #           # #   #     # #   #
 # # # # ########### # # # # # ### ### ### ##### # # ##### ### ### ### ##### ##### # # # # # ### # ######### # # # # ### # ### #
 # # # #     #     # #   # # # # # #   #     #   # # #   #   #   # #   #     #     # # #   #     #     # #   #   # #   # #     #
 # # # ### ### # ### ### # ### # # # ####### # ### # # # # # ### # # ### ##### ##### # ############### # # # ##### ### # # # ###
 #   #   # #   #     #   #     # # #         #   # # # # # # #   #   #   #   #   #   #   #           #   # #     #     #   #   #
 ####### # # ######### ######### # ############# # # # # # ### ######### # # ### # ##### # ######### # ### ##### ######### ### #
 #       # #   #     #   #     # #   #   #     #   # # # #   # #         # # # # # # #   # #     #   #   # #               #   #
 ### ##### ### # ### ### ### # # ### # # ##### ##### # # ### # # # ######### # # # # # ### # ##### ####### # ##### ######### ###
   #   #         #     # #   #     # # # #   #         #   # # # #   #     #     #   # #   # #   # #   #   # #     #       #   #
## ### # ########### ### # ####### # # ### # ### ######### # # ##### ##### ##### ##### ### # # # # # # # ### # ##### ######### #
 # # # #   #       # #   #       # # #     #   #     #   #   #     # #     #   # #   #   # # # # #   #   #   #   #   #       # #
 # # # # ### ##### # # ########### # ######### ##### # # ### ##### # # ##### # # # ##### # # # ########### # ### # ### ##### # #
   #   # #   #   #   # #           #     #   #     # # #   #   #   #   #   # # #       #   # #     #       #   #   #   #     # #
 ##### ### ### # # ### # ####### ####### # # ##### # # ### # ### ### ### # # # ##### # ##### ##### ####### # # ##### ######### #
 #   #     #   #   #   #   #   # #     # # #     # # # # # #   # #   # # #   #       #   #     #   #       # #     #   #   #   #
 # # ####### ####### ####### # # # ##### # ##### # # # # # ### # ### # # ############# # # ### # ### ##### # ##### ### # # ### #
 # #   #   #   #     #     # #         #   #   # #   # #           # # # #     #     # #   #   #     #   # #   #   # #   #     #
 # ### ### ### # ##### ### # ######### ##### ### ##### ########### # # # # ##### ### # ####### ####### ### ### # ### ###########
   #   #     # #       # # # #       #         #   #   #   #   # # #   #   #     #   #     #     #   #   #   # #     #   #     #
#### ### ### # ######### # ### ##### # ### ### ### # ### # # # # # ######### ##### ####### # ### # # ### # # # # ##### ### # # #
 #   # #   #           # #     #   # # #   #         #   #   # #       #     #   #         # #   # #   #   # # # #       # # # #
 # ### ### ####### # # # ####### # # ### # # # ####### ####### ####### # ##### # ######### # # # # ### ##### # # # ##### # # # #
   #   #   #     # # # #   #   # # #     # # # #       #     # #     #   #   # #   #       # # # #   # #   # # #   #   # # # # #
 ##### # ### ### ### # # # # # # # ####### # # # ### ####### # # ### ##### # # ### ##### ### # # ### ### # # # ##### # ### # # #
 #   #   #   # #     #   # # # # # #     # # # #   # #     # # # #   #     #   # #   #   #   # # # #     #   #   #   #   # # # #
 # # ##### ### # ######### # ### # ### # # # ##### # # ### # # # # ### ######### ### ##### ### # # ####### ##### # ##### # # # #
 # #       #     #     # # #     #   # #   #     # # #   #   #   #   #   # #     #   #   #   # #       #   #     # #   #   # # #
 # ####### ####### ### # # ######### # ### ##### # ##### ########### ### # # # ### ### # ##### ####### # # # ##### # # ##### # #
 # # #   # #       # # #     #   # #   # #     # #       #   #     #     #   #   #     # #  S#       # # # #     # # #   #   # #
 # # # # # # ####### # ### # # # # ##### ### # # ########### # ### ####### ##### ####### # # ####### # # # ##### # # ### # ### #
   #   #   #         #     #   #             # #                 #             #       #   #         #   #     #   #   #   #   #
