################################################################################################################################
 #     # #       #     #   #   #     #     #       # #         #     #       #   #     #       #                               #
 # ### # # ##### # ### # # ### ### ### ##### ##### # # ##### # # ### # # ##### # # ### # ### ### ############### ##### ####### #
 #   #   # # #   # # # # #   # #   #   # #   #     #   #   # # # # #   #     # #   # # #   #         #         # #   #       # #
 ### ##### # # ### # # ##### # # ### ### # ### ####### # # # ### # ######### # ##### # ### ######### # ####### ### # ######### #
 # # #   #   #   #   # #                 #   # #    G# # # #   # #   #     #   #   #   #   #   #   # #       #   # # #   #   # #
 # # ### ####### ##### # ############# ##### # # ### # # # ### # ### ##### ####### ##### ### # # # ######### ### # ### # # # # #
 # #   #   # #   #   #   #     #     # #   # # # #   #   # #   # # # #   # #                 #   # #         #   #   # # # #   #
 # ### ### # # ### ##### # ### # ### ### # # # # # ####### ##### # # # # # # ########### # ######### ##### ### ##### # # # #####
   # #   #   #   #     # # # # #   # #   #   # # #   #     #     # # # # # #   #   #   # # #     #   #   #   #   # #   # #     #
## # ### ### ### ##### # # # # ### ### ####### # ##### # ### ##### # ### # # ### # # # # # # ### # ### # ### ### # ##### ##### #
   #   #   #   #   #   # #   #   #     #   #   #       # #   #     # #   # # #   #   # # # # #   # #   #   #   # #   #   #   # #
 ##### ### # # ### # ### ####### ####### ### ########### # ####### # # ### # # ####### # # # # ### ####### ##### ### # ### # # #
 #       #   #         #     #   #     #     #   #       #       #           # # #   # # #   # # #   #   #     #   # #     # # #
 # ##### # ########### ##### # ### # # # ##### # ####### ####### # ########### # # ### # # ### # ### # # ##### ### # ####### ###
 #   #   # #       #       # #     # # #       #               # # #           # #     # # #   #   # # #     #   # # #     #   #
 ### # ### # ##### ####### # ### ### # ########### ####### ##### # # ########### ####### # # ##### # ##### # ### # # ##### ### #
     #     #   # #   #           #   #       #     #     #         #   #     #     #     # #       #       #   #   #       #   #
########## ### # ### # ##### # # # ######### # # ### ### # ########### # ### # # # ##### # ################### ########### # ###
     #   #   #   # #   #     # # # #     #     # #   #   # # #     # #   #   # # #     # #     #       #     #   #         # # #
 ### # # # # ##### ##### ### # # # # ### # ##### # ### ### # # ### # ##### ### # ##### # # ##### ##### ### # ### # ### ##### # #
   #   # # # #   #     #   # # # #   # # # #     #   # #   # #   # # #   #   # # #   # # # #   # #   #   # # #   # #   #   #   #
 # ##### # # # # # ####### # # # ##### # # # ######### # ### ### # # # # ### # # # # # # # # # # # ##### # ### ##### # # # ### #
 #     #   #   #   #   # # # # #       # # #     #     #         #   # #   # # # # # #   # # #   #     #   #   #     # # #     #
###### ### ######### # # # # # # ####### ####### # ############# ##### ### # ### # # ##### # ##### ##### ### ### # ### # #######
   #   #     #     # # #   # # #       #   #   # #       #     #   # #   # #   # # #     # # #       #   #   #   # #   #   #   #
 # # ### ### # ##### # ####### ### ####### # # # ####### # ### ### # ### ##### # # ##### # # ####### # ### ### ### # ##### # ###
 # # #   #   #     # #       #   # #     # # # #   #     # # #   #       #   # # #   #   # # #   #   # # #   # #   #     # #   #
 # # ##### ####### # ####### ### # # ### ### # ##### ##### # ### # ##### # # # ##### ### ### # # # # # # ### ### ####### # # # #
 # #     #         #   #   # #   # # # #     # #   #       #   # # #   #   # #     #   # #   # #   # #     # #   #   #   # # # #
 # ##### # ########### # # # ####### # ####### # # ######### ### ### # ##### ##### ### # # ######### ##### # # ### # # ### # # #
 #     # #           # # # #         #         # #               #   #   #       #     # # #   #       #   # #     # #   # # # #
 ####### ### ####### # # # ##################### ################# ##### # # ### ####### # # # # ##### # ### ########### # # ###
       #   #   #     #   #                 #     # #             #     #   # #     #   #   # # #     #           #       # #   #
###### ### ##### ### ##################### # ##### # ##### # ### ##### ####### ### # # ##### # ######### ####### # ####### ### #
         # #   #   #   #           #       #   # # # #     #   #     #       # # # # #       #           #     #       #   #   #
 ####### # # # ### # # ######### ### ######### # # # # ### ### ##### ####### # # # ### # # ########### ### ### # ##### # ### ###
 #     #   # #     # #           #   #   #     #     # #   #   #   #       # # # #   # # # #   #     # #   # # #     # # #     #
## ### ##### ####### ############# ### ### ############# ### ##### ####### ### # ### # # # # # # ### ### ### # # ### # # ##### #
   #   #   # #   #   #   #       # #   #   #     # #     #   #           #     #   #   # # # # # #       #   # #   # # #     # #
 ### ### # ### # ### # # # ##### # ### # ### ### # # # ### ########### # ######### ##### # ### # ######### # # ### # ####### # #
 #       #   # #   # # #   #   # #   #       #   #   # #   #         # # #   #           #     # #       # #   # # #     #   # #
 ########### # ### # # ##### # # ### ######### ######### ### ####### # # # # ####### # # ####### # ##### # ##### # ### # # ### #
 #   #     #   #   # # #     # #     #       #     #   # #   #         #   #     #   # #     # # #   #   #   #   # # # # #     #
 # # # ######### ##### # ##### ####### ##### ##### # # # # ####### ############# # # # ##### # # ### # ##### # # # # # # # #####
   #   # #       #   # #     #     #   #   #   #   # # # #       # #       #       # #     #   #     #     # # # #   # # # #   #
######## # ######### # ##### ####### ##### ### # ### # # ####### ### ##### # ####### # # ################# # # # ### # ### # # #
 #   #     #     #   #     # #     # #   #     #     # # #       #   #   # # #   #   # #       #   #     # # # #     #   # # # #
 # # # ##### # ### ####### # # ### # # # ############# # ######### ### ### ### # ##### ### ### # # # ### # # # ######### # # ###
   #   # #   #     #     # # # #   #   #   #       #   #     #   #   # #   #   #       # #   #   # #   # # # # #       #   #   #
 ####### # ######### ### # # # ########### # ### ### ##### # # # ### # # ### ########### ### ##### ##### ### # # ##### ####### #
 #       #       #   #   # #         #     #   #   # #   # # # # #   #   #   #     #   # #   #     #     #   #   #   #   #   # #
 # ##### ####### # # ##### ##### ##### ##### ##### # # # # # # # # ########### ### # # # # ### ##### ##### ######### # ### # # #
 #   #             #     #     #       # #   #     # # # # #   #   #       #   #     #     #       #   #             # #   #   #
 ##### # ####### # ##### ##### # ####### # ### ##### ### ##### ##### ##### ################### ####### ### ##### # ### # #######
 #     # #     # # #   #       #       # # #   #     #   #   #     # #   # #     #     # #     #     #   # #   # #     #       #
 # ##### # ### # # # # ######### ### # # # # ### ##### ### # ####### # ### # ### # ### # # ##### # # ### # # # ############### #
   #   #     # # #   # #     #     # #   # #     #     #   # #       #   #   # #   #   #   #     # #   # #   #   #           # #
## # # # ##### # ##### ##### # ### # ##### ######### ##### # # ######### ##### ##### # ##### ##### ### # # ##### # ########### #
   # # # #     # #   #     # #   # #   #   #       # #     # # #         #   #   #   # #   # #   # #   # # #   #   #   #   #   #
#### # # ######### # # ### # ### # # # # ######### # ### ### # # ########### ### # ##### # # # ### ##### # # # ##### # # # # ###
     #             # #   #   # # # # # # #       # #   #   # # #   #         #   #       #   #   #       #   # # #   #   # #   #
 # ##### # ######### # # ##### # # ### # # ##### # ### ##### # ### # ######### ############### # ############# # # ### ####### #
 # #     # #   #     # #         #   #   #   #   # #   #     #     #   #     #       #   #     # #               # #   #     # #
 ### ####### # # ##### # ### ####### # ##### # ### # ### ##### ### ### # ### ####### # # # ##### # ##### ##### # # # ### ### # #
   #   # #   # # # #   #   #       # #       #     #   #     #   #       #   #     # # # #   # # # #   #     # # # # #   # #   #
 # ### # # ### # # # ##### # ####### # # ####### ##### ##### # # ##### ####### # ### # # ### # # # # ####### # # ### # ### #####
 # # # #   #   # #   #   # # #     # # #   #   #       #       #     #         #     # #   #   #   #       # # # #   #     #   #
 # # # ### ##### ##### # # # # ### # # # # # # # ####### ########### ####### ############# ### ##### ####### # # # ####### # # #
 #   #   # #     #     #   #   #   # # # #   # #         #     #   #       #           #             #   #   # #     #       # #
 ####### # # ######### ##### ### ### # ####### # # ####### ### # # ####### ##### ##### # ########### # # # ########### ##### # #
   # #   # # # #     # # #     #   # #     #   # #         # # # #       #     #     #   #         #   # #             #   # # #
 # # # ### # # # # # # # # # ####### ##### # ### ########### # # ####### ### # ##### # ### ####### ##################### # ### #
 #   #   #   #   # #   #   # #       #     # #   #         #   #       #   # # #   # #   # # #   #         #             #   # #
 ####### ####### # ######### # ####### ##### # ### ####### ########### ### ### # # # ##### # # # ######### # ##### ######### # #
     #   #       # #         #     # # #   # #   #       #     #     # # #     # #   #     #   #         #   #   #     #   # # #
## ### ######### # ######### ##### # # # ### # # ####### ### # ### ### # ####### ##### ########### ########### # ####### # # # #
   #   #   #     #     #         # #   #   # # # #     # #   #   #   #   # #     #     #           #           #  S    # #   # #
#### ### # ##### ##### # ####### # ####### # ### # ### ### ##### ### ##### # ##### ##### # ### ##### ################# # ##### #
     #   #     #     # # #   #   # #     #   #   # #       #   # #       # #       #   # #   # #   #       #   #       # # #   #
 ##### ####### ##### # # # # ##### # ### ##### ### ######### # # ##### # # ######### # # ### # # # ####### # ### ####### # # # #
 #     # #   #     # # # # # #     # #   #     #     #       # #     # #             #     # #   #       # #     #       #   # #
 # ##### # # ##### ### ### ### ####### # ### # # ### # ####### ##### # ####### ############# ##### # ### # ##### # ### ####### #
   #   #   #     #   #   #     #       #     # # #   # #   #   #     #   #   #     #   # #   # #   #   # #     # #   # # #     #
 ### ### ####### ### ### ######### ########### # # ### # # ### # ##### ### # ##### # # # # ### # ### ### ##### # ##### # # ### #
         # #   #   #   #   #     #   #     #   # # #   # #   # # #   # #   #         #   #   #   #   #   #   # #     # # # #   #
 # ####### # ##### ### ### # ### ##### ### # ##### ### # ### ### # # ### ### ############# # ####### # ### # # ##### # # # # ###
 #         #         # #   #   #     # # #   #     #   # # #   #   #     #   #     #     # # #       #   # #   #   # # #   #   #
 ### ### ############# # ##### ##### # # ##### ##### # # # ### ########### ### ### # ### # # ####### ### # ##### ### # # ##### #
   # # #     #         # #     #     # #     # #     # #   # # #   #   # #   #   # # #   # #     #   #   # #   #   # # # #   # #
 # # # ##### # ######### # ########### # ##### # # ### ##### # # # ### # ### ##### # ########### # # # ### # ##### # # ### # # #
 # #   #     #   #       #             # #     # # # # # #     # #     #   # # #   #   # #       # # #   # #     # #   #   #   #
 # ##### ####### ####################### # ####### # # # # ##### ######### # # # ##### # # ######### ### # # ##### ##### ##### #
 #     #   #   #     #           #       #   #     #         # #     #   # # # #   #   #   #           # # #             #     #
 ##### ### # ####### # ##### ### # ######### # # ##### ##### # ##### # ### # # ### # ################### # ####### # ####### # #
     #   # #       # #   # #   # #         # # # #     #   #   #     #     #         #     #   #   #     # # #     # #       # #
 ### ### ######### # ### # ### # ######### # # # ####### # ### # ####### ##### ##### # ### # # # # # ##### # # ##### ######### #
 #     #           #   #   # # #         #   # # #   #   #   # #     #   #   # #   #   #   # #   # # #     # #     #         # #
 ################# ### # ### # ##### ### ##### # # # # ##### # ##### # # # ### # # ### # ### ##### # # ##### ##### ######### ###
         #       #   # #     #   #   # # #     # # # #   # # #     #   # #     # #   # #     #     # # #   #     #     #   #   #
 ######### ##### # ### ### ####### ### # ### # # ### ### # # ### # ##### ##### # ### # ####### # ##### # ####### # # # ### ### #
 #     #   #     #   # #   #   #   #   # #   # #   # # #   #     #     #       #   # #   # #   # #   # #   #   #   # #     #   #
 # # ### ### ####### # # ### ### ### ### # ### ### # # ########### ### ##### # ### # ### # # ##### # # ### # ####### ####### # #
   #   #   #   #     # #     #   #         #   # #   #         #   #   #     # #   # #   #   #     #   #   #       #   #   # # #
 ##### ### ### # ##### ####### # ########### ### ############# # ### ### ### # # ### ### ##### ######### ######### # # # # # # #
 #   #   # #   #   #   #       # #     # #       #   #         # # #     #   # #   # #   #     #       #     #   # # # # #   # #
 # ####### # ##### # ### ######### ### # # ####### # # ######### # # ######### ### # # # # ##### ##### # # # # ### ### # ##### #
   #   #   # #   # #   #     #   # # # #   #   #   #   # #       # # #       #   # #   # # #   #   #   # # #   #   #   # #     #
#### # # ### # # ##### ##### # # # # # ##### # # ####### # ####### # # ##### ### # ##### # ### ### # ### # ### # ### ### # #####
     #   # #   #     #     #   #   # #     # #   #     # #   #     # # #   #   # #     # #     #   # #   #   # #     #   #     #
 ######### ######### ### # ### ##### ##### # ##### ### # ### # ##### # # ##### # ##### # ####### ### ####### # ##### # ### ### #
 #     # #         #   # #   # #       # #   #       #   #   #       # #     # # #   # #     #   # #       # # #     # # #   # #
 # ### # # ####### ### ##### # # # ### # ##### ########### ########### ##### # # # # # # ### # ### ####### # # # ### # # # ### #
 # #   #   #     # #   #     #   #   # # #   #   #         #   #     # #   #     # #   # #   #   # #       # #   #   # # # #   #
 # # ####### ### # # ### ##### ##### # # # # ### # ######### # # ### # # # # ##### ##### # ##### # # ############# ### # # # ###
 # #         # # # #     #       #   #   # # #   #       #   # #   #   # #   #     #   # #   #   #                 #   #   #   #
 ############# # # ####### ####### ### ##### ### ####### ##### ### ##### ### # ### # # # ### # ##################### ##### ### #
     #     #     #     #   #       #   #   #           #       #   #   #   # #   # # # #   # # #           #   #   # #   #   # #
 ### ##### # ##### # # ##### ####### ### # ####### ####### ##### ##### # # ##### ### # ### # # # ########### # # # # # # # # # #
 # #     # # #     # #       # #     #   # #       #     # #   # # #   # #     #     #   # #   # #       #   #   #   # #   # # #
 # ##### # # ####### ######### # ### ##### # ### ### ### # # # # # # ######### ######### # ##### # ##### # ####### ########### #
   #   # #           #           #   #     #   # #   #   #   # # # # #   #     #   #     #     # #     #   #       #         # #
 ### # # ####### ######### ##### # ### ######### # ########### # # # # # # ##### # # ######### # ##### ### ######### ####### # #
     # #     #   #     #   #   # # #   # #       #           # # #     #   #     #   #     #   # #   # #   #           #   # # #
 # ######### ##### ### ##### # # # # ### # ################# ### ######### # ####### # ### # ### # # # ##### ########### # # # #
 # #       #       # #   #   # # # # # #   #               #   #   # #     # #   #   #   #   #   # # #     #   #     #   # # # #
 ### # ############# ### # ### # # # # # ### ####### # ####### ### # # # ### ### # # ### ##### ### # ##### ### ##### # ### # # #
     #                 #   #   # #           #       #       #     #   #   #     # #   #           #     #           #   #   # #
