################################################################################################################################
#         #   #           #   #   #         # #               # #       # #     #   #       #             #                     
##### ### # # # ######### # # # ### ### ### # # ##### ####### # # ##### # # # ### # # ### # # ####### ##### ####### ##### # ### 
#     #   # # #     #   # # # #   #   #   # # # #   # #     # # #   #   # # #   # #   #   # # #     # #     # #   #     # # #   
# ##### ### # ##### # ### # ##### ### ### # # # ### # # ### # # ##### ### # ### # ######### # # ### ### ##### # ####### ### # ##
# #   #     # #   #   #   #     #     #   # # #   # # # # #   #   #   #       #   #       #   # # #     #             # #   #   
# # # ####### ### ##### ####### ### ### ### # ### # ### # ##### # # ##### ### ##### ##### ##### # ################### # # ######
#   #   #   # #                     #   #   # # # #     #       #       # #   #     #     #     # #       #   #   #   # # #     
####### # ### # ### ##### # # ####### ### ### # # ####### # ########### ### # # ##### ##### ##### # ##### # # ### # ### # # ### 
#   # # #       #   #   # # # #       #     #   # #     # #       #   #     # # #     #   # #   #   #   # # #       #   #   #   
# # # # ######### ### # # # # # ########### ### # ### # # ####### # # ####### # # ##### ### # ### ### ### ####### ### ####### # 
# # # # #   #   # #   # # # # # #       # #   # #   # # #   #   # # #   #   #   #       #   #   # #   #   #       #   #     # # 
# # # # # # # # # # ### ### # # # ##### # ### # ### # ### ### # ### ### # # ### ####### # ##### # # ### ### ####### ### ##### ##
# #   # # #   # # #   #     # #   # #   #         # # #   #   # #   #   # #   # #     # #     #   #     # #       #   #     #   
# ##### # ##### # ### ### ### ##### # # ######### # # # # # ##### ####### ### # # ### ####### # ######### ### ####### ##### ### 
# #     #   # #   # # #   #   #   # # # #     #   # #   # # #   #       #   # # #   #   #     #   #       #   #     # #   #     
# # ### ### # ##### # ##### ### # # # ### ### ### # ####### # # ####### ### # # ### ### # ####### # ####### ### ### # ### ##### 
# # #     #   #   # #     #   # # #   #   # #   # #   #   # # #   #   # # # # #   #   # #   #     #           #   # # #         
# # # # # ####### # ##### ### # # ##### ### ### # ### # # # # # ### # # # # # ### ##### ### # ##### ##### ####### # # # ### # # 
#   # # # #       # #   #   # # # #   # #     # #     # #   # #   # #   # # # #           # # # #   #   #   #     #   # #   # # 
##### # # # ####### # ##### # ### # ### # # # # # ##### ##### ### # ##### # ### ##### ##### # # # ### # ##### ########### # # ##
#     # #   #       #       #       #   # # #         #   #   # #   #   #       #     #     # #     # # #     #           # #   
# ##### ##### ##### ################# ### ####### ### ### # ### ##### ### ####### ### # ##### ##### # # # ####### # # ######### 
#     #     #   #   #   #           #   #       #   #     # #       #     #       #   #     #         # #   #     # # #   #   # 
##### # # # ### ##### # # ######### # # ####### ### ##### # # ##### ####### ####### ####### ####### ####### # ##### # ### # ### 
#     # # #     #     # #     # #   # #       # # #     # # #   # #   #     #   #   #     #       #     # # #   #   #     #     
# ##### # ####### ########### # # ##### ### # # # ##### ### # # # ### # ##### ### ### ### ####### # ### # # ### ################
# #   # #     #   # #       #   # #     #   # # #     #     # # # # #   #       #     #   #     # # #   # #   # #           #   
### # # # # ### ### # ##### ##### # # ####### # ##### ####### # # # ##### ##### ####### ### ##### # ##### ### # # ### ##### # ##
#   #   # # #   #   # #   #     # # #     #   #     # #       # # #     # #   # #     # #   #   # #       #   # #   #   #   #   
# ####### ### ##### # # ####### # ####### # # ##### # # # # # # # ##### # # ### # # # # # ### # # ####### # ### # ##### # ##### 
#     #     #     # # #   #     #     #   # #   #   #   # # # #   #     # #   #   # # # # # # # # #     # #   #   #     #   #   
# ### ### # ##### # # ### # ######### # ### ##### ####### # ####### ### # ### ##### ### # # # # # # ### # ### ##### ##### ### ##
# #   #   #     #   #     # #   #     # #   #     #     # # #     #   # #   #     #     #   # # #   # # # # #     #   #   #   # 
# # ### ######### ####### # # # # ##### # ### ####### # # # # ### ### # ### ##### ######### # ####### # # # ##### # # ##### ### 
# #   #       #   #       #   # # #     # # #   #     #   # # #   #   #   #     #           # #         #   #     # # #     #   
# ### ######### ### ########### # # ##### # ### # ######### # ##### ##### ##### ######### ### # ########### # ####### # ##### # 
#   #     #     # #         #   #   #         # #     #   # # #   # #       # # #     #   #   # #         # #   #   #   #     # 
# ####### # ##### ######### ######### ####### # ##### # # # # # # ### ##### # # ### ### ### ### ######### # ### # # # ######### 
#   #     #   #   #     # #   #       #     # #     # # # # #   #   # #   #   #   #       #   #     #   #     # # # # #   #   # 
### # ####### # # ##### # ### ####### # ### # ##### ### ### ####### # # # ####### # ### ##### ##### ### # ##### ### # ### # ### 
#   # #     # # # #   #   # # #     # # #   #     #   #     #     # # # #         #   #     # #   #   #   #     #   #   # #     
# ### # # ### ### # # ### # # # ### ### # ### # ##### ####### ### # # # ########### # ####### ### ### ### # ##### ##### # # ####
#   #   #     #     #     # #   # #   # # #   #     # #       # # # # #             #   #   # #   # #   # #       #   #   # #   
### ########### ####### ### ##### ### # # ######### # # ####### # # # ######### ####### # # # # ### ### # ######### # # ### # ##
#   #   #     # #     # #   #       # # #         # # #         # #           # #     #   # # #       # #   # #   # #S#   # #   
# ### # ##### # # ### # # # # ### # # # ######### # # # ####### # # ######### # # ### ##### # # ####### # # # # # # # # ### ### 
#   # #     # # # #   #   #   #   # # # # #   #   # #   #   #   # # #       #   # #   #     # # #     #   # # # # # # #         
# # # ### # # # # # ### ####### ##### # # # # # ### ##### # ##### # # ##### ##### ########### # # ### ##### # # ### # ##########
# #   #   # # # # #   #       #   #   # #   # # #       # #       # #   # #       #             # #     # # # #     #           
# ##### ##### # # ### ##### # ### # ### ##### # # ####### ######### ### # ######### ############# ##### # # # ################# 
# #   #     # # #   #   # # #   # # #   #   # # #   #     # #       #   #       #             #   #   #   # #       # #   #     
# ### ##### # # # ##### # # ### # # # ### ### # ##### ##### # # ##### ### ### ### ####### ##### ### # ##### # ##### # # # # ####
# #   #   #   #   #   # #   #   # #   # #   # #     # #   #   #   #   # #   #   # # #   # #   #   # #   #   #     # #   # # #   
# # ### # ##### ### # # ### ##### ##### ### # ##### # # ### ##### # ### ### ### # # # # ### # ### # ### # ####### # ##### # ### 
# #   # #     # # # #   #   #   # #   #           #   #   # #   #   #   #   #   #   # #     #     #   #   #       # #     # #   
# ### # ##### # # # ######### # ### # ########### ##### # # ### ##### # # ### ##### # ############### ##### ####### # ### # # # 
#   # #   # # #   #     #   # #     # #         #       #             # #   # #   # #       #   #   #       #       #   # #   # 
# # # ### # # # ####### # # # # ##### # ####### # ##### ############# # ### # ### # ####### ### # ########### ####### # ####### 
# #   #   #   #   #   # # #   # #   # # #       #     # #           # #   # # #   # #     # #   # #                   # #       
# ##### ####### # # # # # ##### # # # # # ####### ### # # ######### # ### # # # ### # ### # # # # # ######### ########### ######
#               # # # # #   #   # # # # # #       #   # # #       # #   #   #     #   #   #   #     #       #     #   #   #   # 
# ### ######### # # # ##### ##### ### ### # ##### ##### # # ##### # # ############### # # ##### ##### ##### # ### # # # ### # # 
#   #     #   # #   #     #       #   #     #   # #   # #   #   # # #     # #         # #       #     #     #   # # # #     #   
# # ##### # # # ######### ######### ### # ### # ### # ####### ### # ##### # # ####### # ######### ############# # # ####### ####
# # #   # # # #   #     # # #       #   # #   #   # #   #         #     #   # #       # #   #     #           # # # #       #   
# # # # # # # ### # ### # # # ######### # # ##### # ### # ############# ### # ####### # ### # ##### ######### # ### # ####### # 
# #   # # # #   #   #   #   # #         # #     # # #   # #           #   # #       # #     # #     #     #   #     # #   #   # 
# ##### # # ### # ### # ##### ##### # ### ##### ### # ### ########### ### # ####### # ####### # ######### # ####### # # # # ####
#   #   # #   # # #   # #   #     # #   #     # #   #   #     #     #     #     #   #       #   #         # #   #   # # # #     
# ### ### ##### # # ##### # ##### # ######### # # ########### # ### ############# ### # # ########### ### # # # # # # # ####### 
# #   # #     # # #       #     # #   #     #       #   #     #   #               #   # # #     #   # #   # # #   #     #     # 
### ### ##### # # ########### ### # ### ### ##### ### # # ########### # ########### # # ### ### # # ### # # ########### # ##### 
#   #       #   #           #     # #   #   #     #   # #   #     #   # #           # # #   #   # #   # # #       #       #     
# ####### # ##### # ################# ####### ### # ### ### # ### # ### # # ##### ### # # ### # # ### ### ####### # ### ### ####
# #     # #     # #         #       #         #   # # #     # # # # #   # # #   #   # # #   # # #   # #         # # # # #   #   
# # ### # ##### # ##### ### # # ### ### ####### ### # ####### # # ### ### # # # ### # ##### # ####### # ####### # # # # # ### # 
# # #   # #     # #   #   # # #   # #   #       #   # #       # #   # #   # # # #   # #   # # #   #   #   #     # #   # #   # # 
# ### ### # ##### # # ### # ####### ##### ##### # ### # # ### # ### # # ##### # # # # # # # # # # # ####### ##### ##### ### # ##
# #   # # #     #   # #   #       #     #   #   #   #   #   # #   #   # #     #   # #   #   #   #   #       #     # #           
# # ### # ##### ##### # ######### ##### ### # ##### ######### # ####### # ######### ################# ##### # ##### # # ####### 
#   #   # #     # #   #         #   #       #     #     #   # #       # #   #   #   #             #   #     #     #   #   #   # 
####### # # ### # # ##### ##### ### ####### ##### ##### # # # ##### # # ##### # # ### ### # ##### ##### ######### ##### ### # # 
#     # # # #     #   # # #   #   #       # #         #   #   #   # # #   #   # # #   #   #   #   #   # #   #     #   # #   #   
# ### # # # # ####### # # # ##### ####### ### ####### ######### # # # # # # ### # # ### ####### ### # # # # # ##### # ### ##### 
# #   #   # # # #   # #   # #       #   #   #   #   #           #   #   # # #   # #   #   #   # #   # # # # #   #   #   # #   # 
# ######### # # # # # ##### # ### # # # # # # ### # ##### # ####### ####### ##### ### ##### # # # ### # # # ### # ##### # ### # 
#   #   #   #   # # # #   #   #   # # # # # # #   #       # #     # #     #   #       #     # #   #   # # #   #   #   #   #   # 
### # # # ##### # ### # ####### # ### # ### # # ########### # ### # # ### ### # # ##### ##### ##### ### # ### ####### ##### ### 
# # # # # #     #   # #         # #   #     # #     #   #   # # # # # # #   # # #     # #   #     #   # #   #   #     #   #   # 
# # # # ### ### ### # # ####### # # ################# # # ### # # # # # ### # ### ##### ### ##### ### # ####### # # ### # # # # 
# # # #G  # #   # #   # #     # # #       #     #     # #   # # # # # #   #   #   #   #   #     #   #     #   # # # #   #   # # 
# # # ### ### ### ##### # ### # ######### # ### # ##### ##### # # ### # # ##### ### # ### ##### ### ####### # # # # # ####### # 
# #   # #   #           # # #   #         # #   #   # #       # #   # # # #     #   #     # #   #   #       # # # #         #   
# ##### ### ############# # ### # ######### # ##### # ######### ### # ### ####### ######### # ### ### ####### # ########### ####
#     #   #               #     # #         # #   #   #         # # #   # #   #   # #   #       #     #     # #       #     #   
##### # ##### ################### # ######### # # ##### ##### ### # ### # # # # ### # # # # # ######### # ### ####### # ##### # 
#     # #     #                   #       # # # #     #     #     #   # #   #   #   # # # # #     #   # #   #   #         #   # 
# ##### # ### # ######################### # # # ##### # ### ######### # ######### # # # # # # ### # # # ### ### ### ##### # # ##
# #   #   #   # #   #           #   #   # # #   #   #   # #           #     #   # # # #   # #   # # #   #     #   #     #   #   
# # # ### # ### # # # ####### ### # # # # # ##### # ##### ################# ### # ### ##### ### # # ##### ####### ### # # ##### 
#   # #   # #   # # #   #   #   # # # # # #       # #     #                 #     #   #   # #   #       #       #   # # #   #   
##### ##### # ##### # ### # ### ### # # # # ####### # # # # ### ### ######### ##### ##### # ######### # ####### ### # # ##### ##
#   #       # #     # #   #   #     # #   #       #   # #     #   #                 #   # #     #   # #     #     # # # #   #   
# ######### # # ##### # ##### # ##### ##### ##### ##### ##### ### ##### ### ### ####### # ##### # # # ##### # ### # # # # # ####
#     #     #   #   #     # # #     # #   #     #     #     # #   #   # # #   #     #   # #   # # # # #   # #   # # # #   # #   
##### ### # ##### # ##### # # ### ### # ##### ####### ##### # # ### ### # ### # # ### ### # # # # # # ### # ### # # # ### # # # 
#   #     #       # #   # # #   #             #     # # #   # #   # #   #     # #     #     # #   # #   #     # # # #   # #   # 
# ######### ### ### # # # # ### ####### ####### ### # # # ### ### # # ######### ####### ########### ### ####### ### # # ##### # 
#         #   #   # # # # #     #     #       #   #   # # #   # # #   #     #                   # #   #   #   # #   # #     # # 
######### # # # # # ### # ####### ### ####### ### ##### # # # # # ##### ### # ############# ### # ### ### # # ### ### ##### ### 
#           # # # #     # #       #   #     # #   #     # # #   #   #     # #   #   #     #   #   # #   # # #   # # # #   #   # 
# ######### # ### ####### # ####### ### ### ### ### ### # ######### # ##### # # # ### ### ### ##### ### ### ### # # # # # # # ##
# #       # #   #     #     #     # #   # #     #   #   # #       #   #     # #   #   #   # #         # #   #   # #   # # # #   
### ##### ##### ### # # ######### # ##### ########### ### # ##### ##### ### ####### ### ### # # # # # # # ### ### # ##### ### # 
#   #   #       #   #     #       #   # #       #   # #   # #   #     # #   #       #   #     # # # # #   # #   # #     #   # # 
# ##### ######### # ##### # ######### # # ##### # # # # ##### # ##### # ### # ####### ########### # ####### ### # # ### ### ### 
# #     #         # #   #         #   #   #   # # #   #       # #     #   # # #     #     #       #           #   #   # # # #   
# # # # # # ### ##### # ######### # ####### ### # ############# # ####### # # # ######### # ### ### # # ##### ####### # # # # # 
# # # #   # #   #   # # #   #   # #       #   #   #         #   # #   #   # # # #       # # #   #   # # #   #         # # #   # 
# # # ####### ### # # # # # # # ######### ### ### # ######### ### # ### ##### # # ####### ### ####### ### # ##### ##### # ##### 
# # #       #     #   #   # # # #         #         #   #   #     #   #     # # #         #   #       #   # #     #     #       
# ### ##### ############### # # # ####### ####### ### # # # ######### ##### # # ########### # ######### ### # ################# 
#   # #     #             #   # #   #     #     # #   # # # #     #       #   #   #         # #   #   # #   #   #     #         
### ### ##### ### ##### ####### ### # ##### ### # # ##### # # ### # ##### ####### # ### ### ### # # # # ##### # # ### # # ######
# #   #   #   #   # #   #     #   # # #   # #   # # #   # # #   #   #     #   #   #   # # #   # #   # #   #   # # # # # # #     
# ### # # # ### ### # # # ####### # ### # ### ### # # # # ##### ##### ##### # # ##### # # ### # ##### ### # ### # # # # # # ### 
#     # #   #   #     # #         #     #     #       #         #           #         #     #       #     #   #   #   # #   #   
