################################################################################################################################
   #   #     #     #     # #             #   #         # #   #                     #     #     # #     #   #               #   #
## # # # ##### ### # ### # # ########### # # ######### # # # # # ##### # ######### # ### # ### # # ### # # # ############# # # #
   # # # # #   #   #   #   # #     #     # #     #   #     # # #     # # #   # #   # # #   #   # # #   # # #           #   # # #
 ### # # # # ### ######### # # ### # ##### ##### # ##### ##### ##### # ### # # # ### # ##### ### # # ### # ########### ##### # #
 # # # # # #   #   #     #   #   # #     #   # # # #   # #     #   # #     # #   #     #     #   # #     #           #   #   # #
 # # # # # ### ### # ### # ##### # ##### ### # # # # ### # ##### # # # ##### ##### ##### ##### ### ######### ####### ### # ### #
 #   # #   #   # #   #   # #     #     #   # #   #     # # #     # # #     #     # # #   #       #   #   # #     #   #   #   # #
 # ####### # ### # ### ### # ######### ##### # ####### # # ##### # # ##### ##### # # # ### # ### ### # # # ##### # ### ##### # #
   #   #   # #   # #   #   #         #       #     #   # #     # # #   # #     #   #   # # #   #   #   # #     # # #   #   # # #
 ### # # ### # ##### ### # ######### # ########### # # # ##### ### ### # ### # ######### # ### ### ##### ### # # ### ##### # # #
 #   #   #   #   #   #   # #   # #   # #     #   # # #       # #   # # #     #       #   # # # #       #     # #     #     # # #
 # ####### ##### # ### ### # # # # ##### ### # # # # ##### # # # ### # ######### # # # ### # # # ############# ####### ##### # #
 #   #   # #   # # # #   # # # # # #     #   # # # # #   # #         #     #     # #   #   # # #           # # #             # #
 ### # ### # ### # # ### # # # # # # ##### ### # # ### # # ############### # # ##### ### ### # ####### # # # # # ###############
   #   #   # #   # #     #   #   # # #     # # # # #   #   #           #   # #     #   #   # #   #     # #   # #           #   #
 # ### # ### # ### ######### ### # ### ##### # # # # ##### # ######### ########### ####### # ### # ########### # ######### # # #
 #     # #   # #   # #       #   #   #     # # # #   #   # #   #     #       #   # #     #   # # #   #     #   #   #   # #   # #
 ####### ### # # ### # # # ### # ### ##### # # ######### # ### ##### ##### # # # # # # ##### # # ##### ### # ##### # # # ##### #
     #   #   #   #     # #   # # # #       #                         #   # # # # #   #   #   # #         #       #   #   #   # #
 ##### ### ####### ##### ##### # # ############# ##### ##### ######### # ### # # ##### # # ### ################# ####### ### # #
 #   #   #         #   #   #   #   #     #       # #   #   #       #   #   #   # #   # #             #         #       #   #   #
 # # ### ##### ### # # # # # ##### ### # # ####### # ### # ### ### # ##### ### # # # ############# ### ####### # # ####### #####
 # #   #     # #   # # # # #     #     #   #         #   #   # # #   #   #   # # # #   #   #     # #   #     # # #   #   #   # #
 # # ####### # # ### ### ####### ########### ### ##### ##### # # ##### # # # # # # ### # # # ### # # ####### # # ##### # ### # #
 # #       # # #   #     #     # #   #       #   # #   #     #   # #   # # # # #   # #   #   # # # #     # # # #       #   # # #
 # ### # # # ############# ### # # # ### ##### ### # ### ####### # # ### # # ### ### ######### # ####### # # # # ######### # # #
     # # # # #       #   # #   #   #   #     #     #   #     # #   # #   # #   #               # #   #   # #   #     #   #   # #
 ##### # # # # ##### # # # # ######### ##################### # ### # # ### ### ##### ########### # # # ### ##### ### # # ##### #
   #   # # # # #     # #   #         # #   #     #     #   # #   # # #   # #   #   #   #       #   # # #   #   #   #   #       #
## # ##### # # ####### ############# ### # # ### # ### # ### ### # # ### ### ### # ### # ##### ### # # ### # # ######### #######
   #     # # # #     # #     #   # #     # #   # #   # #   # #     #   #   # #   # #   #     #   # # #   # # #         #     # #
 ####### ### # # ### # ##### # # # ####### ### # ### # ### # ##### ### ### # # ### ######### ### ### ### # # ######### ##### # #
 #     #     #   # # # #     # # # #   # #   # #   # # #   # #   # #   #     #   #   #     # #     # #   # #   #     #     #   #
 ### ############# # # # ##### # # # # # ### ##### # # # # # # # # # ######### ##### # ### # ##### # # ### ### ##### ##### # ###
   #       #         # #     # #   # #   # #     #   # # #     #   #       #   #     # #   #   # # #   #     # #   #     # #   #
## # # ##### ######### ##### # ##### ##### ##### ##### ########### ####### # ### ####### ##### # # # ### # ### # # # ### # ### #
     #                 # #   # # #   #   # #   # #   #   #     #   #     # #   #       # #   # #   #     #   # # #   #   #   # #
 ################# ##### # ### # # ##### # # # # ### ### # ### # ### ### ##### ####### # # # # # ### # ##### # ####### ##### # #
 #               # #   #                 # # #   #   # #   #   #       # #   #   #     #   #   # #   # #     # #   #   #     # #
 # ############# # ### # ##### # ### ##### # ##### ### ##### ######### ### # ### # ############# # ### ####### # # # # # ##### #
 #     #       # #           # #   # #   # # #   # #       #   #     # #   #     #   #   #     # #   #   #     # # # # #   #   #
 ##### # # ##### ########### ##### # ### # # # ### # # ### ### # ### # # ########### # # # # ### ### ### # ##### # # # ### # ###
 #   # # # #     #       # #   # # #     # # # #   # # # #   # # # # #   #   #     #   #   #     #   #   #     # #   #   # # # #
 # # # # ### ##### ##### # ### # # ### ### # # # ##### # ### # # # # ### # # ### # ################### ####### ####### # # # # #
   # # #   # #     #     #   # # #   #     # # #       #   # #   # #   #   #     #   #   #     #     #   #     #     # # # # # #
#### # ### # # ##### ####### # # ### # ### # # ######### ### ##### ### ############# # ### ### # # # ### # ##### ### # ### # # #
   # #     #     #   #     # # # #   #   # # # #   #   #     # #     # # #           #   #   # # # #   # # #   # # #   #   #   #
 # # ##### ####### ### # # # # # # ##### # # # # # # ### ##### # ##### # # ############# ### # # # ### # # # ### # ### # #######
 # #     # #     # #   # # # # #   #     # # # # # # #   #       # #         #           #   # # #   #   # # #   # # # #       #
## ### ### ##### # ##### # # # ##### ####### # # # # # ######### # # ####### # ### ####### ### # ####### # # # ### # # ####### #
   #   #   #   #   #   # # #   #     #   #   # # #   # #           #   #   #   #   #     # #   # #   #   # # # # #   # #   #   #
 ### ### ### # ##### # ### ##### # ### # # ### ##### # ### ##### ### ### # ######### ### # # ##### # # # # # # # # ### # # # ###
 #     #   # #   #   #   #       #     # # #       #       #   # #   #   #         # # #   #       # # # # # # #   #   # # # # #
 # ### ### # ### ####### # ##### ######### ####### # ####### # # # ### ########### # # ############# # ### # # # ### ##### # # #
 # #   # #   # #     #   # #   #       #   #     #   #     # #     #   #   #     #   #             # # #   #   #   #   #   # # #
 # # # # ##### ##### ### # # # # ##### # ### ### ##### ### ####### # ### # ### ####### ##### # ### # ### ######### ### # ### # #
 # # # # # #       #   # # # # #   #   # #     #       # #     #   #   # #   #         #   # # # # #     # #     # # # #   # # #
 # # ### # # ##### ### # # # # ##### ### ##### ######### ##### # # ### # ### ##### ##### # # # # # ####### # ### # # # # # # # #
 # #   #   # #   #   # # # # # #   #   # #   # #     #       #   # #   # # #     # #     #   #   #   #   # # # # #   # # # #   #
 # ### # ### # ##### # # # # ### # ### # # # # ### ### # # # ##### # ### # ##### ### ############### # # # # # # ### # # # #####
 #   #   #   #     #   # # #     #     # # # #   # #   # # # #     #   #       #   # #   #     #   # # # # # # #     #   #     #
 # ####### ####### ##### # ############# ### ### # # ### # ### ####### ####### ### # ### # ### # # # # # # # # ######### #######
 # #     # # #   # #   #             # #   # #   # #   # # #   #       #     #   # #     # # #   # #   #     #         # #     #
 # # ### # # # # # # # ### ##### # # # ### # # ### ### # ### ### ####### # ##### # ####### # ##### ####### ### ######### # ### #
   #   # # #   #     #     #     # #   # #   # #       #     #   #   #   # #     #   #   #   #   #       #     #   #     # #   #
 ##### # # # ####### # ########### ##### ##### # ############# ### # ##### # ####### # # ### # # ####### ### ### # # ##### # ###
     # # # # #     # #     #   #       #     # #     # #     # #   #   #     #     #   #   # # # # #   #   #     #     #   # # #
 ##### ### ### ### # ##### # # ##### # ##### # ##### # # ### # # ##### ##### ##### ##### ### # # # # ##### # ########### ### # #
         #     #   # #   #   # #   # # #     #     # # # # # #   #   #     # #     #   #     # # # # #     #     #     # #   # #
######## ##### # ### # # ##### # # ### # ######### # # # # # ##### ####### # # ### # # ####### # # # # ####### # # ### # # ### #
       #       # #   # # #   # # #     #     #     # # # # #   #         # #   # #   #   #   # #   #   # #   # # #   #   # #   #
 ##### # ### ### ##### ### # # # ########### ####### # # # ### ######### # ##### ####### ### # ######### # # # ### ####### # # #
 #     #   #   #     #     #   #     #     # #     #   #   # #     #     #     # # #   #   # # #       # # # #   # #   #   # # #
## ################# ########### ### # ### # # ### # ####### ##### # ### ##### # # # ##### # # # # ##### # # ### # # # # ### ###
   #                 #             #   #   #   #   #     #       #   #   #     #   #   # # # # # # #   #   #   #   # # #   #   #
 ##### ############### ### # # ### ##### ####### ### ##### # ### ### # # # ####### ### # # # # ### # # ####### # ### # ### ### #
       # #       #   # #   # # #       # #     # # #     # # # # #   # # #       #     # # # #   # # #         # #   #   # #   #
######## # ####### # # ### # # # # ##### # ### # # ##### # # # # # ### # ####### ##### # # # ### # # ####### ### # ####### # # #
     #   # #       # # #   # # # # #     # # #   #     #G# # # #   #   #     # #     #   # #       # #     #     #         # # #
 ### # # # # ####### # # ### ### # # ##### # ######### # # # # ##### ##### # # ##### ### # # ####### # ### # ################# #
 # # # #   #   #   #   #   #   # # #   #   #         #     #   #     #   # #   #     #   # #       # #   # #   #               #
 # # # ####### ### # ######### # # ### # ### ### ### ########### # ### # ### ### ##### ### # ##### # ##### # # # # ####### #####
 #   #   #   #     # #         # #   # # # # #   #     #     #   # #   #   #   # #     #   #   # #   #     # #   #   #     #   #
## ##### ### ####### # # ####### ##### # # # # ####### # ### # ### # ##### # # # ### ### ##### # ##### ##### ####### # ##### # #
   #   # #       #   # # #     #     #   #   #   #   #   # #   #   #   # # # # # #   #   #         #   #     #       #       # #
 ##### # # # # # ### # ### ### ##### ####### ### # # ##### ##### # ### # # # # # # ### ### ##### ### ### ##### ####### ####### #
     # # # # # #   # #       #     # #       # # # # #   # #   # #   #   # # #                 #   #   # #     #       #   #   #
#### # # # # # ### # ############### # # ##### # # # # # # # ### ### ##### # ################# ### ### # # ##### ##### # ### # #
 #         # #   #     #             # # #     #   # # #       # # #     # #       #       #   #   #   # #   #   #   # #     # #
 # ############# # ##### ############# # # ##### ### # ####### # # # # ### # ##### # ##### # ####### ### # # ##### # ######### #
 # #   #     #   # #   # #   # #   #   #   #   #   # #   #   #   # # # #   # #   # #   #   #   #   #   # # #       # #       # #
 # # # # ### # ### # # # # # # # # ### ##### # ### # ##### # ##### # # # ### # # # ### # ##### # # ### # ########### # ##### # #
   # #   # #   #   # # # # # # # #   #   #   #   # #   #   #   # #   # #   # # # #     # #   #   #     # #         #   #     # #
#### ##### ### ##### # # ### # # ### ### # ##### ##### # ##### # ### ##### # # # ####### # # # ########### ####### ##### #######
   # # #       #     #   #   #   # #     # # #   #   # # #     #     #     #   #       #   # #     #     #   #     #   #       #
 # # # # ### # # ######### ####### ### ### # # ### # # # ####### # # # ############### ##### ##### # ### # ### ##### # ####### #
 # # #   #   # #         #     # #   # #   #       #   #       # # # #  S#           #   #   #   # # # # # #   #     #   #   # #
 # # ### ##### ######### ##### # ### # # ########### ######### # # ##### # ############# # ### # ### # # # # ### ####### # ### #
 #   #   #       #     #     # # # #   #     #       #       # # # #   # #             # #     #       #   # #   #     # #     #
 ######### ### # # ##### ##### # # ### ##### ####### # ####### # # # # # ########### ### ############# ##### # ####### # ##### #
 #         #   #   #   #       #     #   #   #   #   #   #   # # #   # #     #   # # #   #     #     #     #   #   # # #     # #
 ##### ############# # ############# ### # ### # # ### ### # # ############# # # # # # ####### # ### ### ######### # # ##### ###
     #       #   #   # #   #       #   # #   # #   #   #   #   #           #   # #   # #     # # # # #   #     #           #   #
 ### # ##### # # # ### # ### ##### ### # ### ####### ### ####### ##### ### ##### # ### ### # # # # # # ### ### # # ######### # #
   # #     #   # # #   #     #       #   #   #         # #   #   #   # # #   #   # #   #   #   # #   #     # # # # #       # # #
## # ### ####### # # ############### ### # ### ####### # # # # ### # # # # ### ### # ### # ##### ##### ##### # # # # ##### ### #
   #   #       #   # #                 # #       #   # # # # #   # # # #   #   #   # #   # #   # #   #       # # # #     #     #
 ##### ########### # ######### ####### # ######### # ### # ##### ### # ##### ### ### ##### # # # # # # ### ### # # ##### ##### #
 #   #           # # #       # #     # #     #     #     # #   # #   #   #   #   #         # #   # # #   #   # # #   #   #     #
 # # ### ####### # # # ##### ### ### # ##### # ########### # # # # # ### # ##### # ######### ##### # ####### # ##### # ### ### #
 # #   #       # # # #     #   # # # #       #         #     # # # #   #   #   #     #         #   #   #     # #     #   # #   #
## ### ######### # # ##### ### # # # ##### ########### # ##### # ### # ##### # # ##### ######### ##### # ##### # ####### # # ###
   #   #         # #     # #   # # #   #   #   #     # #   # # #     # #   # # #     #   #     # # #   #     #         # # #   #
 ### ### ######### # ##### # ### # ### ##### # ### ### ### # # ####### ### ### # ### ### # ### # # # ### ### ########### # #####
   #     #         #   #   # #   #   #   #   # #   #   #   # #         #   #       #     # #   # # #   #   #   #     #   #     #
## ####### # ### ##### # ### ### # # ### # ### # ### ### ### ########### ### ### ######### # ### # ### ####### # ### # ### ### #
 #     #   # # #     #   # #   # # #     # #   # # #   # #       #       #     #         # #   #     #     # # #   #   #   # # #
 # ### # ### # ##### ##### ### # # ######### ### # ### # # ##### # # # ### ### ### # ### # ### ##### ##### # # ### ##### # # # #
 # # # #   #   #   #   # #     # # #   #   # #   #   # #   #   #   # #   # # #   # #   # #   #     # #     #   #   #   # # # # #
 # # # ######### # # # # ####### # # ### # # # ### # # # ### # # ### # # # # ### # ### ##### ##### # ########### ### # # # # # #
 #   #     #   # #   #   #       # #     # # #     # #   #   # # #   # #   #   # #   #   #   # #   #   #         #   # # #   # #
 ######### # # # ##### ########### ####### # # ####### ### ### ### ### ####### # ### ### # ### # ##### ########### ### ##### # #
         # # # # #         #     #     #   # #         #   #   #   #   #     #   #   #   # #   #     #   #   #   # #       # # #
######## # # # # # ####### # # ####### # ### # ######### ### ### ####### ### ##### ### ### # ##### ##### # # # # # ####### # # #
   #   #   # # # # #   # # # #       # # #   # #   #     #   #     #   # # # #   #   #   # #   #   #   # # # # # #   # #   # # #
 ### # ##### # # # # # # # # ##### ### # # ### # # # ##### ### # # # # # # # # # ######### ### # ### # # # # # # ### # # ##### #
     #       #   #   #   #       #               #   #     #   # #   #     #   #               #     #   # #   #     #         #
