################################################################################################################################
               #   #         #     #         #       #     #   #       #     # #       #         #          G      #       #   #
 ##### ##### # ### # ####### ##### # ####### # # ### # ### # # # # ### # ### # # ##### # ##### # # ### # # ####### # # # # # # #
 #   # #     #       #     #       #   #       #   # # #   # #   #   # #   # # # #     #     # #   # # # # #     #   # # #   # #
 # # ### ######### ### ### # ########### ######### # ### ############# ### # # # ####### ### # ##### # # # # # ####### # #######
   #   # #   #   #   #   # #     #       #     # # #     #   #       # #   #   #   #   # #   # #   # # # #   #       # #       #
 ##### ### # # # ### ### # # # # # ####### ### # # # ####### # ##### # # ######### # ### # ### ### # # # ######### ### # ##### #
     #     # # # #     # # # # # #   #   # #   #   #         #   #   # #       #   # #   #   #     # # #   # #   # #   #   #   #
#### ####### # # ### ### # # # ##### # # # # ####### ### ####### # ### ### ##### ### # ##### ### ### # ### # # # # # ##### # # #
     #   # #   #   # #   # # #     # # # # #       #   #   #   # #   #   #     # #     #   #   # #   # #   #   #   # #   # # # #
 ####### # ####### # # ### # # # ### ### # ####### ### # # # # ##### ### # ### # ##### ### ### # ### # ########### # # # ### # #
 #       # #   # # # # # # # # #   #   # # #       # # # #   #     # #   # #   #     #   #   # #     #           # #   #   # # #
 ##### ### ### # # ### # # # # ### ### # # # ####### # # ### ### ### # ### ######### ### # # # # ######### ##### ######### # ###
 #   #   #       #     #   # #   #     # # #       #   #   #   # #   #     #         #   # # # # #       # #   #       #   #   #
 # # ### # ################# # # ####### # ####### # ##### ##### # ### ##### ######### ##### # # # ##### # # # ####### ####### #
   #       #   #     #       # #         #   #   # # #   # #   #   #     #   #     # # #     # # # #     #   # #   #   #     # #
###### ##### # # ### ######### # ##### # ### # ### # # # ### # # ### ### # ####### # # ##### # ### # # ##### # # ### ### ### # #
     # #     #     #   # #   # # #   # # #   #   # # # #     # # #   #   # #   #   # # #     #     # # #   # # # #   #   # # # #
 ### # # ##### ##### # # # # # # # # # # # ##### # # # ####### # # ### ### ### # ### # # ########### # # # ### # # ### ### # # #
   # # # #   # #   # # #   #   # # #   # #     # # # # #   # # #     #   #   # #   # #   #           # # # #   #   #   # # # # #
 # # # # # # ### # # # ######### ##### ####### # # ### ### # # # ####### ### # ### # ### # ##### ##### # # # ####### ### # # # #
 # #   # # #     # # #         #   #   #       # #           # #   #       # # #   #     # #   # #   # # # # #   #         # # #
## # ### # ####### ########### # # ##### ####### ####### ##### # # # ####### # ### ### ##### # # # # ### # ### # # ######### # #
   # #   #       #             # # #     #   #     #   # #     # # #         #   #   # #     # # # #     #     #   #     #   # #
 ### # ######### ################# # ####### # # ### # ### ##### # ############# ### # # ##### ### ################# ### # ### #
 # # # # #     # #   #       #   # #       #   # #   #   # #     #                     # #     #   #   #     #     #   #   #   #
 # # # # # ### # # ### ##### # # ######### # ### # ##### # ### ##### # ####### ####### # # ##### ### # # ### # ####### ####### #
   #     # #   #   #   #   # # #       #   # #   #     #   #   #   # # #     #       #   # #     #   # # #   #       # #       #
 ####### # ######### ### # # # ####### # ### ######### ##### ### # # # # # ######### ####### ##### ### ### ######### # ##### ###
 #     #       #     # # #   #   #   # # # #         # #   #     # # #   #     #   # #       #       #   #         # #     #   #
## ### ####### # ##### # ####### # ### # # # ### ### # ### ####### # ### ### ### # # # ####### ######### # ##### # # ##### #####
   #       #   # #   # #       # #   #   # #   #   # #   #     #   #   #   #     # #   # #   # #   #     # #   # # # #   #     #
 ######### # # # # # # ##### ### ### ##### ### ### ##### ##### # ##### # ######### ##### # # # ### # ####### # ### # ### ##### #
       # # # #   # # # #     #   #     #         #   # #     #   # #   #         # #   #   # #   # #   #     #   #       # #   #
###### # # ### ### ### # ##### ### ### # ####### ### # ##### ##### # ### # ### # # # # ##### ### # ### # # ##### # ##### # # ###
       # #   #     #   #   #   #   #   # #     # #   #     #   #   # #   #   # # # # #         #   #   # #   #   # #   #   # # #
 ####### ### # ### # ##### # ### ### ### # ### ### ####### ### # ### ####### # ### ######### ##### ######### # ##### # ### # # #
     #     # #   #       # #     # # #   #   #   #   #     #   #     #     # # #   #   #   #     # #         #   #   # #   #   #
#### # # ### # # ######### ####### # # ##### ### ### # ##### ####### # ### # ### ### # # # # ##### # ########### # ### # # #####
   # # # #   # # #     #   #       # #     # # #   #   #   # # #     # #   #   #     # # #   #   #   #       #   #   # # #     #
 ### # # # ### # # ### # ### ### ### # ### # # ### # ### ### # # ##### ####### ####### ##### # # ##### ####### ##### # ####### #
     # # # #   # # # # #   #   # #   #   # # #   # #       # #   #   #       #       #     # # # #     #       #     #   #   # #
######## # # ### # # # ### ### # # ### # # # ### # # # # # # ##### # ####### # # ######### # # ### ##### ####### # ##### # # # #
         # #   # #   #   #     #   # # # # #   #   # # # # #     # #   #   # # #     #     # # #   #   #     #   #   #   # # # #
 # # ##### ### # ### ### ########### # # ##### ##### # # ####### # # ### # # # ##### # ##### # # ### # ##### # ##### # ##### # #
 # # #     #   # #   # #   #       #   #     #   # # # #       #   #     #   #     # #   #   # #     # #     # #     # #       #
 # ### ##### ##### ### ### ####### # ####### ### # # # ####### ############### # ### ### # # # ####### # ##### # ##### ####### #
 #   #   #   #   # # #   #     #   #     # #     #   #   #   #   #           # #   # # # # #         # # #   # # # #   #       #
 ### ### # ### # # # ### ##### # ####### # ############### # ##### ######### ##### # # # # ####### ### # # # ### # # ### ##### #
   #     # # # #   #   # #     # #     #       #           #     #       #   #   # # # # # #       #   #   #     # # #   #     #
## ####### # # ####### # # ##### ##### # ####### ############### ####### ##### # # # # # ### ##### # ############# # # # ##### #
   #     #   # #   #   #   #   #         #   #   #   #     #   #       # #     #   #   #   #   #   #               # # #     # #
 ####### ### # # # # ####### # # ######### # # ##### # # ### ########### # ####### ####### # # # ##### ####### ##### ####### # #
 #   #     # # # # # #     # #   #   #     # #   #     #     #   #       # #             # # # #       #     #       #       # #
 ### # ##### # ### # # ### # ##### # # ######### # ######### # # # ####### # # # ######### ### ### ##### ### # ####### ####### #
   #     #   #   #   #   # # #     #   #     #   # #       # # #   #       # # #   #     #   #   #     # #   # #   #   #     # #
## # ### # ##### # ##### # # # ########### # # ### # ##### ### ##### ####### # ### # ### ### ########### # ### # # ### # ### # #
   #   # # #   # #   #   #   # #           # #   # #     #   #     #     #   # #   # #   # #     #       # # #   # #   #   # # #
 ### # ### # ### ### # ##### # ####### # ### ### # ##### ### ##### ##### # ### # ### # ### ##### # ####### # ##### # ##### ### #
 #   #   # # #   #   # #     #         # #           #   # # #   #       # #   #     #   #     #   #     # # # #   #     # #   #
 # ##### # # # ### ### # ### ########### # ####### # # ### # ### ######### # ########### ##### ##### ### # # # # ### ### # # # #
 #     #     #   # #   # #     #         #   #   # # #   # # #             #     #     #     # #     # #   #       # # #   # # #
 # ### ######### # # ##### ### ##### # # ### ### # # ### # # # ### ### # # ##### ##### ##### # # ##### ########### # # ##### # #
 #   #   #       #   #     #         # # # #     # #   #   #   #   #   # #     #           #   #     #   #     # # # #   #   # #
 ### ### # ########### ##### ######### # # ####### ### ######### # # ######### ######### ########### ### # ### # # # ### # ### #
   # #   #     #       #     #   #     #   #       # #           # # #     # # #       #         # # #   #   # #   #     # #   #
## # ######### # # ##### # ### # ######### # ####### ##### # # ### # # ### # # # ##### ##### ### # # # ##### # # ######### # ###
   #       #   # # #     # #   #         # #   #           # # #   #   #   # #   #   # #   # # # # #   #     # #   #       # # #
 ##### ##### ##### ### ### # ########### # ### # # ####### # # ######### ### ##### # # # # # # # # ##### ##### ### # ####### # #
       #     #     #   #   #   #   #     #   # # # #     # # #   #     # #         # #   # # # #   #  S#   # #   #   #       # #
###### # ####### ### # # ##### ### # ##### ### # # # ### # # ### # ### # # # ############# # # ##### # ### # ### ##### ####### #
     # #   #     #   # #   #   #   #   # # #   # # # # # # #   # #   #   # #             # # # #     # # #   # # #     #       #
 ### # ### ##### ########### ### ##### # # # ### # # # # # ### # ### ##### ############### # # # ##### # ##### # ##### # #######
 #       #     # #       #   #   #     #   # #   # #   # # # # #   # #     #       #       #   # # #   #     # #     # # #     #
 ##### ####### ### ##### # ### ### ######### ##### ##### # # # ### # ### ####### ### # ####### # # # ####### # ##### # # # ### #
 #   # #   # #     #   # # #     # #       # #     #     #   #   # #   #       # #   # #     # # # # #     #   #   # #   #   # #
## # # # # # ####### # # # # ### # # ##### # # ##### ############# ### # ##### # # ##### ### ### # # # ### # ### # # ### ### ###
   # #   #   #       # #   #   #   #   # # # # #     #         #     # # #       #       # #   # #     #   #     # #   #   #   #
 ### ####### # ####### ####### ####### # # # ### ##### # ##### # ### # # # ### ########### ### # ####### ######### ### # # ### #
 #   #   #   #     # #     #   #       #   # #   #     # #   #   #   # # #   # #   #     #   # #       #       #   # # # #   # #
 # ##### # ### ### # ####### ##### ##### ##### ### ##### # # ##### # # ####### # # # ### ### # ####### ####### # ### # ##### # #
 # #     # #   #         #   #     #   # #     #   #     # # #     # #   #     # #   #   #   #   #     #     # # #   #     #   #
 # ##### # ##### # ##### # ### ####### # # ##### # # ####### # # ####### # ##### ########### ### ####### ##### # # ####### ### #
 # #   #         # #   # # #   #       # # #     # # # #   #   #       # #   #   #       #     #               #   #     #   # #
 # # # # ######### # # ### ### # ####### # ####### # # # # ########### # ### # ### ##### # ### ################# ### # # ### # #
 #   # # #     #   # # #   #   # #     # #       # # # # #           # #   #   #     # # # #   #       #     #       # #   # # #
###### # # ### ### # ### ### ### # ### # ####### ### # # ### ####### # ### ### ##### # # # # ##### ### # # # # ####### # ### # #
     # # # # #   #   #   #   #   #   #   #     # #   # # #   #     #     #   #       # #   #     # #   # # # # # #   # # #   # #
 ### # ### # ### ### # ##### # ##### ######### # # ### # ##### ### ### ##### ######### ### ##### # ##### # # # # # # # ### ### #
 #   #     #   # #   #   #   #     # #       # # # #   #       # #   #   #   #   #   #     #   #   #     # #   #   #   #   # # #
 # ########### # # # ### # ### # ### # ##### # # # # ########### ### ### # ### # # # ####### # ### # ##### ############# ### # #
 # #         # #   # # # # # # #   # # # #   # #   #   #   #     #   #   #     # # # #       #   #       # #   #       # # # # #
## ######### # ##### # # # # # ### # # # # ### ####### # # # ##### ### ######### # # # ######### ####### ### # # ##### # # # # #
           # #     #   #   #   #   # # #   # # #     # # # #   #   #   #     #   # # # #       #   #   #   # #   #   # # # # # #
 ### ##### # # ####### ##### ####### ### ### # # # ### # # ### # ### # ### ### ### # # # # ### ### # ##### # ####### # # # # # #
   # #   #   #   #   # #   #       # #   #     # #     # #   #   #   #     #   #   #   # #   # # # # #   # # #     # #   # # # #
 # ### # # ### ### # # # # ####### # # ####### # ####### ### ##### ######### # ######### ### # # # # # # # # ### # # ##### # # #
 #   # # #         #   # #   #   # #         #   #       #         #     #   # #     #     # #   # # # #   # #   # #   #     # #
 ### # # ### ########### ### # # # ### ##### # ####### ### ### ### # ### # ### # ### ##### # ### # # # ##### # ### # # # ### # #
   # # #   #         #   # # # #       # #   #         #   #   # # #   # # #   #   #     # #   #       #     #   #   # # #   # #
## ### ### # # ### ### ### # # ##### # # # ############# # # ### # ### ### ####### ##### # ####### ##### ############# ### # # #
 # #   #   # #   # #   #   #   #     #   #     # #     # # #     #   #   #         #   # # #     #       # #   #     #   # #   #
 # # ### ####### ### ### ### ### # ########### # # ### # # ######### ### ########### # # # # ### # ####### # ### # # ### ##### #
   #   # #       #   #   # # #   # #       # # # # # # # #         #   #           # #   # #   # # #     #   #   # #   #     # #
 ##### # # ####### ### ### # # ### # ### # # # # # # # # ##### ### ### ########### # ##### ##### # ##### # ### ### # # ##### # #
       # # #       #   # # # #   # # #   #   # #   #     #   #   #   #       #     # #     #     #     #   #     # # # #   # # #
 ####### # # ##### # ### # # ### ### # ####### ##### # ### # ### # ####### # # ##### ####### ######### # ### ##### # # ### # # #
 # #   # # #   #   #   # #     #     # #       #     # #   #     #       # # #       #     # #         #     #   # # #   # #   #
 # # ### # ### ####### # ### # ######### ######### ### # ##### ##### ### # # ######### ### # # ######### ##### # # ##### # ### #
 # # #   #   # #       #     #   #   #   #         #   #     # #   #   # # #         #   #   # #   #   #     # # #     #   #   #
 # # # ####### # ######### ##### # # # ##### ####### ####### # # # ### # # ##### ####### ##### # # # # ### ### # ##### ##### ###
 # #   #       # #         #     # # # #     #     # #   #   # # #   # # #     #               # #   #     #   #   #   #     # #
 # ##### ##### # ##### # ### ### # ### # # ### ### # # ### ##### ### # # ##### ### ######### ### ########### ##### # ### ##### #
       #     # #     # #   #   # # #   # # # #   # # #   #       #   # #     #   # #       #           # #   #   # #     # #   #
 ##### ##### ####### ##### ### ### # ##### # ### # ##### ######### ### ##### ### # # ##### # # ####### # # ### ### # ##### # ###
 #   #   #   #       #       #   # #     # #   # # #   #         # #   #     #   # #   # # # #   #   #   #     #   #   #       #
 # # ### # ### ####### ### # ### # ##### # # ### # # # ######### # # ### ##### ### ### # # ##### # # ########### ### # ####### #
 # #   # #     #       #   # # # #       #   #   # # # #   #   # # # # # #   #   # #   #   #     # #           # #   # #     # #
 # ### ######### ####### # # # # ############# ### # # ### # ### # # # # # # ### ### ####### ##### ########### # # # # # ### # #
 # # # #     #   #     # # #   # #   #   #   # # #   #   # # #   # #   # # #   #   # #           # #     #   #   # # #   # # # #
 # # # # ### # ####### # # ##### # # # # # # # # ####### # # # ### # ### # ### ### # ### # ##### # # ### # # ##### # ##### # # #
   #   #   #   #     # # #   #   # #   #   # # #     #   #         #   #   #     # #   # # #   # #   #   # # #     #     #   # #
 ######### ### ##### # # # ### ### ######### # ##### # ##### ############### ### # ### # # # # ####### ##### ### # ### # ##### #
       # # #   #     # # #   #   # #         # #     #   # # #   #     #   #   # #     # # # #     #   #     #   # # # # #   # #
 ##### # # ##### ##### # ### ### # # ######### # ####### # # # # # ### # # ### ######### ### ### ### ### ##### ### # # # ### # #
 #   #   #       #   # # # #   #   # #   #     #     #   #   # # #   #   #     #     #   #   #   #   #   #     #   #   #     # #
 ### ############### # # # ### ##### # # # ##### ### # ####### # ############### ### ##### ### ### ### ####### # ############# #
                         #         #   #         #   #         #                   #         #     #           #               #
