################################################################################################################################
           #     #   #   #           #   #                 #     #   #               #       #     #       # #                 #
 ### ####### ### # # # # ########### # # # # ########### ### ### # # ########### ##### ##### # ### ##### # # # ##### ###########
   #       # #   # #   #         #   # # # #       # #   #   # # # #             #   # #   # # # #       # # # #   #   #       #
## ####### ### ### ############# # ### # # ####### # # # # ### # # ############### # # # # ### # ######### # # # # ### # ##### #
   #     #   # # #   #   #       # #   # # # #   # #   # # #   #     #           # # #   #   # # #       # # # # # #   # #   # #
 ### ### ### # # ### # # # ####### ### # # # # # # ####### # ######### ######### # # ####### # # # # ##### # # ### # ### # # # #
 #   #   # # #   # #   # # #     #   # # # # # # #         #     # #   #       # # #       # # # # #     # #       # #   # #   #
 ##### ### # ### # ##### # ##### ### # ### # # # ########### ### # # ####### ### ######### # # # # ##### # # ### ### ##### #####
           #   # # #   # #   #     # # #   #   #     #   #     #   #       #         #   # #   #   #     # #   #   #     # #   #
 ######### ### # # # ### ### # ##### # # ########### # # # ### ########### ######### # # # ##### ### ### # # # ### ### # # # ###
         #   #   # # #   #   #       # # #     #       #   # # #     #   #     #   # # # #   #   # #   # # # #   # #   # # #   #
 ####### ### ##### # # ### ### ####### # ##### ##### ####### # # ### # # ##### # # # # # ### # ### ### # # # ### # # ##### ### #
 #     #   #       #   # # #   #       # #   #       #     # # #   #   #       # #   # #   # # #     # # # # # # # #   #   # # #
 ##### ### ####### ##### # # ##### ##### # # ####### # ### # # ### ### ######### # ### # ### # # ### # ### # # # # ### # ### # #
       # #     #   #     # #     #       # #       # #   # #     # # # #     #   #     #       #   # #     #   # #   # #   # # #
###### # ##### # # # ##### ##### # ####### ####### # ### # ##### # # # # ### # ### # ####### ### # ######### ### ### # ### # # #
     #   #   # # # # #   # #     # #     # #   #       # #     # # # # #   # # # # # #     #     #     #     #   #   #     # # #
 ### ### # ### # ### ### # # ##### # ### # # # ####### # ##### ### # # ### ### # # ### ### ### # ##### # # # # ####### ##### # #
 # #   # # #   #   #     # #     #   # #   # #   #     # # #   #   # # #   #   # #     # # #   #     #   # # #       #         #
 # ### # # # ##### ##### # ##### ##### ### # ### # ### # # # ### ### # # ### ### ####### # ######### ##### # ####### ### # #####
 #     #   # #   #       #     #   #       # # # # #   # # #   # #     #   #   #         #       #       # # #     # #   # #   #
## ####### # # # ############# ### # ####### # # # # ### # ### # ##### ### ### ### ##### ####### ##### ### # ##### # ##### # # #
   #       # # #   #         # # # #   #     #   # # # # #   # #     #   #   #   #   #   #     #     #   # #     # #     # # # #
 ### ####### # ### # ##### ### # # ### # ##### ### # # # ### # ##### ####### ### ##### ### ######### ### # ##### # ##### # ### #
   #     #   # #   # #   # #   # #   # # #   #   # #   # #   #     # #       #   #     #   #       #   # #     #     # # #     #
 ####### # ### # ### # ### # ### ### ### # # ### # ### # ### ####### # ####### ##### ### # # ##### ### ####### ##### # # ### ###
       # #     # #   #   #   # #         # #     # #       # #     #   #   #   #   #   # # #   #   #   #     #     #   #   # # #
 ####### ######### ##### ##### # ############# ##### ##### # # ### ##### # # ##### ### # ##### # ### # # ### # ### ####### # # #
   #   # #         #         #   #           # #     #   #     #   #     # #     # # # #   #   # #   # #   # #   #     #   #   #
## # # # # ########### # ### ##### ######### # # ### # # ##### # # # ########### # # # ### # ##### ##### ### ##### ### # ### ###
   # # # # #           #   #     # #     #   #   #   # # #   # # #   #       #   # #       #   #   #     #   #   #   # # #   # #
 # # # # # # ############# ##### # # ### # ####### ### ### # # # ##### ##### # ### ### ### ### # ### ##### ### # # ### # ### # #
 # # #   # # #   #       #   # # #     # # # #       #     #   #         #   # #     # #     # #   # #   # # # # # #   # #   # #
## # ##### ### # # ##### ### # # ####### # # # ##### ####### ############# ### ##### # # ### # ### # # # # # # # ### ### # ### #
   # #     #   # #     #   # # #         # #   #   #   #   # #   #       #   #   # # # # # #     #   # # # #   #     #   # #   #
 # # # ##### ### ##### ### # # ########### ### # # # ### # # # # # ##### # # ### # # # # # # # # ####### # ############# # # ###
 #           #   #   # # #   #       # #   #   # #   #   #   # # # #     # #   # # # # #   # # # # #   # #   #   #       #   # #
#### ######### ### # # # ######### # # # ####### ##### ##### # # ### ########### # # # ####### # # # # # ### # # # ####### ### #
     #       #     #   #           #   # #       #   # #   #   #   # #   #     # #   # #   #   # #   #   #   # # #   #   #   # #
 ### # ##### # ####################### # # ####### # # # # ### ### # ### # ### # # ##### # # ### ####### # ### # ### ### # # # #
 # # # # #   # #       #   #   #       # #     #   # # # #   # # #       # # #   # #     # # # # #   #   #   # #     #   # #   #
 # # # # # ### # ##### # # ### # ####### # ### # ### ### ### # # ######### # ##### # ##### # # # # ### ##### ######### ### # ###
 #   # # # #   # #     # # #   # # #     # #   #   #   # #   # #   #       #     #   #   # #   # #     #   # #   #   #     #   #
 ##### # # ##### # ##### # # ### # # ####### ##### ### # # ### # ### ####### ### ##### # # ##### # ##### ### # # # ######### # #
 #     # #     # # # #   # #   #   #       # #     #   # #       #   # #       #       #   #           #   # # # # #   #     # #
## ##### ##### # # # # ### ### ### ####### ### ##### ### ##### ### ### # ##### # ########### ############# # ### # # ### ##### #
   #         #   # # # #     #           #   # #   #   #     # #   #   # #     #                 #         #     # #   #   #   #
 ######### ####### # # ##### ########### ### # # # ### ##### # # ##### # # ##### ### ############# ############### ### ### ### #
   #   #   #     # # #   #       #   #     #   # #   #   #   # # #   # # # #       #               # #               #     #   #
## # # # ### # ### # ### ####### # # # ### ##### ####### # ### # ### # # # ##### # ######### ####### # ######### ### ####### ###
   # # #     #     #   #       #   # #   # #           #   #   #     #   #   #   #   #     #         # #   #     #   #     #   #
 ### # ##### ####### ############### ### # ### ####### ##### ######### ##### # ####### ### ### # # # # # # # ### ##### ### ### #
   # #     #     #   #     #   #     #   #     #     #           #     #     # #   #   #   # # # # # # # # # #   #     #S# #   #
## # ##### ##### # ### ### # # # ############### ### ########### # ######### ### # # ### ### # # # ### ### # # ### ##### # # ###
   #   #   #   # #   # #   # # # #               # #     #     #           # #   # #   # #   # # #         # # #   #       #   #
 ##### ##### # # ### # # ### # # # ############### ##### # ### ### ####### ### ### ### # # ### # ####### ### # # ### ##### ### #
     # #     # #   #   # #   #   #       # #       #   # #   #   # #     #   # # #     # # #   #   #   #   # # # #   #   #   # #
#### # # ##### ### ##### # ############# # # ##### ### # ####### # # ####### # # ####### # # ### # # # ### # ### ##### # ### # #
   #   # #   #   # #           #   #     # # #   # #   #         # # #       # #       # #   #   # # # #   #   #       # #   # #
 ####### # # # ### # ######### # # # ##### # ### # # ############# # # ####### ####### # ### ##### # # ####### ######### # ### #
       #   # #   # # #   #   #   # # #       #   # #               # # #   # # #       #   # #   # # # #       #   # #   #     #
###### ##### ### # ### # # # ##### # # ####### ### # ######### # ### # # # # # ### ####### # # # ### # # ####### # # # ####### #
       #   # # # #   # # # #   #   #         #     #   #   #   #   #   # #   #   #       # # # #     # #         #   #   #     #
 ####### # # # # ### ### # ### # ### ####### ######### ### # ##### ##### ### ### ####### # ### ####### ### ############# # # # #
         # # # #     #   # #   #   # #     #           #   #     #         #   #   #         #   #   #   # #     #       # # # #
 ######### # # ####### ##### ##### # # ### ### # # ##### ####### # ### ### ### ### ######### # # # ##### ### ### # ####### # # #
      G# #   #       # #     #       #   # #   # #     # #       # #   #   #     #       # # # # #     #   # #   #     #   # # #
###### # ##### ### # # # ##### ##### ### # ########### # # ####### # ### ### # ######### # # ### ##### ### # ### ##### # ### # #
     # #       #   #       #       #     #       #   # #   #     # #   # # # # #   #     # #   #   #   #   #   #       # #   # #
 ### # ### ######### ##### # ##### # ########### ### # ####### # # ### # # # ### # # ##### ### ### # ### ##### ########### # # #
 #   #   # #       # #   #       # #     #     # #   # #     # #   #   # # #   # #   #       #     #   # #     #   #       # # #
 # ##### # # ##### # # # ##### # # ####### ### # # ### # ### # ### # ### # ### # ##### ############### # ### ### # ### ##### # #
 #     # #   #     # # #   #   # # #       #   # # #   #   # # #   # #   #     # #   #   #         #   #     #   # #   #   # # #
 ##### # # ######### # ### ##### # # ########### # # ##### ### ##### # ######### # # # # # ####### # ######### ##### ##### # # #
     # #         #   #   #     # #   #         # # # #         #     # # #     # # # # # #       # # #       #       #     # # #
 ### # # ####### ### ### ##### ####### ####### # # # # ### ##### ##### # # ### # # ### # ####### ### # ##### ######### ##### # #
 # # #   #   #   #   # #     #         #   #   # #   # #   #     #       #   #   #     #     #   #   # #   # #     #   #     # #
 # # ##### # ##### # # ##### ########### ### ### ####### # # ############### ##### ##### ##### ### ### ### # ### ### ### ### # #
 # # #     #   #   # # # #   #     #   #     #   #   #   # #       #       # #     #   # #   #   #   # #   #   # #   #   #   # #
 # # # ####### # ### # # # ### ### # # ####### ##### # ########### # ##### # # ##### # ### # ### ### # # ##### # # ### ##### # #
   # # #     # # #       #   #   #   #       # #   #   #           # #   #   # #   # # #   #   # #   # #     #   #   # #     # #
## # # ##### # # ########### ############# # # # # ##### ##### ##### # ####### # # # # # ### ### # ### ### # ####### # # ##### #
 # # #     # # #         # #     #   #     #   # #     # #   # #   # # #     # # # # #   # #     #   #     #       #   # # #   #
 # # ##### # # ####### # # ##### # # # ######### ##### # # # # # # # # # ### # # # # ##### ######### ############# ##### # # ###
   # #   # #   #     # #       #   # #   # #   # # #   # # #   # #   #   #     # #   #                                   # #   #
 ### # # # ##### ### # ############# ### # # # # # # ### ##### # ######### ##### ##### ######### ### # ### ##### ### ##### ### #
 # # # # # # #   #   # #   #       #   #   # #   #   # #     # #       #   #     #             #   # #   #     # # #     # #   #
 # # # # # # # ######### # # # ####### # ### ######### ##### ######### # ### ##################### # ######### # # ##### # # ###
 #   # # #   # # #       # # #     #   #   # #               #         #   #                       #   #     # #   #   #   #   #
 ##### # ### # # # ####### # ##### # ### # # ##### ########### ########### ######################### # # ##### ##### # ####### #
 # #   # #   # # #   # #   # #     # #   # # #   # #     #     #   #               #   #     #       # # #     #   # #       # #
 # # ##### ### # ### # # ### # ##### # ##### # # ### ### # ##### # ######### ##### # # # ### # ####### # # ##### # # ### # ### #
   #     #           # # #   # #     #     #   #     # #   #   # #           #   #   #   # #   #       # #   #   #   #   # #   #
 ####### ### ##### ### # # ##### ######### ########### ####### # ##### ####### ########### ##### # # # # ### # ############# ###
 #   #       #   # #   #   #       #     #           # #     # #     # #     #     #       #     # # # #     # #   #       #   #
 # # ### # ### # # ### ##### ####### ### ### ### ##### # ### # ##### ### ### ##### # ##### ### ##### # ####### # # # ##### ### #
   # #   # #   # # #       #   #     #   # #   # #   # # #   # #   #   # #   #     # #   #   # #     #           # #     #   # #
 ##### # # # ### # # ##### ### # ######### ### # # # # # ##### # # ### # # ### ##### ### ### ### ##### ### ### ######### ##### #
       # # # #   #   #   #     #       # # #   #   #   #   #   # # #   # # #       #   #   #   #     #   # # #     #   #       #
#### ##### # ##### ### # # ### ####### # # # ### ######### # ### ### ##### ####### ### ### ### ######### # # ##### ### #########
     #   # # #   # #   #   #   # #   # #   #   #         # # #     #     #     #     # #   # #     #     #     #   #   #   #   #
###### # # # # # # # ### ### # # # ### # ##### # ######### # # ### ##### ##### # ### # # ### ##### # ##### ##### ### ### # ### #
   #   # # #   # # # # # #   #         #       #   #     # # #   #     #     # #   # #   # #     #   #       #   #       #   # #
 # # ##### ##### ### # # # ######### ############# # ### # # ### ##### # ##### ##### ##### # ### ####### ### # ##### ####### # #
 # #       #     #   #   #     #   # # #         #     #   # # # # #   #   #   #   #         #     #   #   # # #   #       # # #
 # # ##### # ##### ########### # # # # # ####### ####### ### # # # # # ### # ### # ### ####### ##### # ##### # ### # ##### # # #
 # # #   # # # #   #     #     # #     # #       #     #     # # # # #   # #   # # #   #     # #     # #     #   # # #     #   #
 # # # # ### # # # # ### # ##### ### ### # ####### ### # ##### # # # ### # ### # # ##### ### # # ##### # ### ### # # # ####### #
 # # # #     # # # # #   # #   #   # #   #         #   #         #   #   #     # #     #   # # #     # #   # #   # # # #     # #
 # ### ####### # # # ##### # # ### # # ######### ######### ### ####################### ### # # ##### ##### # # ### # # # ### # #
 #     #     #   # #       # # #   #     #     # #   #   #   #   #                     #   #       #     # # #     # #   # # # #
 ########### ##### ########### # ####### # ### ### # # # ####### # ##################### ######### ##### # ######### ##### # ###
         # #                   #   #   # #   #   # #   #       # # #       #   #     #   #             # #           # #   #   #
######## # ####### ######### ####### # # ### ### # ########### ### # # ### # ### # # # # # ########### # ##### # # ### # ##### #
     #   #         #       #     #   #     #   # #   #   #   #     # # #         # # # # # #   #   # # #     # # #     #       #
 # ### ####### ##### ##### ##### # ### ######### ### # # # # ######### # # ####### # ### # ### # # # # ##### # # # #############
 #   #   #   # #     #   #   #   #   # #     #   # #   # # #           # # # #     # #   #   # # #   #     #   # #   #   #     #
 ### ### # # # # ####### ### ####### # # ##### ### ##### ####### ####### # # # ##### # # ### # # ######### ##### ### ### ##### #
 # #   # # #   #   #     # #   #     #     #   #   #   #   #   #   #     #   #   # # # #   # #   #   #   #         #     #   # #
 # ### # # ####### # ##### ### # ######### # ##### ### ### # # ### ############# # # # # ### # ##### # ####### ### # ##### # # #
 #   # # #   #     # #   #   # #     #     #     # #     #   #   # #     #     # # # # # #   #     # # #   #   #   #       # # #
 ### # # ##### ##### # ### # # ####### ### ##### # # ### ####### # # ### # ### # # # # ### ####### # # # ### ### ##### ##### # #
     # #       #     #     # #         # # #   # #   #   #       #   #   #   #   #   #   #     #   #   #     #   #   #     #   #
#### ########### ####### ### ########### # # # # ####### # ################# ##### ### # ##### # ##### ### ### ### # # #########
   # #     #   #     #   #   #     #   #   # # # #       #   #         #   # #   # #   #     # #         # #   #   # # #   #   #
 ### # ##### ####### ##### # # ### ### # ### # # # ##### ### # ####### # # # # # # ########### ######### # # ### ### # # # # # #
                           #   #             #     #           #         #   # #               #           #     #   #   #   # #
