################################################################################################################################
         #     #           #                 #         #     #           #       #   #     #             #         #   #       #
######## # # # # ######### ##### ### ### ##### ##### ### ### # ### ##### # ##### # # # ### # ########### # ### # # # # ####### #
       # # # # # #   #   #   #   #   #   #   # #   # #   # #     #   #   #   # # # # # # # #         #   #   # # # # # #       #
 ##### # # # # # # # # ##### # ### ##### # # # # ### # ### ######### ####### # # ### # # # ### ##### ##### # # # # # # # #######
 #   # # # # # #   # # #   # #   #   #   # #   # #   # #   #       #     #   #   #   # # #   # #   #     # # # # # # #   #     #
 # # # # # # # ##### # # # # ######### # # ##### # ### # ### ##### ##### # ####### ### # ### # # # ##### ### ### # # ##### ### #
 # #   #   # # #   # #   # #   #     # #       # #     # #   #   #       #   #       #   # # # # #     #     #   # # #   #   # #
 ########### # # # # ##### ### # ### # ####### # ####### ### # ######### ### # # ####### # # ### ##### ####### ### # # # ### # #
       #     #   # # #   #   # #   #   #   # # # #     #     #         # #   # # #   #   # #   #     #     #   #   #   #     # #
###### # ##### ##### # ##### # # # ##### # # # # # ### ############# # # # ##### # # # ### ### ########### # ### ##### ####### #
   # # # #   #     # # #     # # #   #   # # # #     #     #       # #   # #   #   # #     #     #   #     #   #     # #       #
 # # # # # # ##### # # # ##### ####### ### # # # ####### ### ##### ####### ### # ### ##### # # ### # # ####### ##### # # ##### #
 # # #   # #   #   # #       #           # #       #   # #   #   #       # #   #   #   #   # # #   #   #   # #     # # # #   # #
 # # ### # ### ### # ####### ########### # ### ##### # ### ### ######### # # ### ##### # ### ### ######### # ####### # ### # # #
 # #     # # #   # # #     #     #     # #   #       #   # # # #   #   #   # # # #     # # #   # #         # #       # #   # # #
 # # # ### # ### # # # ### # ### ##### ##### # ######### # # # # # ### ##### # # # ##### # ### # # ######### # ####### # ### ###
 # # # # # #   #   #   #   #   #   # #     # # #       #   # #   #       #       #   # # #   #   # #         #   #     # # #   #
 # ### # # ### ### ##### ### # ### # ##### # # # ##### ##### # ######### # # # ### # # # # ####### ######### ### ### ### # ### #
 #     # #   #   #   #   #   # # # #     # # #   #     #   #   #   #     # # #   # #   # #       #     #             #   #   # #
 # ##### ### ### ### # ####### # # ### ### # ### ##### # # ##### # ##### # # ### ####### # ### ####### # ########### # ##### # #
 # #       #     #   # #       # #   #   # #   #   #     #       #     #   #   # #       #   # #     # #     #     # #       # #
 ### ############# ### # ####### ### ### # ### # # # ####### ######### # ##### # # ######### ### ### # # ### # ### # ####### # #
       # #     # #   #   #       # #     #     # # # # #   #     #   # #   #   # #   #   #   #   # #   # #   # #           # # #
 ##### # # ### # ### ##### ##### # ##### ####### # # # # # ####### # # # # ######### # # # ### ### ##### # ### ####### ##### ###
 #   #   # # # #           #           #   #     # #   # # #       #   # #       # #   # # # #     # #   #   #   #     #   #   #
 # # ##### # # # ####### ### ############# # ##### # ### ### ########### ####### # ##### # # ##### # # # ####### # ### # # ### #
 # # #   # #   # #   #   #     #     #   # # #     # #   #   #       #   #     #   #     # #     # #   # #   #   # #   # #     #
## # # # # ####### # # ####### # ### # # # # # ##### # ### ####### # # ####### ##### ##### ##### # ### ### # # ##### # # #######
   #   #   #   #   #   #   #   #   #   #     # #     #     #       # #   #       #   #       #   #   # #   #   #     #         #
 ########### # # ####### # # # ### ########### # ################### ### # ####### ######### # # ### ### ##### # ##### ####### #
         #   #   #       #   #   # #   #   #   #   #           #     #       #     #     #     #   #   #   #   #     # #   #   #
######## # ####### ########### # # # ### # # ##### # # # # # ### ##### ####### ##### # # ######### ### ### # # ##### # # # ### #
   #     # #     #     #     # #   #   # # #     #   # # # #             #   #     # # # #   #       #     # #   #   # # #   # #
 ### ##### # ### ##### # ### # ##### # # # ##### # ### ### ####### ##### # # ##### # # # # # # ##### ####### ##### ### # ### # #
   # #   # #   # #   # # # # #       # # # #   # #   #   #       # #   # # #       # # #   # # #             #     #   # # # # #
 # # # # # ### ### # # # # # ####### ### # # # # ##### # ### ### ### # ### ########### ##### # # ########### # ######### # # # #
 #   # # #   #     #   #   #   #   # #   # # #   #   # #   #   #     # #   #     #   #     #   #     #     # #   # #     #   # #
 ##### # # # ################# # ### # ### # ##### # # ### ### ####### # ##### # # # ##### ### ##### # ### # ### # # ##### ### #
       # # #   #       #     #       # #   #   #   # #   #   #     # #   #     #   #       #       # # # # #   #   # #   # #   #
######## # # ### ##### ##### # ####### # ####### ### ### ### # # # # ####### ##### ######### # ##### # # # ##### ### # ### # # #
       #   # #   #       #   # #       # # #   # # # #     # # # #   #   #   #   # #   #   # #   #   # # #     # #   # #   # # #
 ### # ##### # ######### # ### # ####### # # # # # # ####### ### # ### ### ### # # # # ### # ### # ### # ##### ### ### # ### # #
   # #     # # #       # # # # #       #   # #   # #     #   #   #   #     #   #   # #   #   #   #   # #           #         # #
 # # ##### # # # ##### # # # # ##### ####### ##### ##### # ### ### # ####### # ##### ### ##### ##### # ### ######### ######### #
 # # #   #   #   #     # # #           #   # #   #       # #   #   #   #   # #   # # # #   #   #   # #   #   #     # #   #   # #
 # # # ######### # ##### # # ####### # # # # # # ######### # # ### ### # # # ### # # # ### ##### # # ### ##### ### # # # # # # #
 # # # #   #   # #   #   #   #     # #   #   # #     #     # #   #   #   # #   #   # #     #     # # #   #     # # # # # # #   #
## # # # # # # ##### ### ### # ### # ######### ##### # ##### ### ### ##### ##### ### ####### ##### # # ### ##### # ### # # ### #
   #   # #   # #   #   #   # #   # # #   #     #   # #     #   #   # #   #     # #   #     #   #   # #     #   # # #   # #   # #
 ####### ##### # # ### ### # ### # # # # # ##### ### ##### ### ### # # # ##### ### ### ### ### ##### ####### # # # # ### ### # #
 #   # # #     # #   # # # #   # # # # # #       #   #   #   #   # #   #     #     #   #   #   #       #   # #   # #   #   # # #
 # # # # # ##### ##### # # ##### # # # ########### ### # ### # ### # ####### ####### ### ### ### ### # # # # ##### ### ### ### #
   #   # #     #       # #     # # #   #           #   # #   # #   #     #         # # #   #     #   #   #   #   #   #   #     #
 ####### ##### ######### ##### # # ### # ##### ##### ### ##### # ### ### # ####### # # ### ##### ######### ### ############### #
     # # #   # #       #     #   #   # # #   #   #   # #     # # #   # # #       #   #   # #     #       #   #     #     #   # #
## # # # # # # # ##### # # ######### # # # # ##### ### ##### ### # # # # ##### # # ### ### ##### # ##### ### # ### # ### # # # #
   #   #   # # # #   # # # #         # # # # #   # #   #   #   # # #   # #   # # #       #     # # #   #   #   #   # #   # # # #
#### ####### # # # # # # ### ######### # # ### # # # ### ##### # # ##### # # ### ####### ##### ### # ##### ######### # ##### # #
   # #     # # # # #   #     # #     #   # #   # # #   # #     # #   #   # #     #           #     # #   #     #     #       # #
 # ### ### # # # # ##### ##### # ### # ### # ### # ### # # ##### ### # ### ############# ### ####### # # ##### # ############# #
 # #     # # #   #   # #     # #   # # #   # #   #     # # #   #   # # #   # #     #       #   #   # # # #     #         #     #
 # # ##### # ####### # ##### # ### # # # ### # ####### # # # ### # # # # ### # ### ####### ### # # # # ### ##### ##### # # ### #
 #   #     # #     # # # #         # # #     #     #   # # #   # # # # #     #   #     # #   # # #   # #   #     #   # #   #   #
 ##### ##### # ### # # # # ##### ### # ########### # ### # ### ### ### ######### ##### # ### # # ##### # ### ##### # # ##### # #
 #   #   #   #   # # #     #   #   #   #   #     # #   #   #       #         #   # #   # #   #   #   #   #         # # #   # # #
 ### # # ######### # ##### # # ##### ### # # ### # ### ############# ### ##### ### # ### # # ####### ##### ######### # # ### # #
   # # #   #   #   # #     # #     # #   #     # #   #   #   #   #   #   #     #   # #   # #   #     #   #   #   #   # #     # #
## # ##### ### # ### # ### # ##### # # ######### ### ### # # # # # ##### # ##### ### # ### # # # ##### # ### # ### # ######### #
   #   #   #         #   # # #   # #   #   #   # #     #   # # # # #   # #   # #     #     # # #   #   # #   #     # #       # #
 ##### # ### ####### ##### # # # # ##### # # # # # ######### # # # # # ##### # ############# # ### # ### # ######### # ##### # #
 #   #   #   #     #       #   # #   #   # # #   # #     #   # # # # #       #               # #   # # # #   #   #   # #     # #
 ### ##### # # ### ####### ### ##### # ##### # ### # ### # ### # # # ######### # ############# # ### # # ### # # ##### # ##### #
   #   #   # #   #     # #   # #   # # #     # #   #   #   #   # # #     #   # #             # # # #   # # # # #       # #   # #
## # # # ### ### ##### # ### # # # # # ### # ### ##### ##### ### # ##### ### # ############# # # # ##### # # # ######### # # # #
 # # # #   #   # #     #     # # #   #   # # #   # #   #     # # #     #   #   #   #       # #   #   #       #   #     #   # # #
 # # # ######### # ##### ##### # ####### # ### ### # ##### ### # ##### ### ### ### # # # ### ##### ### ######### # ### ##### # #
 #   #   #       #   #   #     #   #       #       # #     #   # #     # #   #       # #   #         # #       #   # # #   # # #
 ####### # ######### # ### ####### # ####### ####### # # ### ### ##### # ### ##### ### ### ### ##### # # ########### # # # # # #
 #     # #   # #     # #   #     # # #   #     #     # # #   #   #   #     # #   #   #   # #   #   #   # #           # # # # # #
 ##### # # # # # ##### # ### ### # ### # # ##### ####### # ### ### # # ##### # # ####### # # ### # ##### # ######### # # # # # #
 #   # # # # # # #     #   #   #   #   #   #     #     # #   # #   # # # #   # #     #   # # #   #   #   #     #   #     # # # #
 # # # # ### # # # ####### ### ##### ####### ####### # # ### # # ### # # # ### ##### ##### # # ##### # ####### # # ######### # #
 # # # #     # # # #   #   #   #   # #   # #     #S  # #   #     # # #   # #   #   # #   # #   # #   # #     #   #   #     # # #
 # # # ####### # # # # # ####### # # # # # ##### # ### # # ####### # ##### # ### # ### # ##### # # # # ### # ##### ### ### # # #
   # #         # #   #     #     # #   # # #   #   #   # #   #   #   #   # #   # #   # # #   # #   # #   # # # #   #   #   # # #
#### ### # ### # ######### # # ######### # ### ##### ####### # ### ### # # ### # ### # ### # ####### ### # # # # ### ### ### # #
   #   # #   # # #     # #   # #   #     #     #   #     #   # #     # #   # # # #   #     #   #   #   #G  #   #   # # #     # #
 # ### # ### # # # ### # ##### # # # ######### ### ##### ##### # ##### ##### # # ### ######### # ##### ##### ### ### # ####### #
 # #   # #   # # # #   #     # # #   #   #         #   #   #       #   #   # # #   #     #     #           # #   #   # #   #   #
 # # ### ####### # # ##### # # # ##### # # ######### ##### ##### ### ##### # # ### ##### # ############### # # ### ### # # # # #
 #   # #     #   # # #   # #   # #     #   #   #     #   #     # #   #     # #   # #     #       #   #     # # # #   # # #   # #
 ##### ### ### ### ### # ##### # # # ####### # # ##### ####### # # ### # ### ### # # ########### # # # ##### # # ### # # ##### #
           #   #   #   #           # #     # # #             # # # #   #     # #   # #   #   #   # # # #     # # #   #   #     #
#### ####### ### ### ######### ##### # ### ### ####### # ### # # # # ##### ### ##### # # # ### ### # ### ##### # # ########### #
     #       #   #   #     #   #   #     #     #       #   # # # #   #   #     #     # # # #   # # #   #     # #   #       #   #
 ##### ####### ### # # ### # ### # ##### ####### # # # ##### # # ### # # ####### ##### # # # ### # ### ##### # ##### ##### # ###
   #   #       #   # #   #   #   #   # # #       # # # #     #       # # #     #   #   # # # #   # #   #     # #   #     # #   #
 # # ####### ### ### ### ### # ##### # # ####### # # # # ### ### ### # ### ### ### # ### # # ### # ##### ##### # # ##### ##### #
 # #       #   # #     # #   # #   # # # #       # # # #   #   # #   #     #   #   # #     #           # #   # # #   #   #     #
 ######### ### # # ##### ### # # ### # # # # ####### ######### # # # ####### ### ##### ### ### ##### ### ### # # ##### ### ### #
   #   # #   #   # #   # #   # # #   # #   # #     #     #   #   # #     #     #     # #     # #     #       # #     #   # # # #
## # # # ### ### ### # # # ### # # ### ### ### ### ### # # # ##### ### # # ### ##### # # ### # # ### # ##### # ##### ### # # # #
 # # #     # # # #   #   # #   #   #       #   # #     # # #       #   #   #           # # #   #   #       # # #       # # #   #
 # ##### ### # # # ####### # ### ##### ##### ### ####### # ####### # ##### # ####### ### # ### ### ### # # ### ####### # # #####
 #       #   #   #   #     #   #     #   #   # # #       #   #     #     # #   #     #   #       # #   # #     #     #   #     #
 ####### # ######### ######### ##### ##### ### # ##### # ### # # ####### # ### # # ### ##### ##### # ### ####### ### # ### ### #
   #   # #         # #       #   # #       #   #       #   # # # #     # # #   # # #   #   # #   # # #     #     #   # #   #   #
## # ### ######### # # ##### ### # ########### ######### ### ### # ### # # # # # # # ##### ### # ### # ### # ##### ### ##### # #
         #       #   #   # # #   #       #   #         #   #   # # #     # # # # # #       #   #     # #   # #   # #         # #
#### ##### ######### ### # # # ### ### ### # # ####### ### ### # # ######### # # # ######### ######### # ### # ### ########### #
   #     #           # # #     #   #   #   # # #           #   # #       #   # # # #   # #   # #   #   # #   #   #   # #   #   #
 # ##### ######### # # # ########### # # ##### # ##### ##### ### ######### ##### ### # # # ### # # # ##### ##### ### # # # # # #
 #     #           #   #   #   #   # # # #     # #     #   #   #   #   #   # #   #   #   #   # # # #       #   # #   # # # # # #
 ##### ######### # ####### # # # # ### # # ##### # ##### # ### # # # # # ### # ### ######### # # # ######### # # # ### # # # # #
 #   #   #     # # #     # # #   #     #   #   # # #     #     # # # # # #   #   # #     # # #   # #   #     #   #   #   # # # #
 # # ### # ##### # # ### # # ######### ##### # ### # ########### # ### # # ##### # # ### # # ##### # ### # # ####### ### # # # #
   # #   # #     #   # # # #         #       #     #   #     #   #     # # #   #   # #   # #       # #   # # # #   #   # # # # #
 ### # ### ### # ##### # # ######### ######### ####### ##### ### ####### # # # ####### ### ######### # ### # # # # ### # ### # #
   # #   #     #     #   #     #     #         #     #     #     #     #   # #       #   #     #   # #   # #   # #     #   # # #
#### ### ####### # ########### ############# ### ### # ### ##### # ### ############# ### # ### ### # ### # ##### ######### # # #
     #     #   # #   #       #   #     #   # #   #   # # #     # # # #       #       # # #   #       #   #   #   #   #   #   # #
 ######### # ### ### # ##### ### # ### # # ### ### ### # ##### # # # ####### # ####### # ### ######### ##### # ##### # # # ### #
         # #     #   #     #     #   # # #     # # #       #   # #     #   #   #       # #   #   #     #     #     #   # # #   #
######## # ##### ################### # # ####### # ######### ### ##### # # ##### ####### # ### # # ############### ##### ### # #
   #   # # #   # #     #         #   # # # #   #   #   #   # #     #   # #       #       #     # #   #     #   #   #   #     # #
 ### # # # # # ### ### # ####### # ### # # # ### ### # # # # # ##### ### # ####### ####### ##### ### # ### # # # ##### ####### #
     #   #   #     #     #         #     #           #   #   #           #                     #     #   #   #   #             #
