################################################################################################################################
################################################################################################################################
#     #   #     #             #           #         #               #       #               #   #           # #     #     #     
# # ### # # ##### ##### # ### # ######### # ####### # ######### ##### ##### # ####### ##### # # ########### # # ### # ### ##### 
# # #   # #       #     #   #   #     # #   #     #   #   #   #     # #     # #       #     # #   #   #     # # # # #   #       
# ### ### ######### ### ### ##### ### # ##### ### # ##### # # ##### # ######### ####### ##### ### # ### ##### # # # ### ####### 
#   # #   #   #     #     #     # # #   #     #   #         #     # #   #     #     #   #     # # #   # #     # # #   # # #     
# # # # ### ### # ### ### ##### # # ##### ##### ##### ##### ### ### ### ##### ##### # ####### # # # # # # ##### # ### # # # ####
# #   #   #     # #   #     # #   #     # #   #   #   #   # # #   #   #     #       #       # #   # # # # #     #     # #   #   
# ####### ####### # ##### # # ##### # ### # # ### # ### # # # ### ### ##### ############### # ##### ### # # ##### ####### ### # 
#     #   #   #   #     # # # #     # #   # #   # # #   # # # #     #     #     # #       # # #   #     # # #   #   #       # # 
##### # ##### # ##### # # # # ### ### # ### ##### # # ### # # # ####### ####### # # ##### # # # ### ##### # # # ### # ####### # 
#   # #     # # #   # # # # #   #   # #   # #     # #   # # #   #     # #       # #     # # # # #   #   #   # #   # #         # 
# ### ##### # # # # ### # # ### ##### ### # # ##### ##### # ##### # # # # ####### ##### # # # # # ##### ##### ### # # ######### 
# #   #     # # # #     # #           #   # # #       #   #   #   # # #   #           # #       # #     #   #   # # #       #   
# # ######### # # ##### ############### ### # ####### # ##### # ### # ##### ########### ##### # # # ##### # # # ### # ####### ##
# #   #   # #   # #   # #             # #   #   #   # # #   #   #   #                   #   # #           #   #         #   #   
# ### # # # ### # # # # # ########### # # ##### # # # # # # # ### ### # ################# # ####### ################# # # # ####
#   #   # # #   #   # # # #         #   #         #   #   # # #   #   #       #     #   # #       #             #   # #   # #   
### ##### # # # ##### # # # ### # # ####### # ##### ####### # # ####### # ### # # # # # # ####### # # ########### # ######### # 
#   #     #   #   #   # # #   # # #         # #     #       # # #   #   #   # # # #   # #   # #   # #     #     # #           # 
# ### ######### ### ### # ### # # # ### ##### # ### # ######### # # ##### # # # # ##### ### # # ######### # ### # ############# 
# #   #   #   # #   #   # #   # # # #   #     #   # #   #     # # #   #   # #   #     # # #   # #   #     #   # #     #   #     
# # ##### # # ### ### # # # ##### # # ### ######### ### # ### ### ### ##### ######### # # ### # # # # ####### # ##### # ### ####
# #     #   #   # #   # # # #     # # #       # #     #   # #     # #   #       # #   #     # # # # #     #   #     # #     #   
# ##### ####### # ##### # # # ####### ####### # # ### ##### ####### ### ####### # # ######### # ### ##### # ####### # ####### # 
#   #   #     #   #     # # # #       #     # # #   #     #   #   #   #       #   # #     #   #     #   # #   #   # #   #   # # 
### # ####### ##### ##### # # # ####### ### # # ### # ### ### # ##### ####### ##### # ### # ######### # ##### # # ##### # # # # 
#   #       #     #     # # # # #   #   # # #   #   #   # #   # #     #     #   #   # # #   #         # #   # # #     # # # # # 
# ######### ### ### ##### ### # # # # ### # ##### # ##### # ### # ##### ####### # ### # ##### # ####### # # # # ##### # # ### # 
# #       #   #       #   #   #   # # # #   #   # # #           #   # #       # # #   #   #   # #   #   # #   #     # # # #   # 
# # # ### ### # ####### ### ####### # # ##### # # # # ##### ####### # ####### # # # ### # ##### ### # ### ######### # # # # ### 
#   #   #   # # #   #   #     # #   # # #     #   # # #   #       # #   #   # # # # #   #   #   #   #   # #     # # #   #   #   
####### ### # ### # # ### ### # # ### # # ########### # # ### ##### ### # ### # ### ### ### # ### ##### # # # # # # ##### ######
#   #   #   #   # #   #   # #   #   # # #     #       # #   # #   #         # #   #     # #   #   #   # # # # #   #   #   #     
# # ##### ##### # ##### ### ####### # # ####### ####### ### # # # ##### ### # ### ####### ##### ##### # # ### # ##### ### # ### 
# #     #   # #   #     #   #     #   # #       #       # # # # #   #   #   #         #       #     # # # #   # #     #   # # # 
# ##### ### # ##### ### # ### ### ##### # ####### ####### # # # ### ### # # # ### ### ### # # ##### # # # # ### # ##### # # # # 
#   # #   #   #       # #   #   #     # #       # #       # #     # #   # #   #   # #     # #     #     # # #     #     # # #   
### # ### ### # ##### # ### ### # ##### ######### # ##### # ##### ### ### ### # ### ### ### ##### # ### # # ##### ##### # # ####
#   #   # #   #   #   #     #   # #   # #       # #     # #     #     #   #   #   #     #   #   # # #       #   #       # #   # 
# ### ### # ####### # ####### ##### # # # ##### # # ### ####### ####### ### # ### ##### # ### ### # # ####### # ######### ### # 
#   # #   #     #   #       #       #   #   # #   #   #       #         # # #   #     # # #         # #     # #     #   # #   # 
# # # # ####### # ####### ### ############# # ##### ######### ########### # ######### # # ##### ##### # ### # ##### # ### # ### 
# # # #       #   #     # #   #   #       # #       #       #   #     # # #   #       # #   #   #     #   #   # #   # #   # #   
# # # ####### ### # ### # # ### ### ##### # ##### ### ##### ##### ### # # # # # # ######### # ### ####### ##### # ### # ### # # 
# # #     # #   # #   # #       #   #   #   #   #   #   #   #   #   #   # # # # # #     #   # #   #     # #     # #       #   # 
### ##### # ### # ### # ######### ### ####### # ### ##### ### # # ####### # ### # # ### # ##### ### ### # # ##### ####### ##### 
#   #   #     # # #   #     #   # # #   #S  # #   #   #   #   #   #     #   #   # #   # # #   # #   # #   #     #     #         
# ### # ##### # # # ####### # # # # ### # ### ### ### # ### ####### ### ### # ####### # # # # # # ### ##### ### ##### # ### ####
# #   #   #   # # #   #   #   #   #     # #   #       #   # #       #   #   #   #   # # # # # # #     #       # # #   # #   #   
# # ##### # ### # ### # # ######### ### # # ##### ### ### # # ####### ### # ### # ### # # # ### ####### ##### # # # ### # ### # 
# #   # # #     #   # # #       #   #   #   #     #     # # #     #     # #   # #     #   #     # #         # #   #   # #   # # 
# ### # # ##### ##### # ####### ##### # ##### ### # ### # # ##### ##### # # # # ################# # ####### # ### ### # ### ### 
#   # # #     #       #   #   # #   # # #   # # # #   #   # #   #   #   # # # #   #   #   #       # #     # #   #   #     # #   
# ### # ##### ############# # # # # # # # ### # # ####### # # ##### # ### # # ### ### ### # # ### # # ##### # # ########### # ##
# #   #     # # #   #       #   # #   # #   # # # #   #   #   #   # #   # # #   #     #   # #   #   #       # #   #     #   # # 
# # ####### # # # # # ########### ##### ### # # # # # # # ### # ### ### # ##### ####### ### ### ################# # ### # ### # 
#   #       # # # # # #             # #   #   #   # #   # # # #     # #   #                   #       #           # #   # #   # 
# ### ####### # # ### # ########### # ### ### ##### ##### # # ####### ##### ### ### ############### # ##### # ####### ### # ### 
# #         # # # #   #       #     # #       #     #   # # #       #       # #   # #     #       # #   #   # #       #   # #   
# # ####### # # # # ######### # ##### # # ##### ##### # # # ####### ##### ### ### ### ### # ##### ##### # # # # ####### ### ### 
# # #     # # #           #   # #       # #     #     # #         #     # #     #     # # # #   #       # # #   #     # #   #   
# # # ### # # ##### ##### ##### # ### ### # ##### ### # # ##### # ##### # # ########### # # # ########### # ##### # ### # ### # 
# # #   # # #   #   #   #   #   #   # #   # #   #   # #   #   # #   # #   #   #       #   # #         #   #     # # #   # # # # 
# # # # # # ### ##### # ### # ##### ### # # # # ##### ### # # ### # # ####### # ##### ##### ####### ### ### # # ### # ### # # # 
# # # # # #   #       # #     #     #   # #   # #   #   # # #   # # #       # # #   #     #       #     #   # #     # #   #   # 
# # ### # ### ######### ############# ######### # # ### # # ### # # ### ### # # # ####### ####### ####### ### # ##### # ####### 
# #   # #   #   #     #   #     #   # #     #   # #     # # #     #   # #   # # #           #   #   #       # #     #   #       
# ### ##### ### # ### ### # ### # # ### ### # ### ####### # ######### # # ### # ######### # # ##### ##### # # ### # ##### ######
#             #   #     # # #   # #   #   #   #   #       #   #     #   # #       #     # #   #     #   # # #   # #   #         
####### # ############# # # # ### ### ### ######### ### # ### # ######### # ##### # ### ####### ##### # ### # # ### # # ####### 
#   #   # #       #   # #   #   #   #     #     #   #   #   # # #     # # #     # #   #   #     #   # # #   # #   # #         # 
# # ##### # ##### # # ######### ### ####### ### ########### # # # ### # # ### # ######### # ##### # # # # ### ### ####### # ### 
# #     # # #   #   #       #   #   #     #   #           # # #   #   # #   # #     #     #   #   #   # #   #   #   #   # # #   
# ##### # # # # ########### # ### ### ### ### ########### # # ##### ### ### # ####### ####### # # ##### # # ### ### ### # ### # 
#     # # # # #   #   #   #   #   #   #   # #   #     #   # # #   #       # #     #   #   #   # #   # # # #   #   # #   # #   # 
##### # ### # ### # # # # ##### # ##### ### ### # ### ##### # # ### ####### # ##### ### # # ####### # # ##### ### # # ### # ####
# #   #   # # #     #   # #     #   #   # # # # # # #   #   # #   # #       # #   #   # # # # #   # # #     # #   # #   # # #   
# # ##### # # ########### ### # ### # ### # # # # # ### ### # ### # # ####### # # ### # # # # # # # # ##### # ##### ### # # # # 
# #     #   #   #   #   # #   #   #   #     # # # #   #   # # #     #   # #     # #   # # # #   # #   #   #   #     # # # #   # 
# ##### ####### # ### # # # ### # ##### ##### # # # # ### ### ##### ### # # ##### # ##### # ##### ##### # ##### ##### # # ##### 
#   # # #       #     #   # #   # #   # #     #   # #   # #   #   #   # #       # # # #   #     # #     #     # #   # # #     # 
# # # # ### ##### ######### ##### ### # # ############# # # ### # ### # ### ##### # # # ####### # # ######### # ### # # # ##### 
# #   #   #     # #     #   #     #   # #           #   # # #   #   # #   # #     # #   #     #   #     #     #   # # # #   #   
# ####### ####### ### # # ### ##### ### ### ####### # ### # # ##### # ### # # ##### ### # ### ##### ### # ####### # # # ##### # 
# #     #   # #   #   #   #       # #   #   #   #       # # #   #           #     #   # # #   #     #   #     # #   # #       # 
# # ####### # # ### ####### # ### # # ####### # # ####### ##### # ################### # # ######### # ####### # ##### ######### 
#   # #     #       #       #   #   #       # # #   #   # #   # #   #   #   #       # # #   #     # #   #   #       #     #   # 
# ### # ############### # # ### ########### ### # ### # # # # ### ### # # # # ##### # # ### # ### # ##### # ### ### ##### # ### 
#     # #     #   #     # # # #       #     #   # #   # #   #   # #   # # # # #     # # # #   # # # #     #   #   #   #   #   # 
##### # ##### ### ##### # # # # # ##### ##### ### # ########### # # ### # # # # ##### # # ##### # ### ####### # # ### # ##### # 
# #   #     #   # #   # # #   # # #   # #     #   # #     #   #     #   # #   # #     #         #   #   #     # # #   #     #   
# # ####### ### # # # ### ##### ### # # # ##### ### # ### # ####### ##### ##### # ######### ### ### ### # ##### # ####### ##### 
# # #     #     #   #     #     #   #   # #         #   #   #     #         # # # #   #     #     #     # #     #         #     
# # ##### ############### # ### # ####### # ### # ##### ##### ### ######### # # # # ### # ### ### ####### # ########### ### ### 
#   #                     #   # #   #   # #   # #     # # #   # #   #     # # # # #   # # #   #           # #     #   #   #   # 
# ### ##### # ######### # ### ##### # ### ### # ####### # # ### ### # ### # # # # ### # # # ########### ### # ### # # ####### # 
#   #   #   #       # # #   # #     # #   #   #   #   #   #     #   # #   # #   # #   # # #   #       # #   #   # # #     #   # 
### # # # ######### # # ##### # ##### # ##### ### # # ### ####### ### # ### ##### # ### ##### # ##### # # # ##### # ##### # ### 
#   # # # #       #   #     #   #     #     #   #   #         # #     #   # #   # #   # #     #   # # #   #       #   # #   #   
# ### # # ####### ######### ##### # ####### # ############### # ######### # # # # ### # # ### ### # # # ############# # ####### 
# #   # # #         #     #       #         #     #         #     # #   #   # # # #     # #     # # # # #   #     #   #         
# ##### # # ######### ### # # # ####### ##### ### # ####### ##### # # # ### # ### # ##### ### ### # # # # # # ### # ### ########
# #   # # #   #   #   # # # # #       #       #   #   #   #     #   # #   # # #   # #   #   # #   # # # # #   # #   #   #   #   
# # # # # ### # ### ### # # # ####### ### ### # ##### # # ##### ##### ### # # # ##### # ### # # ### # # # ##### ##### ### # ### 
#   # # #       #   #     # # #   #   # #   # #     # # #     # #   # #   #   #       #     # #   #   # # #   #       #   #     
##### # ######### ####### # # # ### ### ### # ####### # ##### # # # # # ##### ##### ############# # ### # ### # ##### # ########
# #   # #       #       # # # # #   # # #   #   #     # #     #   #   #             #   #       # #     #     #   #   # #       
# # ### # ##### # ##### # # # # # ### # # ### # # ##### ########### ########### # # # # # ##### # ##### ####### # # ### # ##### 
#   #   #   #   # #     # # # #   #       #   # # #   # #           #         # # # # #   #   # #     #         # #     #     # 
# ##### ### ##### # ##### # # ########### ##### # ### # # ##### ### # ####### ### # # ##### # ### ### ##### ##### ####### ### # 
# #   #   #     # #     #   #     #     # #   # #   # #   #     #   # #     #     # #       #   # #   #     #             #   # 
# # # # ####### # ##### ##### # # # ### ### # ##### # ####### # # # # ##### ####### ########### # # ### ##### ##### # # ####### 
#   # #     #   # #   # #   # # # #   # #   #     # #     #   # # # #   #     #     #   #     # # # #     #   #   # # #   #   # 
##### ##### # ##### # # # # ### # ### # # ######### # # # # ### # ##### # ### # # # # # # # ### ### # ### # ##### # # ### # # # 
#   #   #   # #     #   # # #   # #   # # #       # # # # #   # #     # # #     # #   #   # #   #   #   # #     # # #   # # # # 
# # ### # # # # ######### # # ### # ### # # ##### # # # # ### # ### # # # ######### ####### # ### ### ### ##### # # ### # # # # 
# #   #   # # #     #     #   #   #   #   #   #     # # # #   # # # # # #     #   # #     # #   # #   #   #     # #   # # # # # 
# ######### # ##### # ########### ### ##### # ######### # # # # # # ### ####### # ### ### # ### # ##### ### ##### # # ### # # ##
# #       # #     # #     #     #   #   #   #   #       # # # #   #   #       # # #   # # #   # # #   #   # #   # # #   # # #   
# # ##### # ##### # ##### # ### # ##### ##### # ######### # # ####### ####### ### # ### # ### # # # # ### # # # # ##### # ##### 
# #   #   #     # #   #   # # # # #   #     # #     #   #   #   #     #     #     # # #   #   #   # # #   # # # #       #   #   
# ### # ### # # # ### # # # # # # # # ##### # ##### # # ##### # # ######### ####### # # ########### # ##### ### ########### # ##
# #   #     # # #   # # # # #   # # #   #   #     # # #       # #   #     #G# #     #               #     # #   #     #     #   
# # ########### ### # # ### ##### ##### # ######### # # ########### # # ### # # ######################### # # # ### # # # ##### 
#   #             #   #     #           #           # #           #   #       #                         #   # #     #   #       
################################################################################################################################
