################################################################################################################################
         #   #       #           #       #                     #       #           #       #   #     #       #     #   #   #   #
 # ##### # # # ##### ########### # ### # # # ### ############# # ### # ### ####### # ### ### # # ### ####### ##### ### # # ### #
 #     #   # # #   # #     #   # # #   #   #   # #     #       #   # #   #   #     # # #   # # # #   #       #       # # #     #
 ##### ##### # ### # # ### # ### # # ##### ### # # ### ### ####### # ### ##### ##### # ### # # # # ### ####### ##### # # #######
     #   #   #   # # # # # #   #   # #   # #   # # # #   #         # #       # #     #   #   #   #     #     #     #   #   #   #
## ##### # ##### # # # # # ### ### # ### # # ##### # ### # ######### ####### # # ##### # ############### ### # ### # ##### ### #
   #   # # #     # #   # #   #   # #     # #   #   #   # # #         #   #     # #   # #                   #   #   #     #     #
 ### # # # # ##### ##### ### ### # ######### # # ##### # # # ####### # # # ### # # ### ####### ######### # ##### ##### # ##### #
 #   # # # # #             # #         #   # # #   # # # # # #       # # #   #         #     #     # #   #   # # #   # #     # #
 # ### # # # # ######### # # ### ####### # ### ### # # # ### # # ##### # # # ##### ##### ### # ### # # ### # # # # # # ##### # #
 # # #   #   # #       # # #   # #     # #       # #   #   # # # #     # # #     #     # # # # #   # #   # #   # # # #     #   #
## # ##### ##### ##### # ##### ### ### ########### # ##### # # ### ##### # ##### # ### # # # # # ### ### ####### # # ### # #####
   #       #       #   # #   #   # # # #           #     #   # #   #     # #     #   # #   # # #   #     #       # #   # #     #
 ######### # ####### ### # # ### # # # # ############### ##### # ######### # ####### # ##### # ### ####### ####### ### # ### # #
     #     # #     # #     # #   # # # # #     #               # #     #   # #   # # #   #   #   # #     # #     # #   #   # # #
#### ##### # ##### # # ####### ### # # # # ### # # ############# ### # # # # # # # # ##### ####### # ### # # ### # # ### # ### #
   #   #   #     #   # #   #   #   # #   # # # # #       # #   #     #   # #   # # # #     #       #   # # #   #   # #   #   # #
 ##### # ####### ##### # # # ####### ##### # # # ####### # # # ########### ##### # # # ##### ######### # # ######### # ##### # #
     # # #     # #     # # #     #   #   # # #   # #     #   #   #       # #   # #   #   #   #       # # #   #       #     # # #
 ### # ### ### # # ####### ##### ### # # # # ### # # ########### # # # # # # ### ####### # # # ##### ### ### # ####### ##### # #
   # #     # #   #             #   #   # # #   # # #         #   # # # # # #     #   #   # # #     #   # # # # #     #   #   # #
## # ####### ############# ####### ##### # ### # # ######### # ### # ### # ####### # # ##### ######### # # # # # # # # ### ### #
 # #     #     #   # #   # #       #     #     # #     #   #   #   # #   # #       # #     # #   #     #   #   # # # # #   #   #
 # ##### # ##### # # # ### # ####### ########### ##### # ####### ### # ### # ####### ##### # ### # ####### ####### # ### ### # #
     #   # #     # #     # #   #   #         #     #   #         #   #   #     #   #   #     #   # #   #   #   #   #     #   # #
 ##### ### # ##### ##### # ### # # ######### # # # # ### ######### ### ####### # # ### ####### ### # # # # # # # ########### # #
   #   #   #     #   # # #   #   #   # #   #   # # #   #   #       #   #     #   #   #   #       # # # # # # #   #   #       # #
## # ### ########### # # ### ####### # # ### ### # ### ### # ####### ### ### ####### ### # ##### # ### ### # ##### # # ### ### #
 # #     #     #     #   # # #   #   #       #   #     # # #     #     #   #   # #   #   #     # #   # #   #   # # # # #   #   #
 # ####### ##### ####### # # # ### ######### # ######### # ##### ##### ### ### # # # # ####### # ### # # ##### # # ### # ### # #
           # #   #     #   # #   #     # #   #           # # #   #   # # # # # #   # # #   # # #             # #       #   # # #
## ####### # # ####### # ### ### ##### # # # ####### ##### # # ### # # # # # # ### ### # # # # ############# # ########### # # #
 # #     #   # #         #   # #     # #   # #     #     # # # #   # #   # # #   # #   # # # # # #         # # #       #   # # #
 # # ### ### # # # ####### ### # ##### ### # # ######### # # # # ### # ### # ### ### ### # # # # # ####### ### # ##### # # # # #
   #   # #     # #         #     #     #   #   #   #     #   # #   # #   # # # #     #   # # # # # # #     #   # #   #   # # # #
 ##### # ### ### ########### ##### ############# # # ####### ##### # ##### # # ####### ### # # # # # # ##### ### # # ##### # ###
 #     #   # #   #               #               # #         #   # #   #   #   #       #   #     #   #   #   #   # # #     #   #
## ####### # # ### # ####### ### ################# ########### # # ### # ##### # ######### # ### ####### # ### ### # ### # ### #
   #       #       # #       #           #       #     #       #   # #   #     # #   #   # #   #       #   #   #   #   # #   # #
 ### ####### ##### # ######### ####### # # # ### ##### # ########### ##### ##### # # ### # # # ################# # ### # # ### #
 #       # # #   # # #   # #   #       #   #   #     # #         #     #   #     # #     # # # #         #     # #   #   #   # #
 ####### # # # # ### # # # # ### ############# ##### # ######### # ##### # # ##### ####### # ### ####### # ### # ### ####### # #
 #   #   #   # #   #   # #   # # #   #       #     # # #   #     #   #   # #       #   #   #   # # #   #   #   #   #       # # #
 # ### ### ### ### ##### ##### # # ### ##### ##### # # # # # ####### # ### ######### # # ##### # # # # ##### ### # ##### # ### #
   #   # #   #   #   #   #   # # # #   #   #       # #   # #   # #   #   #           # # #     #   # # #     #   # #   # #   # #
#### ### ### ### ### ##### # # # # # ### # ######### ##### ### # # ##### ############# # ##### ### # ### ##### # ### # ##### # #
 #   #     #   #   # #     #S#   #   #   #     #   #     #   # #   #   #     #       # #     #   # #     #   # # #   #     # # #
 # ####### ### ##### # ##### ####### # ####### # # ##### ### # # ### # ##### # ##### # ##### ### # ######### ### # ######### # #
   #   #         #   # #     #     # #   #   #   #     #   #   #     #   # #   #   # # #   #     #         #     #         # # #
 ##### # ##### # # ### # ##### ### ##### ### ######### ######### ####### # ##### # # # # ####### ######### ############### # # #
 #   #   #     # #     # #   # # #     #     #   #   #         # #     # # #     #   # # #               #   #   #       # # # #
 # # ##### ##### ####### ### # # ### ######### ### # ######### # # ### # # # ######### # # ######### ### ### # # ####### # # # #
   #     # #   #   #         #     # #       #G    #     #   # # # #   #   #   #   # # # #   #   #   #     # # # #       #   # #
######## ### # ### # ############# # # ##### ####### # # ### # ### # ##### ### # # # # # ### # # ##### ### # # # # ######### # #
 #       #   #     #   # #         # #   # #         # #     #   # # #       #   #   # #   # # #     # #   # # # #           # #
 # ####### ########### # # ######### ### # ######### # ##### ### # # ####### ######### ### # # ##### # ### # # # ##### ####### #
   # #     #   #       # # #   #   #   #   # #       #   # #   # # # #               #   #   # #     #   # # # # #     #       #
 ### # ### # # # ####### # ### # ##### ##### # ### # ### # ### # # # # ### ######### ### ### # # ####### # # # # # ##### ##### #
   # #   # # # #     # # #   # # #     #       #   #   #   #   #   #   #   #                 # #       # # #   # # #   # #   # #
## # ### ### # ##### # # ### # # # ############# ##### ##### # ######### ### ############### # ####### # # ##### # # # # # # # #
 # #         # #     # #   # #   #   #   #   #   #     #   # #       #   # # #   # #         #   #   #   # #     # # #   # #   #
 # ####### ##### ##### ### # ### ### # # # # # ### ### # # # # ### # # # # # ### # # ########### # # ##### # ####### ##### ### #
     #   #     # #   #     #   #   #   # # #   # # #   # # # # # # #   #   # #     #   #   #   #   # # #   #         #       # #
#### # # ##### # ### ### ##### # # ####### ##### # # # # # ### # # ######### # ####### # ### # ##### # # ############### # # ###
   #   #       #   #   #     #   #     #   #   #   # # # #   #   # #         #       # # #   #     # #   #   #   #       # #   #
 # ######### ##### ### # ############# # ### ####### # # ### ##### # ######### ####### # # ### ### # ### # # # # ######### ### #
 #     #     #     # # #   #   #   # # # # #     #   # #   #       # #   #   #   #   # # # # # #   #   #   # # #     #     #   #
 ##### # ##### ##### # ### # # ### # # # # ##### ### # ### ####### # # # ### # # # # # # # # # ####### ##### # ##### # ##### # #
 #     # #           #   #   #   # # #   #   # #   # # #   #   #   # # # #   # # # # # #   #   #   #   #   # #   #   # #     # #
 # ##### # ####### # ### # ##### # # ##### # # ### ### # ### ### # # ### # ### ### ### # ####### # # ### # # ### ##### # ##### #
 #   #   # # #   # #           # # #     # #     #   # #   # #   # #   # # #     # #   #     #   #   #   # # # #     # # #   # #
 ### # ### # # # ### ######### # # ##### # ##### ### # ### # # ### ### # # ##### # # ####### # ### ### ### # # ##### ### # ### #
   # #   #   # #   #   #     # # # #   # # #   # #   #   # #   #   # #   #   #   #   #       # #   #   # # # #     #     #     #
## # # ##### # ### ##### ### # # # # # # # # # ### ### # # ##### ### ####### # ####### ####### ##### ### # # ### # ########### #
 # #   #   # #   #     # #   # #   # # # # # #     #   # # #         #     #           #     # #         # # #   # #   #   # # #
 # # ### # # ### ##### # # ### ####### # # # ######### # # # # ######### ### ########### ### ### ######### # # ### # ### # # # #
 # # #   #   # # # #   # # #       #     # #           # # # # #       # #   #         # # #   # #   #   # # # #   # #   #   # #
 # # # ####### # # # ##### # # ### # ##### ########### ### # ### ##### # # ### ####### # # # # # # # # # # # # # ### # ####### #
   # # #     # # # #       # #   #     #   # #         #   #     #   # # #   # #   #   # # # #   # #   #   #   #     #   #     #
#### # ##### # # # ############# # ##### ### # # # ##### ### ##### ### # ### # # # # ### # # ##### ############# ####### # # ###
   #           # # #   #   #   # # #     #   # # # #   # #       # #   #   # #   # #     # # #     # #   #       #     # # #   #
 # ######### ### # # ### ### # # # # ##### ### # # # # # # # ##### # ##### # ##### ####### ### ##### # # # ####### ### # ##### #
 # #         #   #   #   #   # # # #     #     # # # #   # #       #     # # #   #       # #   #   #   # #   #     # # #     # #
 ### # ##### # ##### # ### ##### ####### ####### ### ##### ############# # # # ####### ### # ### ####### ### # ##### # ##### # #
     # #   # #     #   # #     #     #   #       #   #     #           #   # # #     # #   #   #             #   # #   #   # # #
######## # # ##### # ### ##### # ### # ### ####### ### # ### ######### ##### # # ### # # ##### ############# ### # ##### # # # #
     #   #     #   #         # # #   # #   #       #   #   # #     #   #     # # #   # #     # #               # #       # #   #
 ### # ##### # # ######### ### ### ### # ### ######### ### # # ### ##### ##### # # ### ##### # # ########### ### ####### ##### #
 # # # #   # #   #     #   #   #   #   #   # #   #   #   #   # # #       #   #   #   #   # # # #     #     # #   #       #   # #
 # # # # # ##### # ### # # # ### ### ### # # # # # # ### ##### # ######### # ####### ### # # # # ### # ### # # ### ##### # ### #
   #   # # #   # # # # # #       #   #   # #   #   # #     #   #         # #       #   # # #   # #   # # # # #     #   # #   # #
###### # # # # # # # # ########### ####### ######### # ##### ########### # # ######### # # ##### # ### # # # ####### # # ### # #
 #   # # # # #   # #             # #     #         # #   #   # #   #     # # #   #     # #       #   # # # #         #     # # #
 # ### # # ##### # ############# # # ### ### ### # # ##### ### # # # ####### # # # ##### # # ####### # # # # ############### # #
       # #   #   #         #     #   # #   #   # # #       #   # # #       #   # # #   # # #   #   # # #   #     #   #     #   #
## ##### ### # # ########### ######### ### ### # # ######### ### # ####### # ### # # ### ####### # # # # ##### ### # # ### ### #
   #   # # #   #     #       #           #     # #           #   #         #   #   # #   #       #   # #   #   #   #   # # #   #
 ### # # # ### ##### # ################# ####### ### # # ##### ############### ##### # ### # ######### ### # ### ####### # ### #
   # # # #   # #     #   #     #         #     # #   # # #     #             #   #   # #   # #       # # # #   # #       #   # #
#### # # # # # # ### ### ### # # ####### ### # # ####### # ##### ### # ### # ### # ### # ##### ##### # # # ### # ##### ##### # #
     #   # #   #   #   #     #   # #     #   # #   #   #         # # # #   #   #     #   #     # #   # #       #     #     #   #
 ##### ####### ### ### ########### # ##### ### ### # # ####### # # # # # ##### # ######### ##### # ### ### ### ##### ##### ### #
 #   # #     # #   #         #     #     # # #   # # #       # # #   # # #     # #     #   #     #     #   #   #   #   #     # #
 ### # # ### ### ### ####### # ### ##### # # # # # # ##### # # ######### ####### # ### # ### ######### ##### # ### ### # ### # #
 #   # #   # #   #   #     #   #     #   #   # # #   #   # # #         # #       # #   # #     #     # #     #   # #   #   #   #
 # ### ### # # ### ### ######### ### # ####### # ##### # ### # ####### # # ####### # ### ### # # ##### # ####### # # ### # #####
 #   # #   #   # #   #     #   # #   # #   #   #   #   # #   # #   #   # #   # #   #   #   # #   #     # #     # # #   # #     #
 ### # # ##### # ### ##### # # ### # # # # # ##### # ##### ### # ### # ##### # # ######### # ##### ### # ### # # # ### ### ### #
 #   # # #   # # # #     # # #   # # #   # # # #   #       #   # #   # #       #           # #     # # #   # # #     #   # #   #
 # ### # # # # # # ##### # # ### ### ##### # # # ########### # # # ##### ################### # ##### # ### # ### ####### # # ###
 #   # # # #   # #     #   #   #   #     #   #               # # #     # #         #       #   #         # #     #   #   # #   #
 ### # # ##### # ##### ####### ### ##### ####### ##### # # ##### ##### # # ####### # ##### ######### ##### # ##### # # ### ### #
   # # # #   # # #           #   #               #     # #       #   #   #     # # # #   #       # # #     # #     # # #     # #
## # # # # # ### ##### ##### ### ############# ### ##### ######### # ######### # # # ### ####### # # # # ### # ####### # ##### #
   #   #   #     #   #     #   # #     #       #   #     #         # #     #   #   # #         # #   # # #   #         #   #   #
 ##### ########### # ######### # # ### # ##### # ######### ######### # ##### ####### # ### ### # ##### # # # ########### ### ###
     #   #     #   #       #   #     # #     # # #         # #       # #   # #       #   #   # #   #   # # #             #   # #
 ### ##### ##### ######### # ######### ##### # # # ######### # ####### # # # # # # ##### ### # ### # ##### ##### # ### ### ### #
   # #   #   #   #       # # #   #     # #   # #   #       #   #       # #   # # # #     #   # #   # #     #   # #   # # #     #
## # # # ### # ### ####### # # # # ##### # ### ##### ##### ##### ####### ##### # # ### ### ### # ### # # ##### # ##### # #######
   # # #     # #     #   # #   # # #     # #     #   #   #       # #   # #     # #   # #   # # # #   # # #     #   #   # #     #
 ### # ####### ### ### # # ##### # # ##### ####### ##### ######### # # # # ##### ### # # ### # # # ### ### ######### # # # ### #
   # #     #     #     #   # #   #   #   #     #   #     #     #     # # # #   #   # # #     # # #   #   # #   #     # #   #   #
#### ##### ##### # ######### # ####### ####### # ### ### # ### # ##### # ### # ##### ######### # ### ### # # # # ########### ###
     #   #       # #   # #     #     #       #   #     # # #   # #   # #     #     #     #   # #   # #   # # #   #         # # #
 ##### # ######### ### # # ##### ########### ##### ### ### # ### ### # ########### ##### # ### ### # # ### # ##### ####### # # #
       #                                             #     #         #           #       #           #     #             #     #
