################################################################################################################################
#   #       #         #       #   #   #   #   #     #       #         #   #                 #       #       #     #         #   
# # # ##### # # # ##### ##### # # ### # # # # # ### ### ### ### ##### # # ##### ####### ##### ##### ##### # # ### ### ##### # # 
# #   #   #   # # #         # # # #   # #   # # #       #   #   #   #   #     #   # #   #   #   #   #   # # # # #   #     #   # 
####### # # ### # # ######### # # # ##### ##### ######### ### ### # ######### ### # # ### # ##### ### # # # # # ### ########### 
#     # # # #   # #   # #     # # #   #   #   # #       #   # #   #         #     #   # # #   #   #   #   # # #   #   #         
# ### # # ### ### ### # # ##### # ### # ### # # # ##### ### # # ########### ####### ### # ### # ######### ### # ##### # ########
#   #   #   #   #   # # #   #   # #   # # # # # #     # #   # #       #     #     # #   #   #   #   #     #   #       #     #   
### ####### ### ### # # ### # ### # ### # # # # ##### # # ### ### ### # ### # ### # # # ### ####### # ### # ####### ####### # # 
# # #     #     # # #   #   # # #   #   # # # # #     # #   #   # #   # #   # #   # # #   # #     #   #   #       #   #     # # 
# # # ########### # ### ##### # ##### ### # ### # ##### ### ### # # # # ### ### # # # ##### # ### ##### ######### ### # ##### # 
# # #   #   #     # #   #   # #     #         #       # # # #   # # # #   #     # # #     # #   # #     #   #   # # # # #     # 
# # ### # # # # ### # ### # # # # # ######### ######### # # # ##### # ### ####### # ##### # ### # # ##### # # ### # # # # ##### 
#   #     #   #     # #   # # # # #           # #       #     #     #   #   #   # # #   # #   # #         # # #   # # # #     # 
##### ##### ######### # # # # ### ########### # # ############# ##### # ### ### # # # # # ### ##### ##### ### # ### # # ####### 
#   # #   #   #     # # # # #   # #     #   # # # #       #       #   #   #   #   # # #     #     # #   # #   # #   # #   #     
# # ### # ### # ### # # # # ### # # ### # # # # # ####### # # ### # # ####### # ### ##### ####### # # # ### ### # # # ### # ####
# #     #     # #   # # # # #   #   # # # #   # # #       # # # # # #     # # #   #     #     #   # # #     #   # # # #     #   
# ########### # # ### ### # # ### ### # # ##### # # ######### # # ### ### # # ### ##### ##### # ### # ####### ##### # ### ### # 
#   # #       # #   #     # # #       # #   #   # # #   #     # #   #   #   #   # #   # #     #   # #         #   # #   #   # # 
### # # ####### ### ####### # ### ##### ### ### # # # # # # ### ### # # ####### # # # # # ### ### # ########### # # ### ### # ##
#   # #       # #   # #     #   # # #   #   #   #   # #   #       # # #       # # # #     #     # #   #         #     #     #   
# ### ### ##### # ### # ####### # # # ### ### # ##### ### ######### ########### # # ######### # # # # ### ########### ##### ### 
#   #   # #     #     #   #   # #   # #       #       #   #         #   #       #   #     #   # # # #     #                     
### # # # # ############# # # # ##### ######### ######### # ######### # # ##### ##### ### # ### # ####### # ######### ##### ####
#   # #       #     #     # #         #   #     #       # # #   #   # # # #     #     # #   #   #       # # # #       #   # #   
# ########### # ### # ##### # ######### # # ######### # # # ### # ### # # # ### # ##### ##### ######### ### # # ####### # # # # 
#       #   # #   # #   #   # #       # # # #   #   # #   #     #   # #   # #   #     #     #     #   # #   #   #       # # # # 
####### # # # ### ##### ### # # ##### # # # # ### # # ########### # # ####### ####### ##### ##### ### # # ##### # ####### # # ##
#   #   # # #   # #   #     # # #   #   #   #   # # #             # #   #   #       #       #         # # #     #   #   #       
# ### ### # ### # # # ####### # ### # ######### # ############# # # ### # # # # ### ########### ##### # # ######### # ##### ### 
#     #   # #       #         #   #   #   #   # #   #   #       # #   #   # # # # #       #   #   #   # #     #     #       #   
##### # ### # # ####### ##### ### ### # # # ### ### # # # ####### ### ##### # # # ##### # # # ##### # # ##### # ######### ### # 
# #   # # #   # #       #   #   #   # # # # #   # #   #   #     #   # # #   # # #       # # # #   # #     #   #       #   #   # 
# # # # # ####### # ##### # ### ### # # # # # ### ######### ### # # # # # ##### ######### # ### # ####### # # ####### # ### ### 
#   # #   #       # #     #       # # # # #         # #     # #   # #   #     #     #     # #   #   #   #   #     #   # #   #   
# ### ##### ##### ### ######### # # ### # ######### # # ### # ##### ######### ##### # ##### # ##### # # ####### # # ##### ### ##
# #       #   #   #   #     #   # #     #   # #   # #   #   #     #   #       #     #     #   #   # # #   #   # # #     #   #   
# # # ### ### ##### ### ### # # # ######### # # ### ##### ####### ### # ################# ##### ### # ### # # ### ##### ### ### 
# # #   #S  #     #   #   #   # #         # # #   #     #   #         #           #   #       #     #   # # # #     #   #   # # 
# # # ##### ##### ### ######### # ####### # # ### ##### # # ######### ########### # # ######### ####### # # # # # ### ### ### # 
# # #     #   # #   # #     #   #   # #   # # #   #     # #     #       # #   # # # #     #     #     # # # #   # #   #   #   # 
# # ####### # # ##### # ### # ##### # # ### # # ### ##### ##### ##### # # # # # # # ##### # ##### ### # # ######### # # ### ### 
# #   #     #   #     #   # #     #   #   # #     #   #     #   #     #   # # #   # #   # # #   #   # # #         # # #   #     
# ### # ### ##### ####### # # ### ####### # ##### ### ####### ### ######### # ##### ### # # # # ##### # ### ##### # # ### # ####
#   # #   # #     #   #   # #   #   #     #   #     #         #     #       #     #   # # # # #       # #   #   #   #   # #     
# # # ### ### ### # # ##### ### ### # ### ### # ### ########### # # # ########### ### # # # # ######### ##### # ######### ##### 
# # #   # #   #   # #       #     # # # #   # # #             # # # # #     #   # #   # # # #   #   #         # #     #   # #   
# ##### # # ##### # ########### ### # # # # # # # ######### # ### # # # ##### # ### ### # # ### # # ########### # ### # ### # ##
#     # # # #   # #           # #   # # # # # # #     #   # #     # # # #     #   # # #   # #   # # #   #     # # # #   # # # # 
# ##### ### # # ############# ### ### # # ### # ####### # # # ##### # # # ####### # # ##### ### # # # # # ### # # # ##### # # # 
#   #   #   # #       #     #   # #   #   #   #   #   # #   # #   # #   # #       #   #   #   #   # # # #   #   #   #         # 
##### # # ### ### ### # # ##### # ##### ### ### # # # ######### # ### ### # ######### # # ### ##### # # ############### ##### # 
#     # #     # #   # # #   # # #     # #   #   # # #     #   # # #   #   # #       #   #   # #   #   #         #     # #   # # 
# ############# ### ### ### # # ##### ### ##### ### ##### # # # # # ### ### # ##### ####### # # # ############# # ### ### # # # 
# #         #   #   #   # #   #   #   #   #     #   # #   # #   #   # # #   #     #   # #   # # #           # # #   #     # # # 
# # ### ### # # # ### ### ####### ##### ##### # # ### # ### ######### # ########### # # # ### ########### # # # ### ####### # # 
# # # #   # # # #     #       #   #     #     # #     #     #       # #             #       #           # # # #   # #   #   # # 
# # # ### # # ######### ##### # ### ##### # ### ##### ####### ##### # ############# ####### ########### ### # ### # # # ##### # 
#   #   # # #   #   #   #   # #   # #     #   #     #   #     #                     #   #         #     #     #   #   #     #   
# ### # # # ### # # ##### # # ### # # # ##### ######### # ### ####### ### ### # ##### # ##### # # # ##### ### # ########### ### 
#   # # # #   #   #   #   #     # # # #     #   #     #   #   #   #   #   #   # #     #       # # # # #     # # #     #   # #   
# # ### # # ######### # ##### ### # ########### # ### ##### # # # ##### ### ### # ##### ####### # # # # ### # # # ### # # # # ##
# #     # #     #     #   #   #   # #         # #   #   #   # # #       #   #   # #   # #       #   # # # # # # # # #   #   #   
# ####### ### # # ##### # # ### ### # ####### # ### ### # ### # ######### ### ### ### # # ####### ### # # # ### # # ########### 
# #   #   #   # #     # # #   # #   # #   #   #   #   # # #   #   #   #   #   #   #   # #   #     #   # # # #   # #   #   #     
# # # # ############# # # ### # # ### # ### ########### # ####### # # # ### ### ### ### ### ##### # # # # # # ### # # ### # ### 
#   # #               # # # # #   #   #   #       #     # #       # # #   # # #   #       #   #   # #   # # #   #   #   #   #   
# ### ################# # # # ##### ##### ####### # ##### # ### ### # ##### # ### ####### ### # ### ##### # ### ####### ##### # 
#   #   # #G        #   # # #     # #   #       #   #     # #   #   #     # # # # #   # #   # # #   #     #   # #     # #     # 
# ### # # # ####### # ### # ##### # # # # ### # ##### ### # ##### ####### # # # # # # # ### # ### ### ### ### # # ### # # ##### 
# #   # # # #     # # #   #       #   # #   # # #   # #   #     #   #   # #   # #   # #   # #     #   #     #   #   # # # #   # 
# # ### # # # ##### # # ##### ######### ### # # # # # # ####### # ### # # ##### ##### ### # ####### ### ############# # # ### # 
# #   #   #   #     # #     # #   #     # # # #   #   #     #   # #   # # #     #     # #         # # #   #   #       # # #   # 
# ### ####### # ########### # ### # ##### # # ############# # ### # ### # # ### # ##### ### ### ### # ### # # # ####### # # ### 
#   #       # # #         # #   # # #       #       #       #     # # #   #   # #   # #       #     #   # # #   #     # # # #   
### ####### # # ######### # ### # # ############### ####### ####### # ##### # ##### # # # # ######### ### # ##### ##### # # # ##
#   #     #   #     # #   #   # # #       #     #   #   #     #     # #   # #   #   #   # #     #     #   # #           # # # # 
# ### # ########### # # ####### # ####### # ### # ### # # ##### ##### # ### ### # ####### ##### # ### # ### # ########### # # # 
#     # #           # #   #             #   # # # #   # #     # #     #     #   # #     # #   #   #   # #   #             #   # 
# ##### # ########### ### # # ############### # # # ### ### # # # ######### ##### # ### # ### ######### # ################# ### 
#   #   #         #   # #   # #           #   # #     #   # # #   #       # #   # #   #   #   #       # #   #         #     #   
### # # ######### # # # ##### # ######### # ### ######### # # ######### # # # # # ### # ### ### ##### # ### # # ##### # ####### 
# # # #         # # # # #     # #   #     #   #   #       # #   #   #   # # # # # #   # #     # # #   # #   # #     # # #     # 
# # # ### ### # # ### # # ##### ### # ####### ### # ######### # ### # ### # # ### # ##### ##### # # ##### ### ##### ### # ### # 
#   # # #   # # #   #   # #     #   # #       # # # # #       #   # # #   # # #   #     #   #   # # #     #   #   #   # # #   # 
### # # ### ### ### ### # # ##### ### ####### # # # # # ####### # # ### ### # # ####### # ### ### # # ##### ##### ### # ### ### 
#   # #     #   #   #     #     #   #       # # #   # # #       # # #     # # # #       # #   # # # # # #   #     #   # #       
# # # ####### ### ##### ####### ### ####### # # ##### # ######### # # ### # # # # # ##### # ### # # # # # ### ##### # # # ######
# # #       #   # #   #       #   #         #     #   #         #       #   # # # # #   # # #     #   #   # # #   # # # #       
# # ####### ### # ### # ##### ### ############# # # # ######### ### ### ##### # # # # # # # ##### ##### ### # # ### ### # ##### 
# #   #   # #   #     # # #     #   #   #     # # # # # #     #   # #   #   # # # #   # # # #   #   #   #   #   #   #   # #     
### # # # # ### ####### # # ####### # # ##### ### ### # # # ##### # ##### # # # # ##### # # # # ### # ##### # ### ### ### ######
#   # # # #   #       # # # #       # #     #   #   # #   #     # #       #   # #     #   #   #   #       #   #   #   # #       
# ##### ##### ######### # # # ############# ### ### # # ##### # # ##### ####### ##### ########### ####### ### # ### ### # ##### 
# #   # #     #       # # # #         #       #   # # # #   # # #     #       # #   #       #   #   #   #   # # #   #     #     
# # # # # ##### ##### # # # ######### ####### ### # # # ### # # ##### ####### # # # # # ##### # ### # ##### # # # ### ##########
#   #   # #     #   # # # #   #     # #   #               #   # #     #       # # #   # #     #     # #   # # # #   #         # 
# ####### # ##### # # # # ### # ### # # # # ############# ##### # ##### ####### ####### # ########### # # # # # ### ######### # 
#       #   #     # #   # #   #   # #   # #   #       # # # #   #     #     # #   #     # #       #     #   # #                 
### ### ##### ########### # ##### # ##### ### # ##### # # # # # ##### # ### # ### ####### # # ##### ######### ################# 
#   # #       #   #       #       #           #   #   #   #   #   #   #   #     # #       # #             #   #   #           # 
# ### ##### # # # # ########################### # # ####### ### # # ##### ####### # ####### ############# # ### # # ######### ##
# #         # # # #     #     #       #   #   # # # #       #   # #   #   #   #   # #   #     # #       # # #   #   #   #   #   
# ########### # # ##### # ### ### ### # ### # ### # ####### # ####### # ### # # ### # # # # # # # ##### # # # ####### # ### ### 
#         # #   #   #   # #   #   # # #   # # #   #     #   # #   #   #     # #   # # # # # #   #   #   # # #     #   #   #     
# ####### # ####### # ### # ### ### # # # # # # ####### ### # # # # ####### # ### # # # # # ####### # ### # ##### # ##### # ####
# #     # #         #   # #   #     #   # # #   #     #   # #   # # #     # # # #   # #   #     #   # #     #     # #     # #   
# # ### # ######### ### # ### ####### ##### ##### # ##### ######### # ### # # # ####### ####### # ### # # ### ##### ####### # ##
#   # # #         # #   #   # #       #     #     # #   # #     #   # #   # # # #     #   # #   # #   # #   #     #       # #   
# ### # ######### ### ##### # # ####### ##### ####### # # # ### # ### # ### # # # ### ### # # ##### ### # # ##### ####### # ### 
# #   #       # #     #     #       #   #   # #     # #   # #   #     # #   #   #   # #     #   #   #   # #     #   #     # # # 
# # ####### # # ############# ####### ### ### # ### # ##### # ### ##### # ########### # ### ### # ### ### ######### # ##### # # 
# #   #     #   #   #   #     #       # #   #   #   #       # # # #     #     #   #       # #   # #   #     #     #   #     #   
##### # ##### ### # # # # ##### ####### # # ##### ########### # # # ##### # # # # # ##### # # ### ########### ### ##### ##### ##
#   # # #   #     #   # # #   #   #   # # # #     #       # # #   #     # # # # # #   #   # #     #           #   #     #       
# # # # # # # ######### # # # ### # # # # ### ######### # # # ##### ### # # ### # # # ########### # ########### ### ##### ##### 
# #   # # #           #   # # # #   # #         #       #   #     #   # # #   # # # #           # #     #     #   # #   #   # # 
# ##### # ##### # ########### # ##### ######### # ####### ####### ### # # ### # # # ### ####### # ##### # ### ### # # # ### # # 
#       #     # #     #           #   #     #   # #   #   #     #   # # #   # # # #   # #     # #     # #   # # # # # # #     # 
######### ### # ##### # ########### ### ### # ### # # # ### ####### # # ### # ### # # # # ### # ####### ### # # # # ### # ##### 
#     #   #   #     # # #   #   #   #   # # # #   # # #   #     # # # #   # #     # # # #   # #     #   # # # # #   #   #   #   
# # # ##### ##### ### # # # # # # # # ### # # # ### # ### ##### # # ### # # ####### # # ##### # ### # ### # # # ##### ##### # ##
# # #     # #     #   # # # # #   # #     # # #   # #   #   #   # #   # # # #       # # # #   # # #   #   # # #   #   #     #   
### ##### # ##### # ### # # # ##### ####### # ### # ### ### # ### ### ### # # ####### # # # ### # ##### ### # ### # ### ####### 
#   #   # #     # #   #   # # #         #   #     # # #   # # #     #     # #   #   # #   # #   #   #       #     #   #   #   # 
# ### # # ##### # ### ##### # ########### ######### # ### # # ##### ####### ### # # # ##### # ##### # ############### ### # # # 
#     # #       #   #       #             #           #                           # #       #                             # #   
