################################################################################################################################
   #   #   #   #               #   #   #         #       #   #           #         #     #           #       #       # #       #
 # ### ### # # ############### ### # ### ####### # ##### # # # # # ##### # ### # # # ##### ### ####### ##### # ##### # # ### ###
 #     #   # # #       #     #     #   #   #     # #   #   #   # #     #   #   # #       #   #   #     #     # #     # # # #   #
 ####### ### ### ##### # ### ##### ### ### # ##### # # ####### ####### ##### ### # ##### ### ### # ##### ##### # ##### # # ### #
   #           #     #   # #     #       # #   #   # #         #     #   #   # # # #   #   #   # # #   # #     #   #     #     #
## ########### ##### ##### ##### ####### # ### ### # # # ##### # ### ### # ### # ### # # ##### # ### # # # ####### ##### #######
   #         #     #     # #   # #   #   #   # #   # # # #   # # #   #   #     # #   # #       #     # # #     # # #   # #     #
 ### ####### ##### ##### # # # # # # # # ### ### ##### # # # ### # ### ### ##### # ### ####### ####### # ##### # # # # # # ### #
 # #   #   #     # #   # #   # #   #   #   #     #     # # #     # #   # #   #   #   # #     #       #   #     #   # #     # # #
 # ### # ####### # # # # ##### ####### ### ####### ##### # ####### ##### # ### ##### # # ### ####### ##### ########### ### # # #
 #     # #     # #   #   #   #       # #   #           # # #   # #     #   #   #     #   #         # #   #   #   #   #   #   # #
 ####### # ### # ##### ##### ####### # # # # # ### ### ### # # # ##### ### # ### ################# # # ##### # # # # # # ##### #
 #   # #   #         # #   #       #   # #   #   #   #   #   # # #   #   # #   #               #   #       # # #   # # # #   # #
 # # # # ########### ### # ####### ### # ### ### # # ### ##### # # # ### ##################### # ##### ##### # ##### # # # # ###
 # # #   #     #         #       #     # #     # # # # # #   #   # #   # #   #         #   #   #       #   # # #   # # # # #   #
 # # ##### ### ################# # ### # ##### # ### # # # ########### # # # # ####### # # # ##### ### # # # ### # # # ### ### #
   #       #   #   #     #     # # #   # #   # #   #   # #             #   # #       #   # #   #   #   # # #     # # #   # #   #
############ ### # # ### # ### # ### ### # # ##### ##### # ####### ######### ####### ##### ### # ### # # ######### # ### # # ###
           #   # #   # # # #   #   # #   # #       #     # #     #         #   #     #   #     # #   # # #         #   # # #   #
 ######### ### # ##### # ### ##### ### ### ######### ##### # ### ##### # ##### # ##### ########### ### # # ########### # # ### #
     #   #   # # #     # #   #   #     #   #   #   # # #   #   #   #   # #   # # #     #           #       #             #   # #
#### # ##### # # # ##### # ### # ##### # ### # # # # # # ####### # # ### # # # # # ### # ####### ####### ### ############### # #
   # #     # #   # #     #   # #     # # #   # # #   # # #       # #   # # # #   # #   #       # #       #   #       #       # #
 # # # ##### ##### # ####### # ##### # # # ### # ##### # # ####### ### # # # ##### ########### # # # ##### ### ##### # ####### #
 #   #     #       # #     # #   #   # # #   #   #     # # # #   # #   # # # #   # #       #   # # # #   #   # #   #   #   #   #
 ######### ####### # ### # # ### ##### # ### ##### ##### # # # # # ####### # # # # # ### ### ##### # # # ### # # # ##### # # ###
 #       #   # #   #   # # #   #     # #   # #         # # #   # #   #     #   # #   #   #   #     # # # #   #   #       # # # #
 ### # # # # # # ##### # # ### ##### # # # # ### ##### # # # ####### # ######### ##### # # ### ####### # ### ######### ##### # #
   # # # # #   #       # #             # # # #   #   #     #       # #   #     #   #   # #   #         #   #   #     # #     # #
## # # # ##### ######### ######### ##### # # # ### # # ##### ##### # ### ##### ### # ### ### ############# ### # ##### # ##### #
   # # #         #         #   #   #     # # #   # # # #   # #   #   # #     #   #   #     # # #   #     #   # # #   # #       #
 ##### ######### ####### # ### ##### ##### # ##### # ### # ### # # ### ##### ### ##### ##### # # # # ####### # # # # # #########
       #       #     #   #     #   #   #   #       #     #   # # # #   #   # #   #   # #   # #   # #   #   # #   # # #   #   # #
########## ### ##### ### ####### # ### ##################### ### # ### # ### # ### ### # # # ##### # ### ### # ### # ### # # # #
         #   #     #   #   #     #   #       #   #         #   # #     #     #       # # # #       # #   #   #     #       #   #
 ####### ####### ##### ##### ####### # ### # ### # ####### ### # ##### ######### ### # # ########### # ### ################### #
 #   #   #     #   #   #   # #       # #   #   #   #       # # # #     #   #   # #               # #   #   # #         #   #   #
 # ### ### ### # # # ### # # ### ####### ##### ##### ####### # # # ### # ### # ### # ########### # # ### ### # ####### # # # # #
 #   # #     # # # #     # #   #         #       #   #       #   # # # # #   # #   #   #       #       # # #   #     #   #   # #
 ### # ##### # # ######### ### ############# ##### ### ##### ##### # # # # ##### ##### # ##### ####### # # ##### ### ######### #
   # # #     # # #       #   # # #         #     #   # #           #     #       #     #     #     # # # #   # # #     #     # #
## # # # ##### # # ##### ### # # # # # ### ##### ### # # ############### ### ##### ######### ##### # # # ### # # ##### # ##### #
   #   # #       #   # #     # #   # #   # #   # #   # # #     #   #   #     #   # #   #   # #   # #   #   #   #     # #   #   #
 ### ##### ######### # ####### ##### ### # # # # # ### # # ### # # # # # ##### # ### # # # # # # # # ##### ### ####### # # # ###
 # # #     #       # #         #       # #   #   # # # # #   # # # # #   #     #   # # # #   # # # # #   #   #         # # #   #
 # # # ### # ##### # # ######### # # # # ### ##### # # # ##### # # ##### # ####### # # # ##### # # # # # ### # ######### ##### #
 # # #   #     #   #   #   #     # # # #   # #     #   #   #   # # #   # #       #   #   #     #   # # # # # #   #       #     #
 # # # ####### ######### # ### ### # # ### # # ######### # # ### # # # ### ##### ### ##### ##### ### # # # # ### # ####### #####
 #   # #     #           #   # #   # # # # # # #   #     # #     #   #   #     # #   #   #     #     # # # #   #   #   #   #   #
 # ##### ### ##### # ####### # # ### # # # ### # # ##### ############### ####### # ### # # ### # ### ### # ### # ### # # ### # #
 #       # # #     #     # #   # #   #   #   #   #     #       #         #       # #   # # #   #   #         # # #   # #     # #
 ######### # # ####### # # ##### # ######### ######### # ### # # ######### ######### ### # # ##### ####### # # # # ########### #
  S#       #   #     # # #       # #     # #           #   # # # #         #   #     #   # #     # #   #   # # # #   #   #     #
## # ######### # ### ### ##### # # ##### # ################# # # ####### ##### # ##### ### ##### ### # ##### # # ### # # # #####
   #         # #   #     #     # #     # #       # #         # #     #   #   # # #   # #   #   #     #     # # #   #   # #   # #
 ########### # ### ############# ##### # ####### # # # # ##### ##### # ##### # # # # # # ### # ########### ### # ####### ### # #
 #               #       #       #   # #       # # # # # #       # #   #       # # #   # #   #   # #       #   #     #   #   # #
 ####### ####### ####### # ######### # ####### # # # # # # ##### # ####### ##### ####### # ##### # # ####### ### ### # ### ### #
       #   #   #       # #     #     #   # #   # #   # # #     # #   #   #     #       #   #     # # #       #   #   #       # #
###### ##### # ####### # ##### # ##### # # # ### # ### # ##### # ### # # # ### ####### ##### ##### # # ########### # # ##### # #
   #   #   # #   #     #   #   #     # #   # # # # #   #   #   #   #   # # # #   #     #   # #     # #   #         #   #   #   #
 # # # # # # ### ####### # # ####### # ##### # # ### # ### ####### ##### # # ### # ##### # # # ##### ### # ############# # ### #
 #   # # # #   # #     # # # #       # #     #       # # #     #   #     # #     #     # #   #         # #         #     #   # #
 ####### # ##### # ### # # # # ####### # ####### ##### # ##### # ### ##### ########### # ############# # ######### # ####### # #
         #       # # # # # #   #     #   #   #   #   #     #   # #   #   #     #     # #         #   # #       #   #   #     # #
 ################# # # # # # ##### ####### # ##### # ####### ### # ##### # ### # ### # # ######### # ######### # ####### ##### #
 #   #   #       # #   # # # #   # #       #       #   #     #   #     #   #   #   # # #       #   #     #     # # #   # # #   #
 # # ### # ##### # # ##### # ### # # ################# # ##### ####### # ### ####### # # ##### # ######### ##### # # # # # # # #
   #     # # #   # #       #     # # #   #         #   # # #           #   #   #     # #   # # #           #   #   # #   # # # #
#### ##### # # ### ######### ##### # ### ##### ### # ### # # # ######### # ### # ##### ### # # ############# # ##### ##### # # #
   # #     # #     #   #           #   # #   #   # # #   #   #           # #   #   # # #   #   #   #         # #     #     # # #
 # ### ##### ####### # # ##### # ##### # # # # # ### # ##### # ### ####### ####### # # # ######### # ######### # ##### ### # ###
 #     # #       #   #   #   # #       #   # # # #   #     # #   #       # #   #   # # # #       # # #   #   #   #     #   #   #
 ####### # ####### # ##### # # # ########### # ### ####### ##### # ####### # # # ### # # # ##### # # # # ### ####### ### # ### #
 #   #             # #     #   # #     #     #   #       #   # # # #     #   # #   # # #   #   #   #   #       #   # #   # #   #
 # ### ### ######### ########### # ### # ####### ####### ### # # # # ### ##### ### # # ####### # ############# # # ### ### # ###
 #   # #   #   #   # #     #     #   #   #     #   #   # #   #   # # #   #     #   # # #         #     #   #   # # #   #   # # #
 ### # # ### # # # # # ### # # # ### ######### ### # ### # ######### # ######### ### # ### ##### # # # # ### ### # # ### ### # #
   #   #   # # # # #   # # # # #   # #   #     # #   #   #           # #     #   #   #   # #   # # # # #   # #   # # #   # # # #
## # ####### # # # ##### # # # ### # # ### ##### ### # ######### ##### ##### # ### ##### ### # # # # # ### # # ### # # ### # # #
 # # #   #   #   # #     # # # # # # #     # #   #   #         #     #       # # # #   #   # #   # # #     #   #   # #         #
 # ### # # ####### # ##### # # # # # # ##### # # # ########### ####### ####### # # # ##### ### ### # ########### ############# #
 #     # # #       #       # #   #   # #   # # #   #     # #   #     #     #   # #   #         #   #     #   #   # #         # #
 ####### ### ############### ######### # # # # ######### # # ### ### ### # # ### # ### ######### ####### # # # ### # ####### # #
   #   #     #           #             # # # # #   #   #   #     #   #   # #   #   #       #     #     # # # # # #   #     #   #
 # # # ####### ### ### # # ### ### ####### # # # # # # # ######### ### ### ### # ### ####### ##### ##### # # # # ##### ####### #
 # # # #     # #   #   # #   #   #         #   # #   #   #     #   #     #   # # #   #     #     # #     # # # #       #       #
## ### ##### # # ####### ### ### ### ### ### ### ######### # # # ### ### ### # # # ### ### ##### # # ##### # # ####### # ##### #
       #     # #     #   #   # #   #   #     #   #         # # # #   #   #   # #   # #   #       # # #     # #       #   #     #
 ### ### ##### ##### ##### ### ### ### # # ### # # ######### ### # ### ### # # # ### # ##### ##### # # ##### ####### ### # ### #
   #       #   #   # #   # #       #   # #     # #     #   # #   # #   #   # # # #   # #   #       #   #     # #     #   #   # #
 # ##### # # ### # ### # # ######### ### ### # # ##### # # # # ### # ######### # # # # # # # ##### ##### ##### # ####### ##### #
 # #   # #   #   # #   # #     # #     # #   # #     # # # # # #   # #     #   #   # # # # #     # #   # # #   #   #     #     #
 # # # ### ### ### # ### ##### # # # # # ########### # # # # # # ### # ### # ### ##### # # ### # ### ### # # ##### # # ### ### #
 #   #   # #   # # #   #       #   # # #           #   # #   # #   #     # #   # #     # #   # #   #     #     #   # #   #   # #
 ####### # # ### # # # ########### ### # ######### ########### # # ####### ### # # ##### ### ##### ####### ##### ########### # #
 #   #   # #   # # # # #   #   #   #   #       #   #     #   # # #   #       # # # #   #   #     #         #   # #   #     # # #
 # # # ####### # # # # # ### # # ### ### # ##### ### ### # # # # ##### ####### # # # ##### ##### ########### # # # # # ##### # #
 # # #     # #   # # # #   # #   #   #   # #   #   #   #   #   #   #   #       #   # #   # #   #     #     # # #   # # #     # #
 # # ##### # ##### ### ### # ##### ### ### # # ### ### ######### ### ### ####### ### # # # # # ##### # ### # # ##### # # ##### #
   #     # # # #   #   # #   #     # # #     #   #   # #   #     #   # # #   #   #     # # # #     #   # #   #       # # #   # #
######## # # # # ### ### ### # ##### # ##### ##### # # ### ### # # ### # ### # ##### ### # # ### ####### ############# # ### # #
 #     # #   # # #   # #     # #     # #   # #     # #   #     # #     #   # #     # #   # #   # #           #       #   #   # #
 # ### # ##### # # ### ##### # # ##### # # ### ##### ### ####### ######### # ##### # # ### ##### # ######### # ##### ##### ### #
 # # # # #     #   #   #     # # #     # #   # #   #   # #     # #   #     #     #   #   #   #   #     #     # #   # #     #   #
 # # # # # ### ####### # ### # # # ##### ### # # # ### # # ### ### # # ##### # ### ######### # ######### ##### # # ### # ### ###
   #   #   #         #   #   # #   #     # # # # #     # #   #     # #   #   #     #         #           #       # #   # #   # #
 ########### ### ### ##### # # ##### ##### # # # ####### ### ####### ### # # ####### ######### ############# ####### ##### ### #
 #   #         #   #   #   # #     # #         #   #   #     #     # #   # # #     #   #       #       #             #     # # #
 # # # # ##### ### ### # ### ##### # ############### # ####### ##### # ##### # ### ### ### ########### ##### ######### ##### # #
 # #   # #   #   #   #   # #     # #   #             #         #   #   #   # # #     #   #           #     #     #   # #   # # #
 # ##### # # ### ### ##### ### # # ### # ######### ########### # # ##### # # # # ### ### # ######### ##### ##### # # # # # # # #
 #   #   # #       #     # #   # #   #   #   #   #           #   #       #   # #   #   # # #       # #           # #   # #     #
 ### # ### ############# # # ### ### ##### # # # # # ############### # # ### # ### ##### # # ##### # ### ### ##### ########### #
 #   #   #       #   #   #   #   # #       # # # # #         #   # # # #   # #   #   #   # #   #   #   #   #     #     #       #
 # ##### ######### # # ####### # # ######### # # # ######### # # # # # ### ##### ### # ####### # ##### # # ##### ##### # ##### #
   #     #   #   # # # #       #   #       #   # # #   #     # # #   #   #         #   #     # # # #   # # #   #     #   #   # #
 ### ### ### # # # ### # ##### ##### ### # ##### ### # ####### # ####### ####### # ######### # # # # ### # # # ##### ##### # # #
 #   # # #   # # # #   # #         #   # # # #   #   #         #     # #       # #   #     # # # #     # # # #   # #     # # # #
 # ### # # ### # # # ### # ### ### # # ### # # # # ##### ########### # ####### ### # # ### # ### ##### # ### ### # ### # # # # #
 # # #   # #   # # # #   # #     #   #   #   # # # #   # #       #   # #     #   # #   # # #   #  G# # # #   #   #     # # # # #
## # ### # # ### # # # ### ############# ### # # # ### ### ##### # ### # ####### # ##### # ### ### # # # # ### ####### ### # # #
   #     # #   #   # # # #   #         #   # # # #   # #   #     #   # #         # #   # #   #   # #   #     #     #   #   # # #
 ### ##### ### ##### # # ### # ####### ### ### # ### # # ### ####### # ########### # # # ### ### # ### ##### ##### ##### ### # #
   # #   #   # #   # # # # # # #     # # # #   #   # # #   #         #             # # #     #   #   #   # #   # # #   # # #   #
 # ### # ### # # # # # # # # # # ##### # # # ####### # ### ############### # ######### ####### ##### ### # ### # # # # # # #####
 #     #     #   #   #     #   #       #   #         #     #               #                                     #   #         #
