################################################################################################################################
################################################################################################################################
           #     #           # #     #     #                     # #         # #         #                   #     #     #     #
 ######### # ### ########### # # ### ##### # # ################# # # ####### # # # ##### # # ############# # # ### # # # # ### #
 #         # #   #       #   #   # #     # # #           #     #   #   #   # #   # #   #   #S#             # #   # # # # # # # #
 ########### ### # ### ### ### ### ##### # # ########### # ### # ##### # # # ##### # # ##### # ##### ####### # # ### # # # # # #
   # #     #   # # # #     #   #   #   #   # #         #   #   #   #   # # # #     # #   #   # #   # #     # # # #   # # #   # #
## # # # ##### # # # ####### ##### # # ##### # ####### ########### # ### # # # ### # ### # # # # # ### ### # # ### ### # ### # #
       #   #   # # # #     #     # # #     # #   #           #   # #   # # #   #   #   # # # # # #   # # #         #   #   # # #
 ####### # ##### # # # ### ##### # # ##### # ### ########### # ### ### ### ##### ##### # # # # # ### # # ### ########### ### # #
 #     # #       # #   #   #     # #   # # # # #     #     # #       # #   #   #     # #   # # #   #   #     #   #     # #   # #
 # ### # ######### ##### ### ##### # # # # # # ##### ##### # ##### ### # ### ### # # # ##### # ### ##### ##### # # ### ### ### #
 # #   #     #   # #                 # #   # #     #       #     # #   #   #   # # # # #   # #   # #   #       # # # #   #   # #
 # ####### # # # # # ####### ##### ### ##### ### ############### # # ##### ### # # # # # # ####### # ######### ### # ### ### ###
 # #     # # # # # # #     # #   # #   #   # #   #         #   # # # #           # # #   #     #   # #       # #   #   #   #   #
 # # ### ### # # # # # ### ### # ### ### # # # ### ### # # # # # # # ### ######### # ######### # ### # ##### # # ##### ### ### #
   #   # #   # # # # # # #     #   #     # # #     #   # #   # # # #   #     #     #       #   # #   # # #   #   #     # #     #
 ####### # ##### # # # # ######### ##### # # # ##### ### ####### ##### ####### ##### ### ### # # # ### # # ### ####### # #######
     #   #                   #     #   # # # # #     #   #     #   # # #   #   #     #   #   # # # #   #   # #           #     #
#### # ##### ######### ####### ##### # # # # # ######### # ### ### # # # # # ##### # ##### ### # # # ####### ### ######### ### #
   # #     # # #     # #     # #     # # #   #     #     # #   # #   #   # # #     # #     #   #   #   #                 # # # #
 ### ##### # # # ### # # ### # # ##### ### ### ### ####### ##### ### ##### # # ##### # ####### ####### ######### ####### # # # #
 #   #   # #   #   # # # #   # # #   #   #   #   #       #   #     # #   # # # #     #   #       #   #   #     #     #   #   # #
 # ### # # ####### # ### ##### # # ##### # ### # # ##### ### # ##### # # # # ### ####### # ##### # # ### # ### ##### # ##### # #
   #   # #   #     #   #       # # #   # # #   # # #     #   # #     # # # # #   #   #   # #   # # # #   # #         #     # # #
## # ### ### # ####### # ####### # # ### # # ### # # ##### ### # ##### ### # # ### # ####### # ### # # ##### ### ####### ### # #
   #   #     #   #   # # #   #   # #   # # #   # # #           # #   # #   # # #   #         #     #   #   #   #     #   #   # #
 # ### ######### # ### ### # # ### ### # # ### # # ########### # # # # # ### # # ######################### # # ##### # ### ### #
 #   #         # #     #   #   # #   #   #   # # #   #       # #   # #   #   # #             #           #   #     # # #   #   #
 ### ####### ### # ##### ####### ### ##### # # # ##### ##### ####### ##### ### ############# ### ####### ### ### # ### # #######
 # #         #   #   # # #   #           # #   #     # #   #     #   #     #     #         #     #     #   #   # # #   #       #
 # # ####### # ##### # # # # ######### # # ######### # # # ### # # ### ##### ##### ####### ########### ### # # ### # ######### #
   # #       #     # # #   # #     #   #   #       #   # #   # # #   # #           #   #       #       #   # # #   #       #   #
#### # ##### ##### # # ##### # ### # ####### ##### ##### ##### ##### # # ####### ### # # ####### ####### ##### # ######### # ###
     #   #     #   #   #     #   # # #     # #   #       #     #     # # #     # #   # #   #   # #     # #     # #       #   # #
## # ##### ### # ##### # ######### # # ### # # # ######### ##### ##### # # ### ### ### # # # # # # ### # ### ### ##### # ##### #
   #   #   # # #   #   #   # #     #   #   #   # #         #   #     # # # # #   # #   # #   # #   #   #     #   #     #       #
 # # ### ### # ##### ##### # # ######### ####### ##### ##### ####### # ### # ### # # ##### ### ##### ########### # ########### #
 # #   #     #       #     # #         # #     #       #           # #     #   #   # #   #   #       #       #   #           # #
 ##### ########### ### ##### ######### # # ### ######### ######### # ####### ####### # # ##### ############# # ### ########### #
 #   # #   #   #   #   #   #         # #   #     #     #       #   #   #     #     # # #     #       #     # #   # #     #     #
 # ### # # # # # # # ### ### ####### # # ### ### # ### ##### ### ##### # ##### ##### ####### # ### # # ### # ### # # ### # ### #
 #     # # # #   # #   # #   #     # # #   #   #   # # # #   #   #     #           #         #   # #   # #   #   # #   #   # # #
 ####### # # ##### ### # # ### ##### # # ##### # ### # # # ### ### ############### ############# # ##### ##### ##### # ##### # #
       # #   #       # #   # #   #   # # #     #   # # #   #   #   #         #       #         # #           # #   # # #   #   #
######## ##### ####### ##### ### # ### # # ####### # # # ####### ### ####### # ##### ####### # # ####### ##### # # # # # # # ###
       #   #       #   #   #         # # # #       #   # # #     #   #     # # #   #         #   #     # #     # # # #   # #   #
 ##### ##### ####### ### # ####### ### ### # # ######### # # ##### ### ##### # # # ########### ### ### ### ##### # ######### # #
 #         # #       #   #         #   #   # #       # # # #     # # # #     # # # #       #   #   # # #   #   # #         # # #
 ######### # # ######### ######### # ### ### ##### # # # # ##### # # # # ##### # # ##### # # # # ### # # ##### # ######### # ###
 #     #   # #   #       #   #     #     #   #   # #   #     # #   #   #       # #       #   # #     # # #     #       #   #   #
 # ### ### # ### # ####### ### ########### # ### # ######### # ##### ########### ############# ##### # # # ############# ##### #
 # # #   #   #   # #   #         #     #   #     # #     #   #     #           #     #           #   # # #   #     #   #   #   #
 # # ### # ### ##### # ######### # # # # ### ##### # ### # ### ##### ######### ##### ##### # ### # ### # ### # ### # # ### ### #
 # #     # #     #   #       #     # #   #       # #   # # #         #         #     #     #   # # #   # #   #   #   # # #     #
 # ####### # ##### ######### ####### ##### # # ### ### # # ### ####### ####### # ##### ### ### # # ##### # ########### # ##### #
 # #       #   #   #   #   # #   #   #     # #   #     # #   # #   #   #       #   # #   #   # # #       # #           #     # #
 # # ######### # ### # # # # # # # ### ######### ####### ### # # # # ####### ##### # ### # # # # ######### # ########### ##### #
   #   #   #   # #   # # # #   # #   #     #   #       #   # #   # # #     # #   # #     # # # #     #     # #   #   #   #   # #
#### ### # # ### ##### # # ##### ### # ### # # ### # # ### # ##### ### ### ### # # ####### # # ##### # ##### # # # # # ### # # #
     #   #   #   #   #   # #     #   #   # # #     # #   #   #   # #   # # #   # #       # # #     #   #   # # # # # # #   #   #
 ### # ####### ### # ##### # ########### # ######### ### ##### # # # ### # # ### ### ### # # ### ####### # # # # # # # # #######
 # # #       # #   #   #   #       # #   #   #         #   #   #   #   # #   # #   # #   # #   #       # #   # # # #     #     #
 # # ####### # ####### # # ####### # # ##### ##### # # ### # ######### # ##### ### ### ### # ####### # # ##### # ####### # ### #
   # #   #   #         # # #     # #   #   # #     # #   #   #       #   #   # # #     #   # #   # # # #   # # #   #   #   #   #
#### # ### ############# # ### # # ##### # # # ##### ### ### ####### ####### # # ####### # ### # # # ##### # # ### # # ### #####
                         #     # #   #   # # # #       #   #       # # #     #           #   # # # #       # #   #   # #   #   #
 ####################### ####### ### # ##### # # ######### # ##### # # # ### ####### # # ### ### # ######### ### ##### # # # # #
 #     #           #   # #       #   #   #   # #   #       # #   # #   #   #         # #   #     # #       #   # #     # # # # #
## ### # ######### # # ### ##### # ##### # ####### # ####### # # # ### ### ####### # # ### ####### # ####### ### # ##### # # # #
   #     #       #   #     #     # #   #   #       #     # #   # # #   #   # #     # #   #   #   #     #   # #   #     # # # # #
 ######### ##### ########### ##### # # ########### ##### # ##### # # ### ### # ### # ##### # ### # ### # # # # ####### # # # # #
           #   # # #   #         #   #         #   #   # #       #   # # #     #   #   #   #         # # # # # #     # # # # # #
 ########### # # # # # ######### ############# # ##### # ####### ##### # ######### ##### ####### ### # # # # # # ##### # # # # #
 #   #       # #   # #       #   # #       #   #       # #             #     # #     #   #     # #   # # #   #   #     # #   # #
## # # ####### ##### ####### # # # # ####### ########### ####### ########### # # # # # ### ### # # ##### ######### ######### # #
   # # #     # #     #     # # # # #   #     #         # #     # #         # #   # # #       # # #     # #     # #         # # #
 ### # ### ### # ##### ##### # # # ### # ##### ####### # # ### # # ######### ##### # ######### # ##### # # ### # ######### # ###
 # # #   #     # #   #   #   # #     # #   #   #   #   # # #   #       #     #     #       #   # #   # #   # #       #   # #   #
 # # ### # ##### # # ### # ######### # ### # ### # # ##### ############# ##### ### ##### ### ### ### # ##### # ####### # # # # #
 # #   # # #   # # #   # # # #       #   #   #   #   #   #   #           #   #   #   #   #   #   #   #       # #       #   # # #
 # ##### # # # # # ### # # # # ### ##### ##### ####### # ### # ########### # ####### ##### ### # # ##### ##### # ########### # #
         #   #   #   # # # #   #   #   # #   # #       #   # # #           #       # #     #   # #     # #     # #     #     # #
#################### # # # ##### # # ### # ### # ######### # # # ######### ####### # # ##### # # ##### # # ##### # ### # ##### #
   #               # #   #   #   #             #       # # #   #     #   #     # #   # #     # #     # #   #   #   #   #     # #
 ### ##### ##### # ##### ### # ### ########### ####### # # ##### ##### # ##### # ### # # ##### ##### # ##### # ##### ####### # #
   # #   # #     # #       #   #   #         # #     #   #       #     #     # #     # #     #   # #   #   # #     # #       # #
## # # # # # ##### # ##### ##### ### ####### # # ### ##### # # # # ######### # # ##### # ### ### # ##### # # ####### # ####### #
 #   # #   # #     #   #         #   #   #   #   #         # # # #   #     #   #   #   # #   #   #     # #   #   #   # #     # #
 ##### ##### # ######### # ### # # ### # # ##### # ######### # # ### # ### ####### # ##### # # ####### ##### ### # ### # ##### #
   #   #     #           # #   # # #   # #   #   # #       # # #   # # #   #   #   # #   # # #       # #   # #   # # # #   #   #
## # # # ############### # # ### # # ### ### ##### # ##### # ### # # ### # # # # ### # # # ######### # # # # # ### # # # # # ###
 # # # #     #           # # #   #   #   # #   #   #     # #   # # #   # #   #   #   # # #   #       #   #       # # # # # # # #
 # # # ##### ######### ### # ### ##### ### ### # ####### # ### # ##### ########### ### # ### # ########### ####### # # # # # # #
 # # #     #         # #   #   #   # # #   #   #         # #   #     #       #   #   # #   # #           # #       #     # # # #
 # # # # ########### ### ##### # # # # # # ############### # ####### ####### # # ### # ### # ########### # # ####### ##### # # #
     # #           #   #     # # #   #   #       #         #     #         # # # # # # # # # #   #     #   # #   #       # # # #
###### # ####### ##### ### # # ### ############# # ############# # ### # # # # # # # # # # # ### # ######### # ### ##### # # # #
       #     #   #   #   # # #   #         #   # #   #   #     # #   # # # #   #   #   # # #     #   #       #     #   # # #   #
 ######### # # ### # ### # # ### ### ##### ### # ### ### # ### # ### ### ############### # ### ### ### ####### ##### # # # #####
 #     # # # #     #   # # # #   # #     #     #     #   #   # #   #   #     #           #   #     #   #         #   # # #     #
 # ### # # # ########### # # # ### ##### # ########### # ### ##### ### ##### # ### ######### # ##### ### ####### # ### # # # # #
   #   #   #   #   #     # # # # #       #       #     #   # #     # # #   #     #   #   #   #     # # #   #   # #   # # # # # #
#### ########### # # ##### # # # ######### # ### ######### # # ##### # # # ######### # # # ### # ### # ### # # # ### # # # # ###
     #   #       # # #     # # #           #   #   #       #   #     # # # #       # # #   #   # #   #   # # # #     # # # #   #
 ##### # # ####### ### ####### # ##### # ##### # # # ########### ##### # # # ##### # # ##### ### # ### ### # # ####### # ##### #
       # # #     # #   #       #     # #   #   # #   #   #     # #   # # # #     # # #   # #   # #   #     # #     #   #     # #
########## # ### # # # # ####### ### ##### # ##### ### # # ### # ### # # # ##### # # ### # ### # ### # ##### ##### ######### ###
       #   #   # #   # #     #     # #   # #     #   # #   # # #     #   #   #   # # #   #     #   # # #   # #             #   #
 ##### # ##### # ##### ##### ##### # # ### ##### ##### ##### # ##### ####### # ### # # ####### ##### # # # # ##### ####### ### #
 #     # #     #   #   # #   #   # # # #   #   #   #   #   # #     # #     # #   # # #     #   #     # # # #     # #     # #   #
 ####### # ####### # # # # ### # # # # # ### # ### # ##### # ##### # ### ### ### # # ##### ##### ##### # ####### # # ### # # # #
   #   # # # #       #   #     # # # # # #   # # # # #   # #   #   # #   #   # # # # #   #   #   #   # #     # # # # #   #   # #
## # # # # # # # ############### # # # # ##### # # # # # # ### # ### # # # ### # ### # # ### # ### ### ##### # # ### # #########
 #   #   # #   # #               # #   #       # #   # #       #     # # #   # #  G  # #   #   #       #     # #     #     #   #
 ######### ##### # ############### ############# ####### ############### ### # ##### # ### ##### ####### ##### ########### # # #
 #   #   # #   # #   #                     #   # #       #       #       #   #       # # # #   # #         #     #       #   # #
 # ### ### # # ##### # ### ##### # # ##### ### # ####### # ##### # ####### ####### ### # # # # # ######### # ### # ########### #
 #   # #   # # #   # # #   #     # #     #     #       # # #     #       # #   # # #   # # # # #         # # #   # #           #
 ### # # # # ### # # # ##### ##### # ### ############# # # ############# # # # # # # ### # # # ######### # ### ### # ######### #
   # #   # #   # #   #   #   #   # #   #               # #   #         # # # # #   #   #   # # #               #   # #   #     #
## # ##### ### # ####### # ### # # ### ### ### ####### # ### ##### ### # # # # ### ### ####### ### ######### # ### # # ### # ###
             # # # #     #   # #   # #   #   # #     #     #     # #   # #   # # # #   #     #   # #     #   #     # # #   # # #
###### ##### # # # # ######### ##### ### ### ### ### ##### ##### ### ### ##### # # # ##### # ### # # ### ########### # # ### # #
     # #   # # # #   #         #   #   #   # #   #   #   # #   #   #   #   #   #   # #     #   # # # #   #   #   #   # #   # # #
 ### ### # # # # ### # ########### ### ### # # ### ### # ### # ### # # ### # ####### ######### # # # # ### # # # # ### ### # # #
   #     #   #   #   #             #       #     #     #     #       #     #                       # #     #   #   #       #   #
################################################################################################################################
