################################################################################################################################
# #       #       #   #   #     #     #   #     #   #   #               #             #       #   #           #       #     #   
# # ##### # ### # # # ### # ##### ### # # # # ### ### # ######### ####### ######### # # ##### ### # ######### # ##### ### # # # 
# #   # # #   # # # # #       #   # #   # # #   # #   #     #   # #       #   #   # #   #   #     #     #   # #     # #   #   # 
# ### # # ##### # # ### ##### # ### ##### # ### # # ####### # # # # ######### # ### # ### # ########### ### # ##### ### ####### 
#   # # #     # # #     #   # #     #   # # # #   # #     #   #             # # #   #     #     #     #   # #   #       #       
### # # ##### # # ##### # # # ####### # # # # ##### # ### ################# # # # ### # # ### # # ### ### # ### ######### ######
#   # #     # # #       # #     # #   #   #   #     #   # #     #       #     #   #   # # #   # #   #   # #   #         # #     
# ### # ##### # ######### ##### # # ######### # ####### # # ### # ##### # # ####### ##### ##### ### ##### # ########### # # ### 
#     #     # # #       #   #   # #             #     # #   #   #   # #   # #   #   #   # #   #   #       # #   #   #   # #   # 
# ######### # # # ########### ### ### ########### ### # ##### ##### # ##### # # ### # # ### # # # ######### # # # ### ### ### ##
# #       # # #   #       #   #       #       #   # # #     # #   # #       # #   # # # #   # # #       #   # #   #   #     #   
# # # ### # # ##### ##### # ### # ##### ##### # ### # ##### # # # # ####### # ### ### # # ### ### ### # # # ##### # ### ####### 
# # # #     # #   # #   # #     # #   #     # #     #   #   #   # # #     #     #     #     #   #   # #   #       # #   # #     
# ### ##### # # # # ### # ####### # # ##### # ######### # ####### # # ### ##### ############### # # # ############# # ### # ####
#   # #   # #   #       #     #   # #     # # #   #   # # #   # # #   #   #   # #         #   # # # # #             #     # #   
### # # # # ################# # ### ##### ### # # # # # # ### # # ##### ### # # # ##### # # ### ### # # ############# ##### # # 
# # # # #         #           # #   #   #     # #   # #   #   # #     # # # # # # #     # #   # #   #   #     #     #       # # 
# # ### ### # ### # ############# ### # ####### ##### ##### ### ##### # # # # # # ########### # # # ######### ##### # ####### # 
#   #   #   #   # # #   #   #   # #   # #   #     #       #     #   # #   # # # #           #   # #   #     #   # # # #       # 
# ### ########### # ### # # ### # # ### # # # ##### ##### ##### ### # ##### # # # ############### ### # ### ### # # # # ####### 
#   # # #       # #     # #     #   #   # #   #   # #   #     # #   # #     # # #   #     #     #   # # # #         # #   #   # 
### # # # ##### # ####### ########### ### ##### # ### # # ##### # # # # ##### # # ### ### # ### ### # # # ##### ##### ### # # # 
#   #   # #     #     #       #   #   #   #     #     # # #       # #   #   # #   #     #     #   # #     #   # #           # # 
# ####### ####### ### # ##### ### # ####### ########### # # ####### ####### # ### # ######### ### # ####### # # # # ########### 
# #     #   #     #   # #   #   # # #       #   #     # #   #     #         # # # # # #     # #   #   #     # #   #     #     # 
# # ### ### ### ##### # # # ### # # # ####### # # ### # ##### ### ### ####### # # # # # ### ### ##### # ##### ####### # # ### ##
# # #   #       #   #   # # # # # # #   #   # # #   #   #     # #   # #   #   # # # # # #       #   #   # #   #     # #   # #   
# # # ### ####### # ##### # # # # # ### # # # # ### ##### ##### ### # # # # ### # # # # ######### ####### # # # ### ### ### ### 
#   # #   #       #     # # #   #   #   # # # #     # #   #     #   # # #   #     #   #   #               # # #   #   #   #     
##### # ### ########### # # ### ### ##### ### ####### # ### ### # ### # ######### ### ### ### # ##### ### # ### ##### # ########
#   # # #   #         # # #   #   #     #   # #       #   #   # #   # #           #   #   #   #   #   #   # #   #     #   #     
### # ### ########### # ##### ### ##### ### # ### ####### ### # ### # ########### # ####### ####### ### ### # ### ####### # ### 
#   #     #   #       # #   #   #       #   #   # #   # # #   # #   #         #   #     # #     #   # #   # #   #   #   #   #   
# ####### # # # ####### # # ### # ### ### ##### # # # # # ### ### ##### # ##### ####### # # ##### ### ### # ### ### ### # ### # 
#         # # #           #   # #   #         # #   #   #   #   # #     #         #   # #     #   #       #   # #   #   # #   # 
### ####### # ##### ####### ### # # ### ##### # # ######### ### # ##### ####### # ### # ####### ####### ##### # # ### ##### ### 
#   #       # #   # #     #       #   #     # # #       #   #   #   #   #     # # #   # #       #     #     #   #   # #     #   
# # # ######### # # # ### ##### ##### ####### # # ####### ### ##### # ### ### # # # ### # ########### ##### ####### # # ##### # 
# # #     #     #     #   #   # #   #   #   # #         # #   #     # #     # # #   #   #           #   # # #     # #   #     # 
# # ##### # ##### ##### ### # ### # ### # # # ### ##### ### # # ##### # ##### ####### ### ######### ### # # # ##### ##### ##### 
# #     # # #     #   # #   # #   #   # # # #     #   #     #   #       #     #       #     #     #     # #   #     #     #     
# # ##### # ### ### # ### ##### ##### # # # ####### # ### ####### ##### # ##### ######### ### ### ####### ### # # ####### # ####
# # #     # #   #   #     #     #   # #   #   #     #   #     #       # #       #         #   #   # #       # # # #   #   # #   
# # # ##### # # # ######### ##### # # # ##### # ####### # # ### ##### ### ############### # ### ### # ####### # ### # ### # # # 
# # # #     # # #     #     #   # # # # #   #   #   # # # #     #   #   #     #       # # # #   #     #   #   #     # #   #   # 
# # # ### ### # ##### # ##### # # # # ### # # ##### # # # ####### # ### ### ### ##### # # # ####### ### # # ######### # ####### 
# # #     #   # #     #   #   #   # #   # # #       # # #   #     #   #   #   # #   # # # #       #     #       #     #     #   
# ######### ### # ####### ##### ##### # ### # ####### # # # ######### ### ### # # ### # # ####### # ############# ########### # 
#   #     #   # #       #   # # #   # #   # #         # # #         #   # #   # # #   #       #   # #   #     #   #         # # 
### # ### ### # ####### ### # # # # ##### # # ### ##### ##### # ####### # ### # # # ##### ### # ### # ### ### # # ######### # # 
# # #   #   # #       #   # #   # #     #   #   #     #     # #   #     #   # #   # #     #   # #         #   # # #   #   #   # 
# # ### ### # ####### ### # # ### ##### ##### # ##### ##### # ### # ####### # ##### # ##### ### ##### ######### # # # ### ##### 
# #   # #   # #         # #     #     #   #   #     # #     #   # #     #   #   # # # #   #   #     # #   #   # # # #   # #     
# ### # # ##### ### # # # ### ####### ### ######### ### ##### ### ##### # ##### # # ### # ######### # # ### # # ### ### # ##### 
#     # # #     #   # # #   # #     #   #   #     # #   #   #   #     # #     #   # #   #     # #   #       # #     #   #       
### ### # ### ### # # # ### # # ### ### ### # ##### # ### ##### ##### # ##### ### # # ####### # # ##### ##### ####### ######### 
#   #   #   #   # # # #       #   #   # #   #       #   #       #   #   #   #   # #   # #     # #     #     #       #   #       
# ### ##### ### # # # ####### ### # # # # ##### ####### ####### # # ##### # ### ####### # ##### ##### # ########### ### ##### ##
# #   #   # #   # # # #         # # # # #   #   #     #   #     # # #     # # #       #   #         # # #     #   #   #     # # 
# # ##### # # ##### # # ####### # # ### ### ##### ### # # # # # # # # ### # # ##### ### ##### ####### # # ### ### # ####### # # 
# #       # # #     # #     #   # # #   # # #  S# # # # # # # #   # #   # #       #   #     #     #   # # # #   #   #       #   
# ####### ### ####### ##### # ### ### ### # # # # # # ### # ####### ### # ### ####### ##### # ### # ### # # ### ##### ####### ##
# #     #     #     #     # #     #   # # #   # # # #     #       #     #   #   #   #       #   #       # #      G#   #     #   
# # ### ####### ### # ##### ##### # ### # ##### # # ####### # ### ######### ##### # ########### ####### # ####### # ####### # # 
# #   #   #     #   # #   # #     #   #   #   # # #   #     #   #     #   # #     # #         # #   #   #     #   #       # # # 
# ####### # ##### ### # # # # ### ### # ### ### # ### ##### ### # ##### ### # ##### ####### # # # # ######### # ######### # # # 
# #     #   # #   #   # # # # #   #   # #   #   #   #     #   # # #   #     # #   #       # #   # # #       # #           #   # 
# # ### ##### # ####### # ### # ### ### # ### ### # ##### ##### # # # ####### # ######### ##### # # # # ### # ################# 
# #   #         #       #     # # # #     #   # # # #           #   #       # #   #   #   #   # # # # # #   # #                 
# ### ########### ############# # # ##### # ### # # ############### ### ##### ### # ### ### # # # # # # ##### # ### ####### ### 
#   #   #         #           #   # #     #   # # #     #         #   # #   #   # # #   #   # #   #   # #   # #   # #     #   # 
# ##### # ############### # # ### # # ### ### # # ##### # ####### ##### # # ### # # # ### ### ### ####### # # ##### # ### ### ##
#     #   #         #   # # #     #   # #   # #       # # #   # # #     # #     #   #   #   #   #       # # #     #   #     #   
##### ############# # # ### ##### ##### ### # ####### # # ### # # # ### # ####### ##### ####### ####### # ####### # ### ####### 
#     #   #     #     #     #   #   # #   # # #     # # #     #     #   # #   #     #     #     #     # #     # # # #   #   #   
# ##### # # ### # ######### # # # # # # # # # # ### ### ####### ##### ### # # # ### # # ### ##### ### # ##### # # # # # # # # ##
#   #   # #   # # #   #   # # # # # #   # # # #   #     #   #   #   # #   # # # #   # # #   # #   # #   #   #   # # # # # # #   
# # # ### ##### ### # # # ### ### # ##### # # # ########### ### # # ### ### ### # ### ### ### # ### ##### # # ### ### ### # ### 
# #   #   #     #   # # #   #     #   # # # # # #         #     # # #   # #     #   #     #   #   # #     # # #   #   #   #     
####### ### ##### ### # ### ######### # # # # ### ####### ####### # # ### # ############### ##### # # ####### # ### # # ########
#     # #   #   # # # # #   #   #   # #   # # #   #     #   #     # # # # # #   #     #                 #     # #   # #   #   # 
# ##### # ### # # # # # # ### # # # # # ### # # ### ### ### # ##### # # # # # # # ### # ############### # ##### # ####### ### # 
#       # #   #   # # # #     # # # # #   # #   # # #   #   # #   #   #       #   #   #       #     #   #   # # #       #     # 
####### # # ####### # # ####### ### # # # # ##### # # # # ### # # ##### ##### ########### ##### ### ####### # # ### # # ####### 
#   #   # #         # # #     #   #     # #     # # # # #     # # #   # #   # #     #     #   #   #         # #   # # #         
# # ### # ########### # # ### ### # ########### # # # # ####### ### # # # # # ### # ##### # # ### ########### ### # # # # ##### 
# #   # # #       #   # #   #     # #   #       #   # #       #     # # # # #     #     #   # #   #             # # # # # #   # 
# ### ### ##### ### ##### ### ##### # # # ####### ### # ### ######### ### # ########### # ##### ### ######### # # # # # # # # # 
#   # #   #   # #   #       #         #   #   #   # # #   #       # #   # #           #       #   # #     # # # # # # # # # # # 
##### # ### # # # ####### # ##### ######### ### ### # ##### ##### # ### # ########### # ##### ### # # ### # # # # # # # ### # # 
#           #   # # #   # # #   #       #   #   # #   #   # #     # # #   #   #       # #   #   # # # #   #   # # # # #     # # 
# ####### # ##### # # # # # # # ####### ### # ### ##### # # # ##### # ##### ### ####### # # ##### # # # ####### # ### ####### ##
# #     # #       # # # # #   #     #   #   #         # # # #         #         #   #     #         # # #       #   #   #   #   
# # ### # ######### # # # ######### # ### ########### # # ############# ########### # ############### # ######### # ### # # ### 
# #   # #           # # # #     # # # # #   #     #   # #     #       #         #   #     #   #     # #         # #   #   #   # 
# ##### ### ### # # ### # # ### # # # # ### # ##### ### ##### # ##### ######### # # ##### # # # ### # ######### ##### # ##### ##
#   #   #   #   # #     #   # # #   # #     #   #   # #   # # #   # # #       # # #     # # # #   #   #       # #   # #     #   
# # # ####### ### ####### ### # ##### ### ##### # ### ### # # ### # # # ##### # ### ### # ### ### ##### ##### # # # # # # # ### 
# # #       # #               # #   #   # #   # #       # # #   # # #   #   # #   # #           # #   # #     # # #   # # #   # 
# # ####### # ############### # # # ### # # # # ####### # # ### # # ##### # # ### ### # ######### # ### # ### # # ##### ####### 
# #         # #   #       #   # # # #   #   #     #   # #   # # # # # #   #     #   # # #         #   # # #   #   #     #     # 
### ##### ##### # ####### ##### # # ##### ####### # ### ##### # # # # # ########### ### # ########### # # ############# # ### # 
#   #   # # #   #     # #       # #     # #   #               # # # # #   #       #   # # #         # # # #     #     # # #     
# ### # # # # ####### # ### ##### ##### # # # ######### ##### # # # # ### # ######### # # ######### # # # # ##### ### # # # ####
# #   # #     #   #   # #   #   #   # # # # #   #     #     # # # # #     #   #     #   #       #   # # # #       #   # # # #   
# # ### ##### # # ##### # ### # ### # # ### ### # ### # ##### # # # # ### ### # ### ### ####### # # # # ########### ### # ### # 
# #   # #     # # #   #   #   #   #   #     # # #   # # #     # #   # #         #       #   #   # # #         #   #     # #   # 
# ### # # ### # # # # ##### # ### ########### # ##### ### ### # ##### # ######### ##### # ### ##### ### # ### # ####### # # ### 
#   # #   #   # #   # #     #   #             #   #   #   #   #   #   # #   #     #   # #   #     #     #   # #         #   #   
##### ##### ### ####### ##### # ##### # ######### # ### ### # ### # ### # ### # ### # # ### ##### # ######### ### # # ####### ##
#   #     # # # # #     #   # #     # #       #   #     #   #   # # #   # #   # #   #     #     # # #             # #   #   # # 
# # ##### # # # # # ####### # # ### # ######### ####### # ##### # # # # # # ### # ####### ##### # # # ### ####### # ### # # # # 
# #     # #       # #     #   #   # #           #       # #   # # # # # # #   # # #     #     # # # #   # #     # #   #   # # # 
# ##### # ####### # ##### ##### ### ##################### ### # # # # ### ### ### # ####### ### # # ### ### ### # # ####### # # 
#   # # # #     # # #     # #   #   #   #       #       # #   # # # #     #   #   #       # #   # #   # #   #     #   #   # # # 
### # # ### ### # # # ##### # # # ##### # ##### # ##### # # ### # # ####### # # ### ### ### # ### ##### # ####### ### # ### # # 
# # #   #   # #   #   #   #   # # #   # #   #   # #   # #   #   # #   #   # # #   #   #     #   # #   # #     #     #   #   #   
# # ##### ### ### ##### ##### ### # # # # # ### # ### # ##### ### ### # # # # ### ### ######### # # # ####### ########### ######
# #     # #       #   # #   # #   # # # # #   # # #   #   #     #     # #   # #   # #     #   #   # #       #           #     # 
# ##### # # ####### ### # # # # ### # # # ### # # # ##### ##### ##### # ####### ### ##### # # ##### ####### # ######### ##### # 
#   # #   #       #   #   #   #     #   #   # #   # #   #   #         #       #   # #     # #       #   #   #   #           #   
# # # ########### ### ####### ########### ### ##### # ##### ### # ### ####### ### # # ##### # ##### # ### ####### ####### # ####
# # # #   #     #                   #   # #   #       #         #   #       #   # # # #     # #     #   # #       #       #     
# # # # # # ### ######### ######### # # ### ######### # ######### # ### ####### # # # # ##### # # ##### # # ######### ######### 
# #   # # #   #   #       #     #   # #     # #     #   #       # #   # #   #   # #     #     # # #   #     #   #   #         # 
# ##### # ##### # ####### # ### # ### ####### # ### ##### ##### ### # # # # # ### ####### ##### ### # ####### # ### ######### # 
#       #       #         #   #   #           #   #       #         # #   # #   #       #     #     #         #     #         # 
