################################################################################################################################
################################################################################################################################
         #     #     #   #     #         #       #     #   #       #     #       #     #           #         #       #     #   #
 ####### # # # ##### ### # ### # ######### # ### ### ### # # # ##### ### # # ### # ##### ### # # ### ##### # # ##### # ### ### #
     #     # # #   #   #   #   #     #     #   # #   #   # # #     #   # # # # # #     #   # # #   #   #   # #   # # # # # #   #
#### ####### # # # ### ##### # ##### # # ##### # # # # ##### ##### ### # ### # # # ### ### # ### # # ### ### ### # # # # # # ###
   #     #   # # #   #     # #     #   # #   # #   #     #   #   #   # # #   #   #   #     #   # #   #   #     # #   # # # #   #
 # ####### ### # # ####### # # ### ##### # # # ######### # ### ##### # ### ### ##### ######### ####### ######### ##### # # # # #
 # #     #   # # #         # # #         # # #   #     #   #       # #   # # # #   #   #     #     #   #     #   #     # # # # #
 # # ### ### # # ########### # # ######### # # ### ### ### ####### # ### # # # # # ### ##### ##### ##### ### # ### ##### # # ###
 #   #   #   # #             # #       #   # # #   # #   #       # # # #   #   # #       # # #     #   #   #   #   #   # # #   #
 ####### # ### ############### ####### # ### ### ### ### ####### # # # ##### ########### # # # ##### # ### ##### ##### # # ### #
 #     #   # #     #     #         #   # # #     # #     #         # # #   # #   #   #   #   #   #   #     #     #   # #   #   #
 ##### ##### ##### # ### ####### ### ### # ####### ####### ####### # # # ### # # # # # ##### ### # ######### ####### # ##### ###
       #   #     #   #   #     #   # #   #   #     #       #     # #   #   #   # # # #         #   #                           #
######## # # ### ##### ### ####### # # ### # ### ### ####### ### ######### ##### # # ######### ##### ########### # ####### #####
         #   # # #   #   #         # # #   #   #   # #     #   #         #   #   # #   #   # #     #     #     # # #   # # #   #
 # ##### ##### # ### ### ########### # ### ### ### # ### # ### ######### ### # ### ### # # # ##### ### ### ### # # # # # # # # #
 #   #   #     #   #   #     #     # # #   # # #   #   # #   #     #   #     # # # #   # # #     # #   #     # # # # # # #   # #
 ### # ### ####### # # ##### # ### # # # ### # ### ### # ### ##### ### ####### # # # ### # # # ### # ### ##### # # # # # ##### #
 #   # #   #     # # # #   # # # #   # #   # #   #     #   #     # #       #   #   #     #   #     #   #   #   # #   # #     # #
 # ### # ### ### # ### # # # # # ### # ### # ### ##### ### ##### # # ### ### ############# ######### ##### # ### ##### ##### # #
 #   # # #   #   #   #   # #   #     # #   #   # #   #     # #   # #   # #   #   #       # #       # #     #   #     #     #   #
###### # # ### # ### ##### ##### ##### # ##### # # # ####### # ### ##### # ### # # ##### # # ##### # # ####### ### # ##### #####
       # # #   #   #     #           #   #     #   # #           #       # # # #   # #   #   #     # # #   #   #   #     #     #
 ####### # # ##### ##### ### # # ### ##### ### ##### # ######### ##### ### # # ##### # ### ######### # # # # ### ############# #
     #     # #   #     #     # # #   #     #   #     #   #     #     # #   # # #                     # # # # #         #     # #
#### ####### # # ##### ##### ### # ######### ### ####### # ### ### ### # ### # # ##################### # # # # ####### # ### # #
   #       # # #     #       #   # #   #     #   #     # #   # #   #   # # #   # #     #               # #   # #       #   # # #
 # # ##### ### ##### ### ##### # # ### # ##### ##### # ##### # # ### ### # ##### ### ### ############### # ##### ######### ### #
 # # #   #   #   #       #     # #   # #     #       #       # #         #   #   #   #   #   #     #     # #   #   #       #   #
 # ### # ### ### ######### ##### ### # ##### ################# ######### # ### ### ### ##### # ### # # ##### # # # # ####### ###
 #     #     #   #     #   #   #   # #     #         #       #         #           #   #     #   # # # #     # # # # #         #
 ############# ### ### # ##### ### # ##### ######### # ############### ### ######### ### ####### # # ### ##### # # # # ####### #
     #   #     #   #   #     #     #     #     # #   # #         #   # #   #       # #       # # # #     #     # # # #   #     #
 ### # # ####### ########### ##### ### ####### # # ### # ####### # # # # ### ##### # # # ### # # ######### ####### # ### # #####
   #   #   #   #       #   #   # #   #   #     # # #   # #     #   # #       #   #     #   # # # #   #     #       #   # #     #
 ######### # # ####### # # ### # ### ### # ##### # # ### ##### ##### # ####### # ### ##### # # # # ### ####### ### ### ####### #
 #         # #       #   #     #   #   #   #   # # #   #     #     # # #       #   #     # #   # #   #   #     #     #         #
 # ######### ####### ############# # # ##### # # # # ####### # # ### # # ######### # ##### ##### ### ### # # ###################
 #   #       #     #       #     #   #       #   # #     #   # #     # #   #   #   #   #   #       #   # # #               #   #
 ##### ##### # ### ####### ### # ##### # ######### # ##### ### ####### ### # # ####### # ### ######### # ########### ### # # # #
   #   #   # #   # #     #   # #     # #   #         #     # #     #   # #   #     #   # #   #     #     #   #     # #   # # # #
 # # ### # ##### # # ### ### ##### # # # # # ######### ##### ##### ### # ######### ##### # ### ### ####### ### ### ### ### ### #
 # # #   # #   # # #   #   # #     #   # # #     #   #   #       #   #   #   #   #     #     #   # #   #   #   # #     #     # #
## # # ### # # # # ### ### # # ########### # ##### # ### # ##### ### ### # # # ####### ####### # # # # # ### ### ####### # # # #
   #   # # # # # # #   # # # #   #   #   #   #     # #   #     #   #   #   # # #       #     # # #   # #     #   #       # # # #
 ####### # # ### # # ### # # ### # # # # ##### ##### # ####### ### ### ### # # # ####### ### ### ##### ####### ### ### ### # # #
   #     # #   # #   #   # # #   # #   # #   # #   # #   #   # # #   #   # # # #       # # #     #   # #     # #     # #   # # #
 # # ##### ### # ##### ### # ##### ##### # # # # ### # # # # # # # # ### # ### ####### # # ######### # # ### # ##### # ### # # #
 #   #       # # #   #   # #       #   # # # # #     # # # # # # # # #   #   # #     #   # #   # #   #   #   # #     #   # #   #
 ##### ##### # # # ### # # ##### ### # # # # # # ####### ### # # # # # ##### # ### # ##### ### # # # ##### ### # ####### #######
 #   # #     #   # #   # # # #   #   # # # #   #       #   # #   # # #     # #     # #           # # #   #   #   #     # #     #
 # # # ##### ##### # ### # # # ### ### # # ########### ### # ### # ####### # ####### # ######### # # # ##### ##### ### # # ### #
   # #   # #       #   # # # # #   #   #   #       #   #   #   # #       # # #         #   #   # # # # #   #     #   #   # #   #
######## # # ##### ### # # # # # ### ####### ####### ####### # # ####### # # # ######### # # # ### # # # # ##### ### ##### # ###
         #   #   #     # # #   #   #   #     #   #   #     # #     #     # # #   # #     # # # #   # # # #     #   #   #   #   #
 ########### # # ######### ####### ### ### ### # # ### ### ####### ####### # ### # # ##### ### # ### # # ### ##### # # ####### #
   #       # # #         #     # # # #   # #   #   # #   #   #   #         # # # # #   # #     # # # # # # #   #   # #         #
 # # ##### # # ######### ##### # # # ### # # ####### # ##### # # # ######### # # # ### # ####### # # # # # ### # ### ###########
 # # # #   # # #     #         # # #   # #   #     #   #     # # # #           # #   #   #   # #   # # #   # #   #       #   # #
 # # # # ##### # ### # # ####### # ### # # ### ### # ### ####### # # ##### ##### # ##### # # # ##### # ### # ##### ### # # # # #
 # #   # #   # #   # # #         # # #   # # #   #   # #       # #   # #   #     # #   #   #     # #   #   # #     # # #   #   #
 # ### # ### # ##### # ####### # # # ##### # ### ##### ####### # ##### # ### ##### # ########### # ### # ### ### ### # ##### ###
 #   # #     # # #   # #       #   # #   # #   # #     #     #   #     #   # #   #           # #   # # # #       #   #     #   #
 ### # ####### # # ### # ####### ### # # # # ### ### # ### ####### ####### # # # ### # ##### # ### # # # ######### ####### # ###
   #   #   #   # #   # #   #   #       #   #         #   #   #   #   # #   # # #     #   #             #         #         #   #
 ####### ### ### ### # ### # # ### ##### ############### ### # # ### # # ### ########### # ########### ######### ############# #
 #       #   #     # #   # # #   #     #             # # #   # # #         #   #         # #     #   #       #   #     #     # #
 # ##### # # ##### # ### # ##### ##### # ########### # # ### # # # # ##### ### # ######### # ### # # ####### # ### # # # # # # #
 #   # # # # #   # #     #       #     #     #       # #   # # # # # #       #   #         # #   # # #       # # # # # # # #   #
 ### # # # ### # # # ############# ######### # ####### ### # # # # # # ##### ##### ####### # ####### # ####### # # # # # # ### #
 #   # # #     # #   #     # #   # #   # #   # # #   #   # #   # # # # #   #       #     # #   #     #       # #   # # # #   # #
 # ### # ####### ##### ### # # # # # # # # ### # # ### ### ##### ### # ### ### # ### ##### ### # ######### ### ##### # ##### # #
 # #   #       #       #   # # #   # # #   #   #   #   #   #   #     # #       #     #     #   # #         #   #     #       # #
 # # ################# # ### # ####### ### # ##### # ### ### # ##### # # ####### ##### ##### ### # ### ##### ### ###############
 # # #               # # #   #       # #   #     # # # #   # # #     # #   #   # #   #     #   # # #   #   # #                 #
 # # # ############# ### # ######### # # # ##### # # # ### # # # # # # ##### # ### # ######### # # # ### # # # # ############# #
 #   #   #         #     #         # # # #     # #       #   # # # # # #     #     # #         # # #   # #   # # #   #   #     #
 # ##### # # ##### ########### ### # # # ##### # ### ######### ### # # # ########### # ######### ### ### ##### # # # # # #######
   #     # # #         #       #   #   # #   # #   #   #     # #   # # # #   #     #   #             #   #     # # #   #       #
 ### ####### ######### # ##### # # ##### # ### ### # # # ### # # ##### # ### # ######### ##### ####### ### ##### # ########### #
 # # #       #   #   #   #     # #       #     #   # # #   #   #   #   #   #     #       # #   #       #   #     # #     # #   #
 # # ####### # # # # ##### ### # ####### ####### ### ##### ######### # ### ##### # ### # # # ### ########### ### # # ### # # ###
   #   #     # # # #     # #   #       # #     # # #   # #         # #   # #   # # #   #   #   # #         #   # #   # # # # # #
 ##### # # # # # # ##### # ### ####### # ##### # # ### # ######### # ### # # # # # # ####### # # # ####### ### # ##### # # # # #
 #     # # # # # #     # #   #   #     #       # #   # #         # #   # #   # #   # #     # #   # #     #   # #       # # #   #
 # ####### # # # ####### ### # # # ############# ### # ######### # # # ####### # ##### ### ####### # ####### # ######### # #####
 #   #     # # #       # #   # # #   #   #   #   # # #         # # # #   #       #     # #   #     #     #   # #   #     # #   #
 ### # ####### ####### # # ### ##### # # # # # ### # ######### # # ##### # ### ### ##### ### # ######### # ##### # # ##### # # #
 #   # #     # #     #   # #   #     # #   #   #   # #     #             #   # #   #   #   #   #   #     #       # # #     # # #
 # ### # ### # ##### ##### # ### ##### ########### # ### # # ############### # # ### # ### ##### # # ############# # # ### # # #
 # #   #   #   #       #   #   # #   # #     #     #   # #   #     #       # # #     #     #     #   #           #   # #   # # #
 # # ##### ##### ##### ######### # ### # ### ### ##### # ##### ### # ##### ### ########### # ######### ##### ### ##### # ### # #
 # # #   #       #   #       #   #   #   # #   # #   #   #     # #   # #   #   #         # #   #     # # #   #         # #   # #
## # ### ########### ####### # ### # ##### ### # # ##### # ##### ##### # ### # # ######### ### ##### # # # ####### ### # # #####
   #   #             #     #   #   #       #   #         #   #   #           # # #     #   #   #   # #   #   #   #   # # #     #
 ##### ############# # ### ##### ### ####### ####### # ##### # # # ########### # # ### # ### ### # # # ####### # ### # # ##### #
 #   #           #   #   # #   #   #       # #       #     # # #   #         #   # # #   #   #   # # # #    S# # #   # #       #
 ### # ######### # ##### # # # ### ####### # ### ####### # # ####### ####### # ### # ##### ### ### # # # ### # # ##### #########
 #   #     #   # #   #   # # #   # #   #   #   # #   #   # #       #     #   # #   # #           #   # #   #   #   #           #
 # ### ### # # # ### # ##### ### # ### # ##### # # # ########### # ##### ##### # ### # ######### # ### ### ####### ##### # #####
 #   #   # # # #     #     # #   # #   #     # # # #   #       # #       #     # #           # # #   #     #     #     # #     #
 ### # # # ### ########### # ##### # ##### # # ### ### # ##### # ######### ### # # # ####### # # # # # ##### ######### # ##### #
     # # #     #   #           #   #       # #     # # #     # #     #     #       #   #     #   # #           #   #   # #   # #
######## ####### # ########### # ################### # # ### # ##### # ####### ####### ########### # ######### # ### ##### # # #
         #       #     #   #       #     #       #   # # #   #   #   # #     #     #   #       #   # #       # # #   #     # # #
 # # # ### ########### # # ####### ##### # ### ### # # ### ##### ##### # ### # ### ##### ##### ##### # ##### # # # ##### ### # #
 # # #     #       #   # #     # #         #   #   # #   #     # #   # #   # #   #       #   #     # #     # #   # #     # #   #
## # ############# # ######### # # ####### ##### ####### ##### # # # ##### # ### ######### ####### ####### # # ### # ### # ### #
   #     #       # #     #     #   #     #             # #   # #   #   #   # # # #   #     #     #   #     # #   # # #   #   # #
 ####### # ### ### ##### # ######### ### # ##### ####### # # ######### # ### # # ### # ##### ### ### # ##### ### # # # # ### # #
       #     # #   #   #   #     #   # # # #   #       # # #   #       #   # #   #   #       #   #G# # #   # #   # # # #   # # #
 ##### ### ### # ### # ##### ### # ### # ### # ### ### # ##### # ########### # ### ########### ### # # ### # ##### # ####### # #
     #   #   #   #   # #     #   #   # #   # #   #   # #     # # #           #   # # #             # #   # #     # #     #   # #
#### ### # # ##### ### # ##### ##### # ### ##### ### # ### ### # ### ########### # # # ############# ### # ##### # ##### # ### #
   #   # # #         # # #   # #   #   # #   # # #   #   #     #   # #     #     # # # #   #         #   #   #   #   # #   #   #
 # ### # ########### # # # # # ### ##### ### # # # # ############# # # ### # ##### # # # # # ######### ##### # ##### # ##### ###
 #   # #           # # # # # #   #     #   # #     # #     #       # # #   # #     # # # #   # #       #     #     # #       # #
 ### # ########### # ### # # ### # ### ### # ####### # # ### ####### ### ### # ##### # # ##### # ####### ### ##### # ####### # #
 #   #           # #   #   # #   #   #   # # #     #   # #                   #   #     #     #   # #   # #       #   #       # #
 ### ### ######### ### ##### ### ### ### # # # ### # ##### ####### ### ### ##### # ######### ##### # # ### ##### ##### ####### #
   #     #   #   # #       #   #   # #     # # #   #       #     #   #   #             #     #   # # #     #           #       #
## ####### # # # # # ##### ### ### ### ##### # ##### ####### ### ### ### ### ########### ####### # # ######### # ##### # #######
 # #       #   # # # #   #   #   #   #   #   #     #         #   # # # # #   #       #   #   #   #   # #   #   #   #   # #   # #
 # # ########### # # # # ########### # # # ####### # ######### ### # # # # ### ##### # ##### # ####### # # # # ### ##### # # # #
   #           #   #   #               #             #         #     #   #     #     #       #           #   #   #         #   #
################################################################################################################################
