################################################################################################################################
################################################################################################################################
       #                 #   #   #       #       #     #   #   #     # #   #   #   #     #               # #           #       #
 ##### # ########### ##### # ### # ####### ##### # ### ### # ### # # # # # # # # # # # # # # ##### ##### # # # ### ### # ##### #
 #     #       #     #     #     #         # #   #   #   # #   # # # #   #   #   # # # # # #     # #   # #   # #   # # #     # #
 ############# # ##### ##################### # ### # ### # ### # # # ############# # # # # ##### # ### # ##### # ### # ##### # #
   #  S    #   #   #   #   #           #   #   #   #   # #   # # # #         #   #   # # # #     # #   # # #   # #     #   # # #
 # # ### ### ##### # ### # ### ####### # ### ######### # ### # # # ######### # # ##### # ### ### # # ### # # ### # ####### # # #
 #   # #   # #   # #     #   #     #   #   #   #       #   # #   #         #   #       #     #   # #   # #   #   # #     #   # #
 ##### ### # ### # ######### ##### ##### # ### # ######### # # ####### ############# ########### # ### # ##### ### # ### ### ###
 #       # #     # #       # #   #   #   #   # # #   #     #   #     # #         #   #     #     #     #       # # #   #   #   #
 # ##### # ##### # # ##### # # ##### # ####### # # # # ######### ### # # ####### # ### ### ##################### # ### ### ### #
   #     # #   # #   #   #   #           #     # # # #       #   # # # #     # # # # #   #             #   #     # #   #   #   #
#### ####### # # ##### # ##### ######### # ####### # ####### # ### # # ##### # # # # ################# # # ##### # # ### ##### #
 #   #       # # #   # #   #           # # #       #         #   #   #   # # # # #     #         #     # #         # #   #   # #
 # ##### ##### # # # # ### # ######### ### ### ####### ######### ####### # # # # ####### # ### # # ############# ### # ### # # #
 # #     #     #   # # # # #   #     #   # #   #     #     #   #   #   #   # # # #   #   # #   # # #       #   #     #   # #   #
 # # ##### ######### # # # ### ### ##### # # ### ### # # ### # ### ### ##### # # # # # ### ####### # ##### # # ######### ##### #
 #   #     #   #     # # # # #   # #   #   # #   #   # #   # #   # #   #     # #   #   # #         #   # #   #     #   #       #
 ##### ##### ### ##### # # # ### # # # ##### # ### ### ### # ### # # ### ##### ######### ############# # ######### # # ####### #
   #   #     #   #     # # #   # # # # #   # #   #   # # # #   #   #   #                               #   #       # #   #     #
## # ####### # ##### ### # # ### # # # # # # ### ### # # # ### ####### ######### ####### ### # ######### # # ####### ### ##### #
   #       # # #   # # #   # #   #   #   #     # #   #   #   #       #  G#   #   #     # # # #         # # #     #   # #       #
 # ####### # # # # # # # ### # ############### # # ####### ######### ### # # # ### ### # # # # ### ##### ####### ### # # ##### #
 #           #   #   #   #   # #             #   #       #         # # #   #   #   #   # # # #   #       #     # #   #   #     #
 ########### ######### ### # # # ########### # ######### ####### # # # ### ##### ### ### # # # # # ####### ### # # ####### ### #
     #             # # #   #   #       #     # #     # #       # #   #     #   # #   #   # # # # #       # #   # # #     # #   #
#### # ######### # # # ### ############# ##### # ### # ####### # ##### ##### # ### ### ### # # # # ##### # # ### # # ### # ### #
     #   #       #   #   # #   #                 # # # #   #   #             #     #   # # # # # # #   # # #     # #   # #   # #
 ####### # ######### ### # ### # ####### ######### # # # ### ####### # ############# ### # # # # # # # ### ####### ##### ### # #
   #   # # # #     #   # #   #   # #   #           # # #   #     #   # #     # #     # #   # # # # # # #   #   #     #   # # # #
 ### # # # # # ### # ### ### # ### # # # ########### # ### ##### # ### # ### # # ### # # ### # # # # ### ##### # ##### ### # # #
 #   #   #   # # # #           #   # # # #           #   #   #   #   # # #   #   #   #   #   # # # #     #   #   #     # #   # #
 # ##### ##### # # # ######### # ### # # # ########### # ### # ##### # # # ####### ### ##### # # # ####### # ##### ##### ##### #
 # #     #   # #   #         # #   # # # #   #   #   # #   #   #     #   #       #   #       # # #     #   # #     #   # #     #
 # # ### # # # ##### ####### # # ### # # ### # # # # # ### ##### ##### ######### ### ########### # ### # ### # ####### # # #####
 # #   # # # #   # # #   #   # # #   # # #   # # # # # #       #   #       #     #   #           #   #     # #   #   #   # #   #
 # ### # # # ### # # # # # ### # # ### # # ### # # ### ### ### ### # ####### ##### ### ##### ##### # ##### # ### # # # ### # # #
 #   # #   # #   # # # # # #     # #   # #     # #   #   # #     # # #     # #     # #   #   #     #     # #     # # #   #   # #
 ### # ####### ### # # ### # ##### # ### ####### ### ### # ##### # ### ### # ##### # # # # ### ### ##### # ######### # # ##### #
 #   #   #           #     # #   # #   #       #   #     #   #   # #   # #   #     # # # # #   #   #   # #   #   #   # #     # #
## ####### ### ############### # ##### # ##### ### ### ##### # ### # ### ##### ##### # # # ##### ### # # # # # # # ### ##### # #
   #     #   # #         #     #       # #       # #   #     # #   # #       #   # # # # #   #   #   # # # #   #         #   # #
 ### ### ### # # ####### # ############# # ##### # # # # ##### # ### # # ### ### # # # # ### # # # ##### # ### ####### ### ### #
   # # # #   #       # #   # #     #     # #     # # # #     #   #   # #   #     #     #   # # #     #   #   # #     #   #   # #
## # # # # ######### # ##### # ### ####### # ##### # # ##### ##### ### ################# ### # ####### ##### ### ### ### # # # #
 # #   # # #   #       #     #   #     #   #     # # #   #   #     #   #           #     #   #     #   #   # #   #   # # # #   #
 # ##### ### # ####### ### ##### ##### ##### ##### # ##### ############# ######### # ##### ######### ### # ### ####### # ### ###
 # #   #   # #     # #   #     #   # # #   # #     # # #   #       #     #     #   # #   #   #     #   # #     #   #   #   #   #
 # # # ### # ##### # ### # ### ### # # # # # # ##### # # ### ##### # ##### ##### ##### # ### # ### ### # ####### # ### ### # ###
   # # #   # #   # #         #   #   #   # # #   # #   #       #   # #     #     #     #   #   #   #   # #       #   #   # #   #
## # # # ### # ### # ####### # ##### ##### # ### # # ######### # ### ##### # ##### ####### ### # ### ### # ######### ### # ### #
 # # #   #   #   # #   #     # #   #   #   #   # #       #   # # # # #   # # #     # #   #   # #   #     #   #   # # #     #   #
 # # ##### ##### # # # ####### # # ### # ##### # ####### # # ### # # # # # # # ##### # ##### # ### ######### # # # # ######### #
 # #       #     # # # #     # # #     #     # # #     # # #   # # #   # # # #       # #     #   #       #   # #   # #       # #
 # ######### ### # # ### ### ### ####### ### ### # ### ### ### # # ##### # # ##### # # # ####### ####### # ### ### # # ##### # #
 #             # # #   #   # #   #     # #   #   #   #     # # #   #   # #         #   # #           #   #     #   #   #   # # #
 ##### ####### ### ### ### # # ### ### ### ### ##### ####### # ##### # # # ############# # ### ##### # ######### ####### ### # #
     # #       #   #     # #   # #   # #   #   #   #         #       # # # #   #     #   # #   # #   #         # #   #   #   # #
#### ### ##### # ####### # ##### ### ### ####### ##################### # # # # # ### # ##### ### # ########### # # # ### # ### #
   #     #     #       # #   # #   #     # #   #       #   #     #   #   # # #   #   #   #   # # # #     #   #   # #     # #   #
 ##### ##### ######### # ### # # ######### # # ####### # # # ### # # ##### # ##### ##### # ### # # # ### # # ########### # # ###
 #     #   # #   #   # # #   #           # # #     #   # # #   # # #   #   #   # # #     #   #     # # #   # #   #   #   # #   #
 # ### # # ### # # # # # # ############# # # ### # # ### # ### ### ### # ##### # # ### ##### ####### # ##### # # # # # ### ### #
   #   # #   # #   # #   #         #   # # # # # # # #   #   #     # # #     #   #     #   #       #     #   # #   #   #   #   #
## ##### ### ####### ### ######### # # # # # # # ### # ##### ####### # ##### ########### # ####### # ##### ##### ####### ### ###
   #   #   #     # #   #         #   # #   #   #     # #   #   #   # #     #           # #       # # #     #   #   #   # #     #
 # # # ### ##### # ### ##### ######### ### ### ######### # ### # # # ##### # # # ### # # ####### ### # ####### # ### # # ##### #
 # # #     #   # #   #     #         #           #   #   #     # #   #   #   # # # # # # #     # #   # #       #     # #   # # #
 # # ####### # # ### ##### ######### ### ####### ### # ######### ### # # ####### # # # # # ##### # ### # ####### ######### # # #
 # #   #     # #   #           #         #     # #         #     # # # #       # #   # # #     #   # # #   #   # #         #   #
 # ### # ### ##### ########### # ######### ### # # ######### ##### # # ####### # ##### # ##### ##### # ### # # # # ########### #
 #   # #   # #   #   #   #       #     #   #   # # #       # #   # #   #     #   #       #         #   # # # #   # #   #       #
#### # ### # # ##### # # # ####### ### # ### ### # # ##### # # # # ##### ### ####### ############# ##### # # ### # # # # ### ###
   # # #   #   #   # # # #     #   #     #         # #     # # #           #         #         #   #   #   # # # # # # #   #   #
 # ### # ####### ### # # ##### # ######### ##### ### # ##### ### # ##### # # # ##### # ####### # # # # # ### # # # ### ####### #
 # #   #       # #   # #   #   #       #   #   # # # #       #   #     # # # #   #   # #     # # #   #     # #   #   #   #   # #
 # # ######### # # ### ### ### ####### # ### # # # # ######### # ##### ### # ### # ### ### ### ########### # # ##### ### # # # #
 #   #           #     # #   # #     # #     # #   #     #     #   #   #   #   # #   #   #   #         #     #     #     # # # #
 ############### ####### ### ### ### ##### ### ######### # ##### ### # # ### # # ####### # # ######### # ######### ####### # # #
 #               #     #   #     # #     # #   #     #   #   #   #   # # #   # #           #     #     # #   #   #   #   # #   #
 ############### # ### ### ####### ##### # ##### ### # ##### # # # ##### ### # ################### ##### # # # # ### # ### ### #
   #       #   # #   #       #   #       # #     # #   #     # # #   #   #   # #   #   #           #     # #   #   # #     #   #
## # ####### # # ##### ##### ### ######### # ##### ##### ##### # ### # ### ### # # # # # ################# ####### # ####### # #
 # #       # # #     #     #   # #         #     #       #   # #   # # #     #   #   # #       #   #       #     # #         # #
 # # ##### # # ##### # ### ### # # ############# ######### # # # # # # ####################### # # # ####### ##### # ### ##### #
   # #   # # #           #   #             #   # #   #   # #   # # # #   #   #   #   #   # #   # #   # #   #       # #   #     #
 ##### # # # ########### ### ######### ### # ### # # # # # ##### # # ### # # # # # # # # # # ######### # # # ####### # ### ### #
 #     #     #   #     #   #         # #   # #   # #   # #     # # #   # # #   #   #   # # #           # #   #       # #   #   #
 # ##### ##### # # ### # # ######### ### ### # ### ##### # ##### ### # # # ############# # ####### # # # ########### # # # # ###
   # #   #     # # # # # #   #   # #   #   #   # # #   # # #   #   # # #   #   #       # # #     # # # #       # #   # # # #   #
#### # ### ####### # # # ##### # # ### ### ##### # ### # # # # ### # ####### ### ##### # # ### ### # ######### # # ### # ##### #
         #       # #   # #     # #     #       # #   # # # # #     #   #     #   #   # #       #   #     #   # # # #   #     # #
###### ######### # ##### # ##### ####### # ### # ### # # # # ######### # ##### ### # # ######### ##### ### # # # # # ####### # #
     # #         # #     # #   #   #     #   #   #   # # # # #     #   #       #   # # # #       #   # #   #   # # #   # #   # #
 ### # # ######### # ##### ### ### # ############# ### # ### # ### # ############# # # # # # ##### # ### ####### # ### # # ### #
 #     #     #   # #   #   #   # # #         #   # #   #     # #     #             # # # # # #     # #   #     #     # #   #   #
 ##### ##### # # # ### # ### # # # ##### ### # # # # ### ##### ######### ##### # ### # # # ### ##### # ### ### ##### # ##### ###
     #         # # #   # #   # # # #   #   # # # #   # # #   #   #   #   #     #   # #   #   # #   # # #     #   #   #     #   #
 ############### # ##### ### # # # # # ##### # # ##### # # # ### # ### ### ######### # ##### # # # # # # # # ### # ##### # ### #
 #         #   # # #   #   # # # #   #     #   #     #   # #   # #     #   #   #   # # #   # # # # # # # # #   # # #   # # #   #
## ####### # # # # # # ### ### # ######### ##### # ##### # ### # ####### # # # # # # # # ### # # # # # # # ### # # # # ### ### #
   #   # # # #   #   #   # #     #   #   #   #   # #     #   # #     #   # # # # #   # #   # # # # #   # #   # # # # #   #   # #
 # ### # # ##### ####### # # ##### # # ##### ##### # ### ### # ##### # ##### # # ### # ### # # # # ##### ##### # ### ### # # ###
 # #   # #       #     #   # #   # #   #   #     # # #     # #   #   # #     #   #         #   # # #   #   #   # #   # # # #   #
 ### ### ####### # ### ##### # # # ##### ####### ### # ##### ### # ##### ########### # ### ##### # # # ### # ### # ### # ##### #
     #         #   # # #     # # # #   #   #   #     # #     # #   # #   #         # # #         #   # #   #   #   #   #   #   #
###### ####### ##### # ##### # # # # # ### # # ####### # # ### ##### # # # ####### # # # ### ### ##### ### ### ##### # ### # # #
     #     # #       # #   # # # # # #   # # #         # # #   #   #   # # #   #   # # # #   #   #   #   # #   #     #   # # # #
#### ##### # ##### ### # # # # # # # ### # ##### ##### # ### ### ####### # # ### ##### # ### # ##### ### ### ### ####### # # # #
   #   #   #     #   # # # #   # #   #   #       #   # #   # # #   #     # # #   #     #   # #   #   # # #   #   #     # # # # #
 # # ### ### ####### # ### # ######### ######### # # # ### # # ### # # # # # # ########### # ### # ### # # ### ### ### # # # # #
 #   #   #   #       #   # #   #     #       #   # #   # #   #   # # # # #   # #       #   # # # #     #   #   #   #   # #   # #
 ##### ### # # ######### # ### # ### ####### # ### ##### ####### # ### # ##### # ##### # ### # # # ### ##### # ### ##### ##### #
   #   #   # #   #       #     #   # #   # #   #   #     #     # #     # #     #   #   #   # # # # #         # #   #     #     #
## # ### # ##### # ####### ####### # # # # ### # ### ####### ### ##### # # ####### # ##### # # # # # ### ##### # # # ##### ### #
   # # # #   # # # #   #   #       # # #   #   #     #     # #   #     # # #     # #       # # # # #   #   #   # #     #     # #
 ### # # ### # # # # # # ### ####### # ####### ####### ### # # ### # ### # # ### # ######### # # # ### ### # ######### ####### #
 #   #     #   # #   # #   # #       # #     #       # # # #   #   # # # # #   #   # #     #   # # #   #   #       #         # #
 # ####### ##### ##### # ### # ####### # ### # ##### # # # # ### ### # # # ### ##### # ### ##### ### ### ######### ######### # #
 #       #     #   #   # #   # #     #   # #   #     # #   # #     #   # #     #     #   # #   #   # #   #   #   #   #     #   #
 ####### ##### ##### ### # ### # ### ##### ##### ####### ### ##### ##### ####### ### ### ### # ### # # ##### # # ### ##### ### #
       #           #     # #   # # # #           #       # # #   #     #       #   #   # #   # #   # #     # # #   #   #   # # #
 # ### ########### ##### # ##### # # # # ### ### # ####### # # # ##### # # ####### # # # # ### # ### ##### # # ### ### # ### # #
 # # #           #     # #   #   # # # #   # # # #       # # # #   #   # # #       # # #   #   # #   # #   # #   # # # # # #   #
 # # ########### ##### # ### # ### # ##### # # # ####### # # # ### # # # ### ####### # ##### ### # ### # ### ### # # # # # ### #
 #   #                         #           #   #         #     #     # #     #       #     #     #     #         #   #   #     #
################################################################################################################################
