################################################################################################################################
#   #     #             #   #     #             #                     #   #   #     #       #   #                 #         #   
# # # ### # # ########### ### ### # ########### # ########### ### # # # # # # # ### # ##### # ### # ### ######### ######### ### 
# #   # #   #     #     # #   #   #     # #     #     #     # #   # # # #   #   #   #     #       #   #   #       #   #   # #   
# ##### ######### # ### # # ### ### ### # # ######### # ### # # ##### # ################# ### ############# ####### # # # # # ##
#       # #     #   # # #   #   #     # # # #         #   # # #     # #     #   #   # #   #   #   #   #   # #       #   #       
####### # # ######### # ##### ######### # # # ####### ### ### # ### ####### ### # # # # ### ### # # # # # # # ########### ##### 
#   #   #     #       #       #       # # # # #    G# # #     #   # #         # # #   # # #   # #   # # # # # #         # #   # 
# # # ### ##### # # ################# # # # # # ### # # ####### # # # ####### # # ##### # ### # ##### # # # ### ##### ### # # ##
# #           # # #     #             #   # # #   # #   #   #   # # #   #   #   #       #     # #   # # # #   # #   # #   # #   
# ########### # # ### # # ################# # ### # ##### # ####### ### # # ################# # ### # ### ### # # # # # ### ### 
# #     #   #   # # # # #       #       # # #   # #     # #       #     # # #     #         # #   # #     #   #   # #     #   # 
# # ### # # # ### # # # # ##### # ### # # # ### # ##### # ####### ####### # # ### # ####### # ### # ####### ### ### ######### # 
# # # #   # #   # #   #   #   #   #   #   #   #   #   #         #       # #   #   # #   #   #   #   #         # # #   #       # 
# # # ##### ### # ######### # ##### ### ##### # ### # ################# # ##### ##### # # ### # ### ######### # # ### # ####### 
# #   #     #   #   #       #     # #     #   #   # #     #           # # #   #     # #   #   #   #     #   #   #   # # # #     
# ### # ##### ##### # ########### # ####### ### # ####### # ######### # # # # ##### # ##### ### ####### # # # ##### # # # # ####
#   # #   #   # #   # #       #   #         #   #     #     #     #   # #   #   #   #   #     # #       # # # #   #   # #   #   
# ### ### # # # # # # ### ### # ### ######### ####### ######### ### ### ####### # ##### ##### # # ######### # # # ##### ##### # 
#     #   # #   # # #   #   # # #   #   #           #         #   #         #   #     # #   # # # #       #   # # #   # #   # # 
# ##### ##### ### ##### ### # # # ### # # ### ######### ##### ### ####### # # ####### # # # # # # ##### # ### # # # # # ### # ##
#     # #   #   # #   #     # # #     # # # #         # #   # # #         # #       #   # #   # #       #     # # # # # #   #   
# ### ### # ##### # ##### ##### ####### # # ######### # # # # # ### # ############# ##### ### ############### # ### # # # ##### 
#   #     #     #   #   # #   #     #   #     #   #   # # #   # #   #           # #     # #   #         #           #         # 
### ########### ##### # # # # ##### # ### ##### # ####### ##### # # ########### # ##### # # # # ####### ########### ######### # 
#   # #     # # #     # # # #       #     #     #   #     #       #         #   # #   # # # # # #   #   #         #   #     # # 
# ### # # # # # # ##### # ################# ####### # ####################### ### # ### # # # # ### # ### ####### ### # ### # # 
#     # # #   #   #     # #             #   #     # #           #             #   #   # # # # #     #   # #   #   # # # #   # # 
# ### # # ####### ####### # ########### # ### ### # ########### # ############# ##### # # # # ######### # # ### ### # # ##### # 
#   # # #   #   # #       #   #       # # # # #   # #   #     # #               #   # # # # #         #   #   # # #   #   #   # 
# # # # ### # # ### ########### # ##### # # # # ### # # # ### # ############# ### # # # # # ##### # # ####### # # # ##### ### # 
# # #   #   # # #   #   #       #     # # #   # # #   # #   # #   #   #     #     #   #   #     # # #         # #   #   # #   # 
# # ######### ### ### # # ########### # # ##### # ##### ##### ### # # # ### ################### # # ########### ### # # # # ### 
# #         # #     # #   #   #   # #   #       # #   # #   #     # # # # #             #       # # #         #   # # #   # #   
# ######### # # ##### ##### # # # # ############# # ### # # ####### # # # ############# # ####### # # ####### ### # # ##### # ##
#   #     #   #   #   #     #   #     #             #   # # #     # # # #       #   #   # #       # # #     #     # #   #   #   
### # ### # ##### # ### ##### ####### # # # ####### # ### # # ### # # # ##### ### # # ### # # ### ### ##### ####### ### # ##### 
#   #   # # #     #     #     #     #   # # #     #   #   # #   # # # # #     #   #   #   # #   #   #   # #     #     # #   #   
# ##### # ### ########### ##### ### ##### ### ### # ### ####### # # # # # ### # ####### # ######### ### # ##### # ##### # # # ##
# #   # #     #           #   # #       # #   #   # # #   #   # #   #   #   # # #       #       #   # # #     # # # #   # #   # 
# # # # ####### ##### ##### # # # ##### # # ####### # ### # ### ############# # ########### ### # ### # ##### # # # # ### ##### 
#   # #   #   #   #   #     #   # #   # # # #   #         #     #   #       # # #         #   # #     #     #       # #   #     
##### ### # # ### # ### ######### # # # # # # # ### # ### ####### # # # ### # # # ####### # ### # ######### ### ##### # ####### 
# #         #     # # #     #     # # # # #   #   # # #           #   # #     # # # #     # #   #       #   #   #   # #   #     
# # # # ########### # ##### ####### ### # ####### ### # ### # ######### ##### # # # # ####### ##### # ### ### # # # # # # # ####
# # # #   #   #     #     #       #   # #     #   #   # # # #         #     # #   # # #       #   # #   # #   #   #   # #       
# # ####### # # ####### # ####### ### # ##### # ### # # # # ######### ##### # ##### # ### ##### # ##### # ####### ############# 
# #     #   #   #     # # #     #   # #     # #   # # #   #   # #   #     # #     #   #   # #   #     # #       # #   #     # # 
# ### ### ######### # # ### # # ### # ##### # ### # ####### # # # ##### # # # # # # ### ### # ######### ####### # ### # ### # # 
#     #   #     #   #       # # #   #     # #   # #     #   #   #       # # # # # #   # #   # #             # # #     # #   #   
### ### # ##### # ### ####### # # ####### # ### # ### ### ### ############# ### # ### # # ### # ######### # # # ##### # # ##### 
#   #   # #   #   #       #   # #         #     #   # #   #             #   #   #   #   # #   # #   #   # # # # #       # #     
# ### ##### # ####### ### ### ##################### ### ####### ######### ### ##### ##### # ### # ### # # # # # ##### ### ##### 
#   #   #   #   #   #   #   # #   #   #           #   #     #   #   #     #   #       #   # #   #     #   #   # #   #   #     # 
# # ### # ##### # # ### ### ### # ### # # ### ####### ##### # ### # # ##### ### ####### ### # # ######### ##### # # # ### ### # 
# #   #   # #   # #       #     #     # #   #   #     #     #     # #   # #   # #   #   #   # #   #       #     # # #   #   # # 
# # # ##### # ######### ############### ### ### # ##### ######### # ### # ### # ### # ### ####### # # ### # ##### # # # # ### # 
# # # #     #   #     # #     #       #   #   # #     #   #     # #   #     # #     #   #         # # #   #       # # # # #   # 
# # ### ####### # ### # # ### # ##### # ##### ####### ##### ### # # ######### ##### ### ########### # # ########### # # ### ####
# # #   #     #   #   #   #   # #   #   #     #     # #   #   # # #     #     #       # #           # #         #   # #   #     
# # # ### ### ##### ### ##### # # # ##### ##### ### # # # ### # ######### ### # ##### # ####### ##### ########### ### ### ### # 
# # # #   #     #   # #     # # # #     # #   #   #   # #     #           #   # # #   #     #   #         #       #   # #   # # 
# # # # ####### # ### # ### ### # ##### ### # ### ##### ################# ##### # # ####### # ### # # ##### ####### ### ### # # 
# #   #     # #   #   # # # #   #     #     #   # #   # #   #           # #     # #       #   #   # # #     #       #   #   # # 
# ######### # ####### # # # # ####### ######### # # # # ### # ######### # # ### # # ##### ######### # # ##### ####### ### ##### 
#   #     # #   #         #       #   #       # #   #   #   #     #   # # #   # # # #   #           # #     # # #     #   #     
# # # ### # ### ######### ######### ### ##### # ######### # ##### ### # # ### ### # # # # ### ####### ##### # # # ### # ########
# #   #   # #         #   #         #   # #   #       #   # #     #   # #   #   # # # #   #   #     # #   # # #     # #         
# ##### # # ######### # ### ######### # # # ######### # ### # ##### ### # # ### # ### ##### # # ### # ### # # ##### ########### 
# #   # # #         #       #         # # #     #   # # #   # #   #   # # #   #   #   #     # # # # #     # # #   #   #   #   # 
# # # # ########### ### ########### ### # ##### ### # ### ### # # # ### # ######### ####### ### # # ####### # # # ### # # ### # 
#   # #           #   # #   #     # #   #           #   # #   # #   #   # #       #   #     #   # # #     # #   # #   # # #   # 
# ####### # ######### # # # # ### ### ### ############# # # ### ##### ##### ##### ### # ##### ### # # ### # ##### # ### # # ### 
# #     # #     #     #   #   #       #   #     #     #   #   # #   # #   # #   # #   # #   # #   # #   #   #           #   # # 
### ### # ### # # ##### ############### ##### # # ### # ##### # ### # ### # # ### ####### # # ### # ### ##### ######### ##### # 
#   #     #   # # #     #   #   #   #         # # #   #   #   #     #   #   # #   #       # #   # #     # #   # #     #       # 
# ######### ### # # ##### # # # # # ########### # ######### ####### ### ##### # ### ####### ### # ####### # ### # ### ####### # 
#       #   #   # #     # #   # # #     #     # #           #         # #       # # #   #   #       #     # #   # #   #     # # 
# ##### # ##### # ####### ##### # ##### # ### # ############# ######### ####### # # # # ########### # ### # # ### # ### ### ### 
#   #   #     # #         #   # #   #   # # # #   # #             #     #         # # #       # #   #   # # #   # # #   # #     
### # ####### # ########### # # ### # ### # # ### # # ####### ##### ##### ##### # # # ####### # # ##### # # ### # # # ### ######
#   # #       # # #       # # # #   # # #   #     # #       # #   #       #   # # #   #     # # # #     # # # # # # # #         
# ### # ####### # # ##### # ### # ### # ### ####### ######### # # ######### # # # ##### ##### # # # ##### # # # # # # # ####### 
# #   # #         #   # # #   #   #   # #   #         # #     # #           #   #         #   # # #   #   # #   # # # #       # 
### ### # ########### # # ### # ### ### # ### ##### # # # ##### ####### # ####### ####### # ### # ### # ### # ### ### ####### # 
#   #   #   #   #     # # #   #   # # #   #       # #   # #   #       # #   #     #       #   # # #   # #   #   #     # #     # 
# ##### ##### # # ##### # # ####### # # ### ##### ####### # ######### # ### ### ####### ##### # # # ### # ##### ####### # ##### 
#     # #     #   #     # # #       #   #   #   #   #             #   #   #   # #     # #     # # #   # #         #     #     # 
##### # # ########### ### # ### ##### ### ### # ### # ######### # # ##### ### ### ### ### ##### # ### # ######### # ####### ### 
#     # # #     #     #   #     #   #   #     #   # #   #     # # # #   #   #     # #     #       # # #         # #       # #   
# ##### # # ### ### ### ######### # ### # ####### # ### # ### ### # ### # # ####### ####### ####### # ### ####### # ##### # # ##
# #   # #   #S#   #         #     #       #     # #     # # #   # #     # #         # #     #       # # #   #   # # #   #   #   
# # # # ##### ### # ####### ########### ####### # ####### # ### ######### ### ####### # # # # # ##### # ### # # # # ### ####### 
# # # # #     #   # #     # #         # #   #     #       #   #   #     #   #           # #   # #         #   #   #       #   # 
# # # ### # ### ##### ##### # ####### # # # ####### ######### ### # ####### ### # ####### # ### # ######### ############# # # # 
#   #     #   #     # #     #       #     # #       #       #     #   #   #   # #     # # #   #   #   #   #     #       #   # # 
# ########### ##### # # ##### ####### ##### # ####### ##### ####### # # # ### # # ### # # # ##### # ### # # # ### ### ### ##### 
#     #   # #     #   # #     #     # #   #             #     #     # # #     # #   #   # # #   #   #   # # #       #     #     
### # ### # ##### ##### # # # # ### # # # ##### # # ### ####### ####### ####### # ####### ### # ##### ### # ####### ####### ### 
# # #     #     #     # # # # #   #   # # #   # # #   # #       #   #   #     # #       # #   #     # #   # #   #   #       #   
# # # ##### # ####### # ### # ####### # ### # # # ### # # ####### # # ####### # ##### # # # ####### # # ### # # ### # ####### ##
# # #   #   #       # # #   # #   #     #   # # #   # # # #   #   # # # #     #   #   # #   #       # #   # # #   # #     #   # 
# # ### # ##### ### # # # ##### # # # ### ### # ### # ### # ### ### # # # ### ### ######### # ####### ### # # ### ### ### # # # 
# #   # # #   #   # #   # #   # # # # #   #   # #   # #   #   # #   # #   #     # #       # #     # # # # # #   #   #   # # # # 
# ### # # # ##### ######### # ### ### # ### ### # # # # ##### # ##### ##### ##### # ##### # ##### # # # # # ### ### ### # # # # 
#     #   #     # #       # # #   #   # #   #   # # #         #   #   #   # #     #   # # #     #   #   # # # # #   #   # # # # 
####### ### ### # # ##### # # # ### # # ######### # ############# # # # # # # ####### # # # # # ######### # # # ### ##### # # # 
#     #   #   # #   #   #   # #   # # #       #   # #   #         # #   # # #     #   # # # # # #       # #   #   #       # #   
# ####### ### # ##### # ##### ### ### ####### # # ### # # ######### ##### # ##### # ### # ### ### ### # # ##### # # ####### ####
# #       #   #       #     #   #     #     # # #     # #   # #       #   #     #   #   #   # #   # # # #     # # # #     #     
# # ####### ##### ############# ##### # ### # # ####### ### # # # # # # ##### ####### ##### # # ### # ####### # # ### ### ### # 
# # #           #     #       # #       #   # #   #   #   # # # # # # #   #   #         #   # # #   #     #   # #     #   #   # 
# # # ##### ### ##### # ##### # # ### ####### ### # # ### # # # # # ##### ### # ####### # ### # # ##### ### ##### ##### ### ### 
# #   #   #   # # #   # #   #   # #   #     # #   # #   # # #   # # #   # #   #     #   # #   #   #     #   #   # #     # #   # 
# ##### # ### # # # ### ### ####### ### ### # # ### ##### # ##### # # ### # # ##### # ### # ##### # ##### ### # ### ##### ### # 
#       #   # #   #   # #   # #     #   # #   #   # #     # #     #   #   # # #   # #   # #     # #       #   #   # # #   #   # 
########### # ##### # # # ### # ##### ### ##### # # # # ### # # ####### ##### # ### ### # ### # # ######### ##### # # # ### ### 
# #     #   # #   # # #   #         #     #     #   # # #   # # #   #   #       #     # # #   # # #         #   #   # #     #   
# # ### # ##### # # # ##### ############# ########### # # ### # # # # ### ####### ##### # ##### # # ####### # # ##### ######### 
# # #   # #     # # #     # #           # #       #   # #   # # # # #   # #     #   #   #   #   # #       # # # #               
# # # ### # ##### ### # # # # ####### # # # ##### # ####### ### # ##### # # ### ### # ##### ##### # ####### # ### # # ### # ### 
#   #   #   #   #     # #   #   # #   # #   # #   #   #   # #   #   #   # #   #   # #     #       # #   #   #     # #   # # #   
####### ##### # ####### ####### # # ######### # ##### # # # # ##### # ### ### ##### ### ############# # # ### ######### # # ####
# #         # #     #   #       # #       #     #     # # # #       #   #   # #   #   #     #         #   #   #     # # # #     
# # ####### # ####### # # ####### ##### ### ##### # ### # # ########### # ### # # ### ####### # ### ####### ### ### # # ####### 
#   #     # #     #   #   #   #   #   #   #   #   # #   # # #         # #     # #   #       # #   #   #       # # # # #     #   
### # ### # ##### # # ##### # # ##### ### ### # ##### ### # # ####### # # ##### ########### # ### ### ######### # # # ##### # ##
#   #   #           #       #           #     #       #   #   #         #                       #   #           #   #       #   
