################################################################################################################################
       #               #   #       #   #             #                       #     #       #   #   #     #           #   #     #
###### # # # ######### # ### # ### # ### ##### # # # ######### # ########### # ##### ### # # ### # # ### # ########### # # ### #
     #   # #   #     # #     #   # #   # #     # # #           # #         #         #   # #     # #   # # #     #     # # # # #
 ### ######### # ### # ######### # ### # # # ### # ######### ##### ####### ##### ##### # ######### ##### # # ### # ##### # # # #
 # #   #       #   # #       #   #   # # # # #   #     #   # #     #     #     # #   # # #   #     #   #   #   # #   # # #   # #
 # ### # ########### ####### # ##### # # # # # ####### # ### # ##### ######### # # # ### # # # ##### # # ##### # ### # # # ### #
 #     # # #   #     #     #   #     # # # # #   #   # #   # #     #         # # # #     # # # #     # #   # # #     # # # #   #
 # ##### # # # ### ### ######### ##### # # ##### ### # ### # ##### # ####### # # # ##### # # # ####### # # # # ####### # # # # #
 #   #   # # #   # #   #     #   #   # # # #   #   # # #   #   #   #   #   #   # #     # # # # #   #     #   # #     # #   # # #
 ### # # # # ### # # ### ### # ### # # # # # # ### # # # ##### # ##### # # ############# # # # # # # ######### # ### # ##### ###
   # # # # #   #   # #   # #       #     # # #   #   # # #     #     #   #         #     # # #   # # #     #   #   #       #   #
## # ### # ### ### # # ### # ######### ### # ### # ### # # # ####### ############# # # ### ####### # # ### # ##### ##### # ### #
 # #     #     #   # #     # #   #     #   # # # # #   # # # #       #   #         # # #   #       # # # #   #     #   # #   # #
 # ############### # ####### # # ##### # ### # # # # ### # # # ####### # # ########### # ### ####### # # ##### ##### # ####### #
   #                         # #     # # # #   # # #   #   # #   #   # # #           #     # #   #         #       # #     #   #
#### # ############# # ### ### ##### ### # ##### # ### ##### ### # # # # ##### ##### ### ### # ### # # ### # ##### # ##### # ###
   # # #             #   #   # #   #   # #   #   #   #     #   # # #   #       #   #               # #   #   # #   #     # # # #
 # ### # ### ####### ### ### # # # ### # # ### ##### ##### # ### # ####### ##### # ##### ########### ### # ### # ####### ### # #
 #     #   #   #     #     # # # #   # # # #   #   #     # # #   #       # #   # # #     #     #     #   #   #   #     #   # # #
 ############# # ##### # ### # # ##### # # # ##### ### # # # # ### ##### ### # ### # ### # ### ####### ##### ##### ### ### # # #
       #   # # # #     # #   # #     #   # #     #     # # # #   # #   #   # #     #   # # #   #   #   #   #         #   #   # #
######## # # # # # ####### # # ##### ##### ##### ####### # ##### # # ##### # ########### # ### # # # ##### ####### # # ####### #
     #   # #   # # # #     # #       #         #       # #     # # #     # # #         # #   #   # # #     #     # # #         #
 ### # ### ##### # # # ##### ################# ####### ##### # # # ##### # # # ####### # ### ##### # # ##### ### ### ######### #
   #   # #   #   #   #   #       #   #         #   #   #     # # #     #   # #       #     #   #   #   #     # #   # #         #
 # ##### ### ### ####### # # ### # # # ########### # ### ####### ########### ##### # ########### ######### ### ### # # ####### #
 # #      G#   #     #   # #   #   #   #           # #   #     #   #       #     # # #       #   #         #     #   # #   #   #
## # ######### ### ### ### ### ######### # ### ##### # ### ### ### # ##### ##### # ### ### ### ### ##### ##### # ##### # # ### #
   #     #   #   # #   #     #     #     # #   #   #   # #   #     #     #   #         # #     #     #   #     #       # # #   #
 ##### ### ##### ### ### ### ### # # ##### ##### # ##### ### ##### ######### # ######### ########### # ### # ##### # ### # # ###
     #     #   #     #   # #   # # #     #     # #         #     #   #     #   #     # #   #   #   # # #   #     # # # # # #   #
#### # ##### # ####### # # ### # ####### ##### # ############### ##### ### # ### ### # ### ### # ### # ####### # ### # # ##### #
 #   # #     #         # #   # #       #   #   # #   #     #   # #   #   #   #   # # #             # #       # # #   # #       #
 # ### # ####### # # ####### # # ### ### ### ### # # # ### ### # # # ####### # ### # ### ######### # ####### ### # ### ####### #
 #   #   #   #   # # #       # #   # #   #   #   # # # # #   # #   # #   #   #   # #   #   #   #   # #     #   # # #         # #
 ### ##### # # ### # # ####### ### # # ### ### ### ### # ### # ##### # # # ##### # ### ##### # # ### # ### ### # # ### ##### # #
   #     # #   #   # # # #   #   # #   # #     # # #       # #       # # #       #   #       # #   # #   #     # #   #   # #   #
## ##### # ##### ##### # # # ### ### ### ####### # # ####### ######### # # ######### ######### ### # ### ####### ### ### # ### #
   #   # #     # #     #   #   #   #         #   # # #     # #   #     # #   #     #   #     # # #   #   #     # #   # #   #   #
 ### # # # ### # # ########### ### ### # # # # # # # ##### # # # # ##### ### # ### # # # ### # # # ### ### ### ### ### ####### #
 #   #   #   # # # #   #   #   #   #   # # #   #   #     #   # # #   #   # # # #     #   #   # #   #   #   #       #         # #
 # ####### ### # # # # # # # ### ####### # ############# ####### ##### ### # # # ########### # ##### ####################### # #
 # #   #   #   #   # #   #   #   #   # # # #   #     #   #   #   #   #   # # # # #         # # #   #   #         #     #       #
 # # # ### # ####### ### ##### ### # # # # # # # ##### ### ### ### # ### # # ### # ####### # # # # ##### ####### # ### #########
 #   # #   # #   #     #     #   # # # # #   #     #   #     # # # # #           # #     # # #   #             #     # #       #
 ##### # ### # # # ### ### ##### # # # # ######### # ####### # # # # # ########### # ### # # ########### ########### # # ##### #
       # # #   #   # #   # #   #   # #   #   #   # #       #   #   #   #           # #   # #   #       #     #     # #   # #   #
######## # ######### ### # # # ##### ##### # # # # ####### # ####### ### ########### # # # ##### ##### ####### ### # ##### # ###
   #     #     #     # # #   # #   #       #   # #   #     # #           #     #     # # #       #   #         # # #       #   #
 # # ######### # ##### # ##### # # ############# # ### ##### ####### ####### ### ##### # ######### ############# # ########### #
 #   #       # #       # #   # # # #     #   #   # #   #   #   #   # #     #     #     # #               # #     #   #   #   # #
 ##### ##### # ### ##### # # ### # # # ### # # ### # ### # ### # # # # ### ####### ##### ##### # ####### # # # ##### # # # ### #
 #     #   # # #   #   # # #     #   #     # # #   # #   #   #   # # # # #     #   #   #       # #     #     # #   #   # #     #
 # ##### # # # # ### # # # ################# # # ### ####### ##### # # # ##### # ### ########### # ### ##### ### # ##### #######
 #   #   # # # #     # # #   #     #   #     # #   #     #       # # #   # #   #   # #           #   #     #     # #   # #     #
 ### # ### # # # ##### # ### ##### # ### ##### ### ##### ##### ### # ##### # ##### # # # ########### ##### # ##### # # # # ### #
 #   # #   # # # #   # #   #   #   #   #   #   #   #   # #   # #   # #     # #   # #   #   #     #   #   # #     # # # # # # # #
 # ### ##### # # # ### # # ### # ##### ### # ### ##### # # # # # ### # ### # # # # # ##### # ### ##### ### ##### ### ### # # # #
   #       #   # #     # #   # #         # #   #       # # # #   #     #   # # # # # #   # # #       #     #   #   # #   #   # #
 ### ##### ##### ####### ##### # ######### ### # ####### ### ### # ##### ### # # # ### # # # ####### ##### # # ### # # ####### #
     #     #       #   #       # #   #   #   # #   #   #   #   #       #   # # # #   # # # #     # #     #   #   # #   #     # #
 ######### # # ### # # ######### # # # # # ### ### # ##### ### # ##### ##### # # ### # # # ##### # ##### ####### # ##### ##### #
   #   #   # #   # # # #   #       #   # #   #   #   #   #   #   #   #       # # #   # # # #   #   # #   #           #       # #
 # # # ##### ### # # # ### # # ####### ##### ### # ### # ### # ### # ######### # # ##### ### # ##### # ####### ####### ##### # #
 # # #   #     # # # #   # # #       # #   #   # # #   #     # #   #     #     # #     #   # # #   #         # #       #   #   #
## # ### # ##### # # ### # # ####### # # # ### # # # ######### # ####### # ##### ### # ### # ### # # ####### # # ####### # #####
   # # #   #   # # # # # # # # #     # # # #   # # # #       # # #     # # #   #   # #   # #   # # # #   #   #           #     #
 ### # ##### # # ### # # # # # # ##### # ### ### # # ### ### # # # ### # # # ##### ### # # ### # # # # # # ### ##### # ##### # #
     #     # #   #   #   # #   # #     #   # #   # #     # #     #   # #   #     #   # #   # #   # # # # #   # #   # # #     # #
 ######### # # ### ####### ### # ### ##### # # ########### ### # ### # ######### ### ### ### ##### # # # ### # # # ### ### #####
 #   #   # # # #   #   # #   # #   # #   #   #   #     #   # # #   # # #       #   #   #       #   # # #   #   # #   #   # #   #
 # # # # # # ### ##### # ### # ### # # # ####### # # ### ### # ##### # ####### # ##### ####### # ### # ### ### # ### ### ### # #
   # # #   #   #   #   #   # # # # #   # #     #   # #       #       #   #   # #     #       # # #   #   #     #   # #   #   # #
 ### ##### ### ### # ##### # # # # # ### # # ####### # ####### ######### # # # # ########### # # ######### ######### # ### ### #
 # #       # #     # #   #   # # # #   #   # #       # #     #     #     # # #     #         # # #   #   # #   #     # #   #   #
 # ######### ####### # # # ### # # ########### ####### # ### ##### # ##### # # ##### # ####### # # # # # # # # # ##### # ### ###
 #     #   #       # #S# # # # #   #   #       #   #   #   #     # #   #   #   #   # # #   #   #   #   # # # # # # #   #   #   #
 ##### # # # ### # # ### # # # ##### # # ####### # # ##### ##### # ### ### ##### # # # # # ############# # # # # # # ##### ### #
       # #     # #         #   #     # # #     # #   #   #   #   #   #   #   #   #   # # # #   #     #   # # # # #   #   #   # #
 ####### ####### ####### # # ### ##### # # ### # ##### ##### ########### ### # ######### # # # ##### # ### # ### ### # # ### # #
               #       # #   # # #   #   # # # #   #       #       #   # #   #           #   #     # #   # #   # #   # # #   # #
#### # ####### ####### # # ### # # # ### # # # ### ####### ####### # # # # ####################### # ### # ### # ##### # # ### #
     #     #   #   #   # # #   #   # #   #   #   #               #   # # #         #   #   #       #   # #   # #       # #   # #
 ######### # ### # # ### # # ####### # ##### ### ############### ##### # ######### ### # ### ####### # # ### # ######### ### # #
 #       # # #   # #   # # # #     # #     #   #   #       #   #   # # #   #     # #   #   #   #     # # #   #     # #   #   # #
 ##### # ### # ### ### # # # # ##### ##### ### # ### ### ### # ### # # ### # ### # # ##### ### ####### # # ####### # # ### ### #
     # # #   # # # #   # #       #   #     #   #     #   #   # #   # #   # #   # # # #   #   #       # # # #     # # #   # #   #
#### # # # # # # # ##### ####### # ######### ######### ### ### # ### ### # # # # # # # # ### ####### # # # # # # # # ### # # ###
   # # #   # # # #   #   #     # #   #   #   #   #     #   # # #   # # #   # # # # #   #   #         # # #   # #         # #   #
 # # # ####### # ### # ### ### # ### # # # ### # # ##### ### # ### # # ##### # ### # ################# # ##### ######### # ### #
 # # #   #     #   # #   #   # #   #   #   # # # # #   # #   #     #   #     #       #             #   # #   #   #       #   # #
## # ### # ##### ### ####### # ### ######### # # # # # # # ######### ### ### ######### ### ##### # # # # # # ### # ##### # ### #
   # # #   #   #   #     #   # #   #     #     # #   #   # #           # #   #   #     # # #   # # # #   # # #   #   #   # #   #
 ### # # ##### # # ##### # ### # ### # # # ##### ######### # # # # ### # # ### # # ##### # # # # # # ##### # ####### ### # # ###
     # #   #   # # #   #   # # # #   # #   #       #         # # #   # # #     # #     # #   # # # #   # # #         #   # # # #
###### # # # ### # ### ##### # ### ### ##### ### # # # ####### # ### # # ####### ##### # ##### # ##### # # ##### ##### # # # # #
   #   # # # #   #           #   # # #     # #   #   #     # # # #   # #     #       #   #     #   #   #   # #   #   # #   #   #
 # # ##### # # # ########### ### # # ##### # # # ######### # # # ##### ##### ########### # ##### # # ####### # ### # ### #######
 # #     #     # #     #   #   #         # # # # #       # # # # #   #       #     #   # #     # # #       # # #   #       #   #
 ####### ### ##### ### # # ############### # # # # ##### # # # # # # ####### # ### # # # ##### # # ####### # # # ####### ### # #
       #   # #   # # #   #       #       # # # # # #     # #   #   #       # #   # # # # #     # #     #   #   # #       #   # #
###### ### ### # # # ########### # ##### # # # # # ####### ##### ######### ##### # # # # # ############# ### ### ##### ### #####
         #   # #   #           #   #   #   # # #   #       #   #     #   # #     #   #   #             # # # #   #   #         #
 ####### ### # ##### ############### # ##### # ##### ####### # ### # # # # # ######################### # # # # ### # ######### #
 #   #     #   #   #   #             #       #   #   #       #     # # # # # # #   #   #       #   #   # #   #   # #     #   # #
 # # ##### ##### # ### # ### # ##### ### ### ### # ####### # ####### # # # # # # # # # # ##### # # # ### ### ##### ##### ### # #
 # #             # # # # #   #   #   # # #   #   #       # # #         # #   #   # # # #     # # # #     #   #   #   # #   #   #
 # ####### ####### # # # # # ### # ### # # ############# # # # ######### ######### # # ##### ### # ####### # # # ### # ### # ###
 #     #   #     #   # # # #   # # #     # #     #     # # # #   #     #           # # #   #     #     #   # # # #   #     #   #
 ##### ### # ### ### # ### # ### # ####### # ### # ### # # # # # ##### ### # ######### # # ### ##### # # ### # # # ######### # #
     # #   #   #   #       # #   #       #   #   # # #   # # # # #     #   # #   #     # # #   #     #   #   # #   #     #   # #
###### # ##### ### ### ####### ##### ### ##### ### # ####### # # # ##### ### ### # ####### ##### ######### ### ##### # # # ### #
       # #   #   #     #     # #   #   #     # #   #     #   # #   #   #   # #   #       #       #         #   #     # #   #   #
 ####### # # ### ####### ### ### # ########### ### ##### # ######### # ### # # ######### ####### ####### ### ### ##### # ### ###
   #     # #   # #   #   # #     #     #     # #   #   # #       #   # #   # # #     #   #       #     # #   #   #   # #   # # #
## # ### # ##### # ### ### ########### # ### # # ### ### ####### # ### ##### # # ### # ######### # ### ### ### ### # # ##### # #
   #   # # #     #   #             # # # # # # #   #           #   # #   # #   #   #   #         # # #   # #   #   # # #   #   #
 ### # ### ### ### # ############# # # # # # # ### ########### ##### ### # # ##### ####### ####### # ### # ### # ### # # # #####
 #   #   #     # # #   #         # # # # #   #   #         #       # #   #         #     # #   #   #     #     # #   #   #     #
 ### ### ####### # # ### ####### # # # # ##### # ##### ### ##### # # # ##### ######### # ### # # ##### ####### # # ########### #
 #   #   #   #     #     #   # # #   #   #   # #     # # #     # # #   # #   #     #   #     # #     #       # # # #   #   # # #
 # ### # # # # ##### ##### # # # ### ##### # ####### # # ##### # ####### # # # ### # ######### ##### ####### # # # # # # # # # #
 # #   #   #   #   # #     #   #   #   #   #     #   #   # #   #     #   # #   #   #   #     # #   #     #   # # #   #   # #   #
 ### ########### # # ####### ######### # ####### # ##### # # ### ### # ### ### # ##### # ##### # # ####### ### # ######### #####
   # #     #   # # #         #       # # #   #   # #   #   #   #   # #   #   # #     #   #     # # #       #   # # #     #     #
## # # ### # # # # ########### ##### # # # ### ### # # ####### ### ##### ### # ##### ##### ####### # ####### # # # # ### ##### #
   #     #   #   #             #     #   #         # #         #             #     #                         #   #   #         #
