################################################################################################################################
################################################################################################################################
# #   #     #     #   #       #   #   #   #     #     #     #   #           #           #     #   #         #   #         #     
# # # # ##### ### # # # ##### # ### ### # # ### # ### # # ### # ##### ##### # ######### # ### # ### ##### # # # # ##### # # ### 
# # # #       #   # #   #   # # #       #   #   #   # # # #   # #   # #   # #       #   # # # # #   #     #   # #     # # #   # 
# # # ######### ### ##### # # # # ##### ##### ##### # # # # ### # # # ### # ####### ##### # # # # ########### # ##### # ####### 
# # #         #     #     # # #   #   #     #   #   #   # # # # # # #     # #   # # #     #   #     #       # # #     # #       
# # ######### ####### ##### # ##### # ##### ##### ######### # # ### ####### # # # # # ######### ##### ##### # # # ##### # ######
# # #   #   #     # # #   #   #     #     #                 # #     #     # # #     #   # #     #   # #     # #   #   #   #     
# # # # # # # ### # # ### ##### ######### ######### ######### ####### ### # ### ####### # # ##### # ### ##### ##### # ##### ### 
# #   # # # #   #   #   #   #   #       # #   #   #   #   #   #   # #   # #   # #           #     # #   #         # #       # # 
# ##### # # ### ####### ### # ####### ### # # # # ### # ### ##### # # # # ### # # ########### ##### # ### ### ### # ######### # 
# #     # #   # #     # # # # #   #   #   # #   # #             # #   # #     # #     #       #   # # #   # #   #   #     # # # 
# # ####### ### # ### # # # # # # # ### ### ##### # ########### # # ### # ##### ##### # ######### # # # # # ### ##### # # # # # 
# #   #     #   #   #   #   #   # # #   #   #   # #           # # #   # #       #     # #   #     #   # # #         # # #   #   
# ### # ##### ##### ##### ### ### # # ### ### # # # ######### # # ### # # ##### # ##### ### # ########### ##### ### # # ########
# #     #   # #     #   #   # #   #   # # # # #   #   #     # #     # # #     #   #     #   #             #   #   #   #         
# # ##### # # # ####### ### ### ### ### # # # ##### # # ##### ##### # # ##### ##### ##### ######### # ##### # ### ############# 
# # #     #   # #         #   #   #   #   # # #     # #     #     # # # #   #   #   #   # #         #   # # #   #   #       #   
# # # ####### # # ####### ### ####### ##### # # ##### ##### ##### # # # # ### # # ##### # # ### ####### # # ####### # ##### # # 
# # #   #     # #   #       #     #   #   #   #   # # #   #     # # # # #   # # #   #   #   #   #     # # #   #     #     #   # 
# # ### ####### ### ####### ##### # ### # # ##### # # ### ##### # # # # ### ### ### # ##### ##### ### # # ### # ######### ##### 
# # # #         #   #           # #   # # #     # # #   #   #   # #   # #       #   # #     #     # #   # # #   #   #   # #     
# # # ############### ######### # ### # # ##### # # ### # # # ### # ### ####### # ### # # ### ##### ##### # ##### # # # # # ####
#   #     #           #       # #   #   #             # # #   # # #   #   #   # #   #   # #   #     #   #         # # #   #     
# ##### ### ####### ####### # # ### # ##### ####### ### # ##### # ####### # # # ### ### ### ####### ### ########### # ##### ### 
#     #     #       #     # #             # #     # #   # #     # #   # # # # #   #   # #   #     #     #         #   # #   #   
##### ####### ### ### ### ####### ####### # # ### # # ### # ##### # # # # # ##### ### ### ### ### ##### # ####### ##### # ### ##
#   # #         # # # #       #   #     # # # # # # # #     #     # # # # #       #   #   #   # #     #   #     #     # #   #   
# # # ######### # # # ####### # # # ### # ### # # # # ##### # ##### # # # ######### ### ##### # ##### # ### ### ##### # ### ### 
# # #         # #   #     # # # # #   # #   # #   # #   #   #     # # # #       #   #     #   #   # # # #   # #     # #       # 
# # ######### # ######### # # # # ### # ### # ##### ### # ####### ### # ####### # ##### # # ### # # # ### ### ##### # ### ##### 
# #   #       # #   #   # #   # #     #   #   #       # #       #     #       #   #   # # # # # # # #     #               #     
# ### # ####### # ### # # # ####### ##### ######### ### ### # # ######### ### ##### # ### # # # # # ####### ### ####### # # ####
# #   #     #     #   # # # #     # #     #         #   #   # # #         # #       #     # # # # # #     #   # #       # #     
# ######### ####### ### ### # ### # ######### ####### ### # # # ##### ##### ### # ######### # # # # # # # ##### # ####### ##### 
#       #   #     #   # #   # #   #         # #   #   #   # # #       #   #     # #   #     #   #   # # # #     #   #   #   #   
# ### ### ### ### ##### # ##### ### ####### # # # # ### # # # ######### # # ##### # # # ##### ######### # # ### ### ### # ### ##
# #   #   #   #   #   # # #     #   #       # # # # #   # # #   #   #   # # #   # # #   #   #         # #   #   # #     # #   # 
# ##### ### ####### # # # # ##### ### ####### ### # ##### ##### # # # ### ### # # # ####### ######### # ##### # # ######### ### 
#   #   # #     #   # #           #   #     #     #     #     #   #   #   #   #   #   #   #         #   #     # # #   #   # # # 
### # ### ##### ##### # ##### ##### ### ### ########### # ######### ### ### ######### ### # ### # # ##### ### # # # ### # # # # 
# # # #     #   #         #   #   #   #   #     #       #   #     #   #   #   #       #   # #   # #       # # #   #   # # # # # 
# # # ##### # ### ####### ##### # ####### ##### # ####### # # ### ########### # ####### ### # ### ##### # # # ####### # ### # # 
# # # #   #   # #   #   # #   # #       # #     # #       # # #    S          #   #     # # # # # #   # #   #         # #   #   
# # # # # # ### ### # # # # # # ####### # # ##### # ### ### # ################### # ##### # # # # # # # ######### ##### # ### ##
#   # # # #         # # #   #   # #     # #   #   #   #   # #   #     #     #   #   #     # #   # # # # #   #   # #   #   #   # 
# ### # # # ######### # ### ##### # ##### ### # ######### # ### # ### # # # # # ##### ##### # ### # # # # # # # # # # ##### ### 
#     # #   #         #   #       #     # # # # #   #   # #   # #   #   # # # # #   #       #   #   # # # # # # #   #       # # 
# ##### # ### ########### ### ########### # # # # # # # ####### ### # ### # # # ### ########### ##### # # ### # ############# # 
# #   # # #   #         # #   #         # #   # # # # #         #   # #   #   #     #         #   #   # #   # # #     #   #   # 
# ### ### # ### # ####### # ### ####### # # ### # # ############# ### # ########### ####### # # # # ### ### # # # # ### ### # # 
# #   #   #   # #       # #   #     #   # # # # # #   #         #   # #     # #   #         #   # #   #   #   #   #   # #   #   
# # ### # ### # ####### # ######### # ### # # # ##### # ########### # ##### # # ############# ####### ### ##### ##### # # ######
# # #   # #   # #     # #           # #   # # #       #             # #     # # #   # #   #   #     #   #     #   #   # # #     
# # # ### # ### ##### # ############# ##### # ########### ####### ##### ##### # # # # # ### # # ### ### ##### # ### ### # # ### 
# #   #   # #       #     #         #       #             #     # #   #     # # # #   #     # # #   # #   #   #   #     #   #   
# ##### ### ### ### ####### ####### ################# ### # ### ### # ##### # # # ########### # ##### # ### ### # ########### ##
#     #       # # #       # #             #   #     #   # #   #     # #     # # #       #     #     # # #   #   # #       #   # 
##### ####### # # ####### # # ##### ####### # # ### ### # ### ####### # ##### # ####### ### # ##### # # # ##### ### ### ### ### 
#   #     # # #         #   #   #     #   # # # # #   # #   # # #     # #   #     #   #   # #   #   #   #     #       #     #   
# # ##### # # # ########### ### ### # # # # # # # ### # ### # # # ##### # # # ##### # ### ### # # ######### # # ########### # # 
# # #     # #             #   # #   # # # # #   #   # #   # # # #       # # # #   # #   #     # #         # # # # #       #   # 
# # # ##### # ########### ##### # ### # # ####### ### ##### # # ######### # # # # # ########### ######### ### # # # ##### ######
# # # #       #   #   #   #     # #   # #     #   #   #     # # #         #   # # #   #                 #     # # #     # #     
# # # # ####### # # # # ### ##### ### # ##### # # # ### # ### # # ############# # ### # ### # ################# # ##### # # ### 
# # #       #   #   # # #   #     #   #   # #   # # #   # #   # #       #       #   # # # # #         #           #     #     # 
# # ### ##### ####### # ########### ##### # ##### # ### ### ### ####### # ########### # # # ######### # ##### ##### ####### ### 
# # #   #   # # #   # #   #   #   #     # #     # #   #   #   #                   #   # #           #   #   #       #     # #   
# # # ### # # # # # # ### # # # # ##### # ##### # ### # # ### ##### ####### ##### # ### ##### # ######### # ##### ### ### ### ##
# # #   # # # # # # #   # # # # # #     # #   # #   # # # # #     # #     # #   # #     #     #           # #   # # # # #   #   
# # ### # # # # # # ### ### # ### # ##### # # # # ### # # # ##### # # ### ### # # # ##### ####### ### ### ### # # # # # ### ### 
# #   #   # # # # #   #   # #   #   #   # # #   #     # # #   #   # #   #     # #   #   # #     #   # #   #   # #   # #   #     
##### ### ### # # ### ### # ### ##### # # # ##### ##### # ### # ####### ####### # ### # # ##### # ### ##### ### # ### # # ######
#   #     #   # #   # #G  #   # #     #     #   # #   # #   # #       # #   #   # #   # #   #   #   #     # #   # #   # # #   # 
# # ##### # ### ### # ####### ### ########### # ### # # # ### ####### # # # # ##### ### ### # ### # ##### # ####### ### # ### # 
# #       # #     # #     #   #     #     #   #   # # # #       #     # # # #       #   # # #   # #     # #         #   #   # # 
######### # # ### # ##### # ### ##### ### # ##### # # ##### ##### ##### # ########### ### # ### # ##### # ########### ### # # # 
#         # #   # #   # # #   #   #   # # #   # # # #     # #   # #     # #       #   #   #   # # # #   #               # # # # 
# ######### ##### ### # # ### ### # ### # ### # # # ##### ### # ### ##### # ### ### ### ##### # # # # ### # ######### # ### # # 
#   #   # #   #     #   #   # #   #   # # #   # #   #   # #   #     #   #   # #     # #     #   # # # #   #         # #   #     
### # # # ### # ### ####### # # ##### # # # ### ##### # # # ######### # # ### ####### ##### ##### # # # ########### ##### ##### 
#   # #     # #   #                 # # # #   #     # # # #   # #   # # # #       #         #       # #   #     #   #     #   # 
# ### ##### # ### # # # ####### ##### # # ### # ### # # # ### # # # # # # # ##### ######### # ####### ### # ### # ### ##### # ##
#   # # #   # #   # # # #     #     #   #     #   # # # #     # # # # # #   #   #         # # #   #     # # #   #   # #     #   
### # # # ### # ### # # # ### ##### ############# # ### ####### # ### # ##### # ######### # # # # # ### # # ####### # # ####### 
# # # # # # # #   # # # #   # #   #           #   #       #       #   #       #       #   #   # # #   # # #   #   # # #     #   
# # # # # # # ### # # # ### # # # # # ####### ########### # ####### ################### ####### # ### # # ### ### # # ####### ##
#   # #     #   # # # # # # #   # # #   #   #     #   #             #         #   #     #       #     # #     #   # # #       # 
# ### # ####### # ### # # # ##### ##### # # ##### # # ##### ######### ####### # # # ########################### ### # # ####### 
# #   # # #   # # #   #   # #   #   #   # #   #     #     #       #   #     #   # #                   #       #     # #     #   
# ### # # # ### # # # ##### ### ### # ### ### ########### # ##### # ####### ######################### # ##### ####### ##### # # 
# #   # # # #   # # #     #     # # # #   #   #     #       #   # #   #   #         #       #   #     # #   # #         #   # # 
# # ### # # # ### # ### # ####### # ### ### ### ### # ### ### # ##### # # ##### ### ### ##### # # ##### # ### # ######### ### # 
#   # # #         #   # #   # #   #   #   # #     # # #   #   # #   #   #       #   #   #     # # #     # #   # #     #   #   # 
##### # ### ######### # ### # # ##### ### # ##### # ### # # ##### ############### ### ### ####### ### ### # ### # ### # ####### 
#     #     #         # #   # # #   #     # #     #   # # #             #   #   #     #   # #     #   # #   #     #   # #     # 
# ######### # ######### # ### # ### ####### # ####### # # ##### ##### # # # # # # ##### ### # ##### ### # ##### ### ### # # # # 
# #         # #   #     # #   #   # #   #   # #       # # #   # #   # #   #   #   #     #   #     # # # # #   # # #     # # # # 
# # ### ### # # ### # ### # ##### # # # # ##### ####### # # # # # # # ### ####### # ##### ####### # # # # # # # # ####### # # # 
#   #   #   # #     #   #       # # # # #     #         # # # # # #   #   #       #   #         # # #   #   # # # #       # # # 
# ### ####### ##### ### ######### # # ####### ########### # # # # ######### ##### ### ### ####### # # ####### # # # # ##### # # 
# #   #     # #   #   #   #           #     #         #     #   # #       #     #   #     #   #   # #       # #     # #     # # 
# # ### ### # # # # ##### # ########### ### ######### # ######### # ##### ######### ##### # # # ### # ##### # ##### # ####### # 
# #     #   # # # #     #   #       #   #   #     # # #   #   #   # #   # #     #   #   # # # #     #   # # #     # #   #     # 
############# # ####### ##### ##### # ##### # # # # # ### # # # ### # ### # ### # # # # # # # ######### # # ##### # ### # ##### 
#             #       #   #   # #   #     # # # #   # #   # #   #   #       #   # # # #   # #       #   # #     # # # # #     # 
# ################### ### # ### # ####### # # # ### # ##### ##### ####### ##### ### # ##### ####### # ### ##### # # # # ##### # 
# #   #             #   # #   # #       # # # #   #         #     #       #   #   #   #   # #     #   # #     #   #   #     #   
# ### # ########### ### # ### # ####### # # # ### ######### # ####### # ### # ### # ### # # # ### ##### # ### ########### # # ##
#   #   #         # #   #   # # #     # # # # #   #   #     #       # #   # #   #       #   # #   #   # # # # #         # # #   
# # ##### ##### # # # ##### # # ##### # # # ### ### # # # ######### ##### # ### # ########### ####### # # # # # ####### ### ####
# #           # # # # #     # #   #   #   #   # #   # # #         #     # #   # # #         #   #     # # #   # #     #   #     
# ########### # ### # # # ### ### # ######### # # ### ############### # ##### # # # ####### ### # ##### # # ### # ### ### ##### 
#   #     # # # #   # # #   # #   #     #   # # # #   #   #         # #     # #   #   #   # #     #   # # #     #   #   # #   # 
# # # ### # # # # ### # ### # # ### ### # # # ### # ### # # ####### # ##### # ### ### # # # ##### # # # # # ####### ### # # # # 
# #   # #   # # # # # # # # #   # #   #   # #     #     # #   #   # #     # #   #   # # # #   #   # #   # # #         # #   #   
# ##### ##### # # # # # # # ##### # # ################### ### # ### ##### # ### ### # # # ### ### # ##### ### ######### ####### 
#     #     # # # #   #   #       # #             #     #     # #   #     # #   #   #   #   #   # #     #     #   #     #       
# # # ### ### ### # ############# # ##### # ### # ##### ####### # ######### # ### ####### ##### # ##### # ##### ### ####### # ##
# # #   # #   #   # #           #   #   # #   # #       #   #   #           #   #   #     #   # #   #   #     #   # #       #   
# # ##### # ### ### # ######### ##### # ##### # ######### # ### ################### # ##### # # ### # ### ####### # # # ####### 
# #     # #   # # # # #   #   #       #     # #   #       # #   #     #   #         #   # # # # #   #   #         # # # # #   # 
# ##### # ### # # # # # # ### ############# # ### # ####### # ### ### # # # ### ####### # # ### # ##### ##### ##### ### # # # # 
# #   # # #   # #   # # #     #       #   #   #   # #       #     #   # # #   # #   #   # #     #     #     # #   # #   # # # # 
# # # # # # ### # ### # ############# # ####### ##### ####### ##### ### # ### ### # # ### ########### ##### ### # # # ### # ### 
#   # #   #     #     #                                           #     #   #     #   #                         #   #     #     
################################################################################################################################
