################################################################################################################################
################################################################################################################################
#     # #     #   #   #       #         #   #     #                                       #   #     #     #         #   #     # 
##### # # ### # # # # # ##### # ##### # # # # ### # ##### # # ########### # ### # ####### ### # ##### ### ### ####### # ### # # 
#     # #   #   #   # # #     # #   # #   #     #   #     # #         # # # #   #   #   #     #       # #   #     #   #   # #   
# ##### ### ######### # ####### # ### # ############# ##### ######### # # # ####### # # ############### ### # ##### ##### # ### 
# #         #   #   # #     #   #     # #   #         #       # #     #   #   #   # # #     #         #     #       # #   # #   
# # ######### # # # # ##### # ########### # # ######### ### # # # ######### # # # # # # # # # ### ##### ##### ####### # ##### ##
# #         # #   # #     # #           # # #   #   #     # #   # #   #     # # # #   # # # # # # #   # #   #         #     #   
# ### ##### # ####### ##### # ######### # # ### # # ##### # # ### # ### # # # ### ##### # # # # # # # # # # ### ########### # ##
#   # #   # #         #     #     #   # # #     # # #     # # #   #     # # #   #       # # #   # # #   # # #   #       #   #   
### # # # ####### ##### ######### # # # ####### # # # ##### # # ########### ### ######### # ### # # ####### # ### ##### # ### # 
#   # # #       # #     #         # # #       # # # # #     # #   #       # #   #   #   # #     #           #   # #     # # # # 
# ### # ####### ### ##### ### ##### # ####### ### # # # ######### # ##### # # ### # # # # ### ########### ##### # ####### # # # 
#     # #     #   # #       # #     #       #     # # #   #     # #   # # # # #   #   # #   #   #       #       #       # #   # 
### ### # ### ### # ##### ### # ########### ####### # ### # ### # ### # # # # # ####### ### ### # ##### # ############# # # ### 
#   #   #   # # # #     # #   #   #   #     #   #   # #   # #   # #   #   # # # #     #   # # # #   #   #         #   #   # #   
# ### ####### # # ##### ### # ### # # # ##### # ##### ##### ##### ##### ### # # ##### ##### # # ##### ### # ##### ### ##### ### 
# # #     #   # # #   #     # # # # # #     # #     #     # #     #     #   # #           # #   #     #   #     # #   #       # 
# # ##### # ### # # ######### # # # ##### # # ##### ##### # # ##### ##### ### ########### # ##### ##### ##### # # # ### ### # ##
# # #   # #   #   #   #   #   # # #     # # # #   # #   #   #       #       #   #   #   # #       #     #   # # #   # #   # #   
# # ### # ### ####### # # # ### # ##### ### # # # # # # ######### ##### ####### # # # # # ######### ####### # ####### # # # ### 
#       # # # #     # # # # #   #   # #     #   # #   #   #     # #   # #     #   # # #   #     #   #   #   #           # # # # 
# ####### # # # ##### # ### ### ### # ########### ####### # ### ### # ### ### # ### ##### # ##### # ### # ##### # ####### # # # 
# #     #   #             #   #   #           #   #   #   #   #     #   # # # #   #   #   #   #   # #   # #     #   #   # # # # 
# # ### ### # ########### ### ### ########### # ##### # ##### ######### # # # ### ### # ##### # ##### ### # ####### # ### # # # 
# #   #   #   #                 #           #   # #   #       #     #   # #   # #   # #       #       # #   # #     #     #   # 
# ### ####### # ############### # ######### ##### # ########### ##### ### # ### # # # ##### ########### ##### # # ######### ### 
#     #       #     #   #   #   #       #   #       #         #       #   # #     # #     #                 #   #   #   #   # # 
# ####### ########### # # # ### # ####### ### ####### ######### ####### ### # ########### ##### # ####### # ### ### # ### # # # 
#         #     #     #   #   # #   #   #       #     #   #     #   # # # # # #     #     #   # # #   # # #     #   #     #   # 
### ####### ### # ########### # ##### # ##### ### ####### # ##### # # # # # ### ### # ##### ### # # # # # ### # # # ########### 
#   #     #   #   #       # # #       # #   #   #   #   # #       # #   #       #   #   # #   # #   #   #   # # # # #   #   #   
# ### ### # # ##### ##### # # ######### # # # # ### ### # ######### ####### ####### ### # ### # ########### # # # ### # # # # ##
# #   # # # # #   # #   #   # #   #   #   #   #   #         #     #       # #     # #   #   #       #   # # # # #     # # # #   
# # ### # ### # # # # ##### # # # # # ##### ####### ####### # ########### ### ### # # ### # ### # ### # # # # ######### # # ####
# #   # #     # #     #   # #   #   # #   # #   #   #     # #       #   # #   #   #   #   #     #     #   # # #     #   # #     
# ### # ####### ####### # ########### # # # # # # ### ### # ####### # # # # ### ####### # ################# # # ##### ### ##### 
#   #   #     #       # # #     #     # # # # #   #   # # #       # # # #   # # #       #   #     #       # #   # #   #   #   # 
# # ##### ### # ##### # # # ### # ####### # # ##### ### # ##### # # # ####### # # ##### ### ##### # ##### # ##### # ### ### # # 
# #       # #   #   # # # # #   # #     # # #     #     #   #   # # #   #   #   # #   #   #     # #   #     #     #   #   # # # 
# # # ##### ##### ### # # # # ### # ### # # ##### # ####### # ### # # # # # # ##### # # ####### # ### # ##### # ######### ### # 
# # #     #     #     # #   #   # # #   #         # #   #   # #   # # # # # #   #   # # #     # # # # #   #   # #   #         # 
### # ######### ####### ####### # # # ### ######### # # # ### # ### # # # # ### # ### # # # ### # # # ##### ##### # # ######### 
#   #           #   #   # #     # # # #   #         # #   #   # #   # # # #   # # #     # # #   #   # #   # #   # #   # #     # 
# ######### ##### # # ### # ##### # # # ### ######### ##### ### # ### # # ### # # ######### # ##### # # # # # # # ##### # ### # 
#   #     # # #   # # #   #     # # # #   # #       #   #   #   #     # #   # # #           #     # #   #   # #   #     # # # # 
##### ### # # # ### ### # ##### # # # # ### # ######### # # ##### ########### # ### ############# # ######### ##### ### # # # # 
#     # # #   # #G#     #     # #   # #     #           # #       #           #   #   #         #   #   #     #   #   # # # #   
# ##### # ##### # ########### # ##### # ################# ######### ############# ##### ####### ##### # # ##### # # # ### # ### 
#   #   #     #             #   # #   # #   #   #               #   #   #       #       #   #   #     # #     # #   # #   # #   
### ### ##### ############# ##### # ### # # # # # ####### # ### # ### # ####### ######### # # ### ##### ##### # ####### ### # ##
#   #   #   #       #   #   #         #   # # # # #   #   # #   #     # #     #           # #   # #     #     #   # #   #   #   
# ### ### # ####### # ### ### ####### # ##### # # # # # ##### # ####### # ### # # ##### ##### ### # ##### ####### # # ### ##### 
# #     # # #     # #     #         # # #     # # # #   #   # # #       #   #   # #   # # #   #   #     # #         #     #   # 
# # ##### # # ### # # ##### # # ### # # # ##### # # ### # # # ### ####### # ##### # # # # # ### ####### # ##### ########### # # 
# #       #   #   # #   #   # # # # #   #   #   # # # # # # # #   #   #   # # #   # # #         #     # #     # #   #       # # 
# ### ############# ### # ### # # # ######### ##### # # # # ### ### ### ### # # ### # ####### ### ### ####### # # # ######### # 
#   #   #         # #     #   #   #       #   #     #   # #     #       #   #   #   #       #     #   #         # #     #       
### ### # ####### # # ################# ### ### # ##### # ####### ##### # ##### # ######### ##### ##### ######### ##### ########
#   #   #       #   # #   #       #     #   #   # #   # #   #     #   # # #     #       # #     #     #       #   #     #       
# ### ######### ##### # # # ##### ####### ######### # ##### ####### # ### # ########### # ##### # ### ### ### # ### # ### ##### 
# #     #   #   #   #   # # #   #         #         #     #   #     #     #     #   #   # # #   # #       #     # # # #   # #   
# ##### # # # ### # # ### # # # ### ####### ############# ### # ######### ##### ### # ### # # ### # ####### # ### # ### ### # ##
#     # # # # #   # # # #   # #   #   #     #   # #     # # # # #       # #   #     #   # # #   # #   #     # #   #     # #   # 
##### # # ### # ##### # ##### ### ### # ####### # # ### # # # # # # # # # # # # ####### # # ### # ### # ##### # # ####### ##### 
#   # # #     # #   #   # #   #   #   # #   #   # # #   # # #   # # # # # # # #   # #   # #   # #   # #   # # # # #   #       # 
### # # ####### # # ### # # ##### # ### ### # ### # ##### # ##### # # # # # # ### # # ### ### # ##### ### # # # # ### ##### ### 
#   #     #       #     # #     # #   # #   #     #     # #       # # #   # #   #   # # #   # # #       # # #   #   #     #     
# ####### # ### # ####### ##### # ### # # ### ### ### ### ### ##### # ##### ### ##### # ### # # # ##### # # ####### ##### # ### 
#       # #   # #       #     # #   # #   #     #   # #   #   #   # # # #   #   #     # #   # # # #   # # #       #       #   # 
# ##### # # ### ##### ### # # # ### ####### ### ##### # ### ### ### # # # ### ### ##### # ### # ### # ### # ############### # # 
#     #   # #   #   #     # # #   #   #     # #       #     # #     # # # #   #   #           # #   #   # #             #   # # 
# ### # ### # ### # ####### # ####### # ##### ############### ##### # # # # ### ### ########### # ##### # # ####### # ### ### # 
# # # #     #     # #       #   #     #   #                 # #   # # # # # #   # #   #         #   #     # #   #   #     #   # 
# # # # ######### # # ########### ####### ##### ####### # # # # # # # # # # ### # ### # ######### # ####### ### # ##### ### ####
# #   # #   #   # # # #     #   #     # #   #   #       # #     #   #   # # #   #   # #   #     # #   #   #     #     #   #     
# ####### # # # # # ### ### # # ##### # ### # ### ##### # # ############# # # ### ### ### ### # # ### # # ##### ##### ### ##### 
# #       # # # # #   # # #   # #   # # #   #   #   #   # # #             #   #     # #   #   # #   # # #       # #   # #   #   
# # ####### ### # ### # # ##### # ### # # ##### ### ### # # # ################# ### # # ### ### # ### # ######### # ### ### # ##
# # #   # #     # # #     #   # #   # # #         # #   # # #       #         # #   # #     # # # #   # # #     # # # # #   # # 
# # # # # ####### # ####### # ##### # # ##### ##### # # # ######### # ### ##### # ### ####### # ### ### # # # ### # # # # # # # 
# # # #     #   #   #       #   #   #   #  S  #     # # # #         # # #   #   #   # #   #   #     #   # # #     # #     # #   
# # ### ##### # ##### ######### # ##### # ### # ##### ### # ######### # ### # ##### # # # # # ####### ### # ####### ######### ##
#   #   #   # # #   # # #     #   #   #   #   # #     #   # #       # # #   # #     # # #   #         #       #   #     #   # # 
# ### ### # # # # # # # # # # ##### ####### ### # # ### # # # ##### # # # ### # ##### # ######### # ### ####### # ##### # # # # 
#   #   # #   #   #   #   # #             # #   # # #   # #   #     #   # #   #   #   #   #       #           # # #     # # # # 
### ### # ############### # ##### ####### # # ### ### ######### ####### # # ##### # ### # ######### ### ##### ### # ##### # # # 
#       #     #       #   #     #   #   #   #   # #   #       # # #   # #   #   # # # # #         #   # #   #     #   #   # # # 
####### ##### # ##### # ####### ##### # ####### # # ### # ##### # # # # ##### # # # # # ######### ### # # # ##### ### # ### # # 
#   #       #   #     # #     # #     #   #     # #     # #   # #   #       # # #   #     #   # # #   #   # #   #   #   # # # # 
# # # ##### ##### ####### ### # # ####### # ##### ######### # # ########### ### ######### # # # # ######### # # ### ##### # # # 
# #   #   # #   #   #     #     # #         #       #       #   #     #   #   #   #   #   # #   #       #   # #   #       # #   
# ##### ### ### ### # ######### # ####### ########### ########### ### # ##### ### ### # ### ########### ##### ### ##### # # ### 
#       #   #   #   #   #     # #       # #         # #     #   # #   #     #   # #           #   #   #       #   # #   # #   # 
######### ### # # ### # # ### # ####### ### ####### # ### ### # # # ### # ##### # # ##### # # # # # ############### # # ##### # 
#         #   # # #   #   #   #   #   #   # #       #   #   # #   # # # #   #   #   #   # # #   #   #       #   #   # # #     # 
# ############# # # ####### ### ### # ### ### ######### ### # ##### # # ### # ##### # # ### ######### ##### # # ### # # # ##### 
#     #       # # #       # #       #   #     #   #     # #   #   # # # # #   #     # #   #         #     #   #   #   # #     # 
##### ####### # # ######### # ######### ######### # ##### # ##### # # # # ##### ##### ### # ####### ##### ####### ########### # 
#   #       #   #           # #       #           #     #   #   #   # # # #   #   #   #   #   #   # #     #     # #   #     # # 
# # ####### ### ############# # ##### ### # # ### ##### ##### # # ### # # # ### # # ### ### # # # # # ##### ### # # # # ### # # 
# #   #   #     #         #     # #   #   # #   #     #       # # # # # #       #     # # # # # # # #     #   # # # #   # #   # 
# ### # ####### ### ####### # ### # ### ### ### # ### ######### # # # # ### ########### # # ### # ####### # # ### # ##### ##### 
#   # #     #       #       #     # # # #   #   #   #   #   #   # #   #   #   #         #   #   #     #   # #     # #     #     
# # # ##### # ##### # ####### # # # # # # ### ####### # # ### ### ### ### # # # ########### # ####### # ### ####### # ####### # 
# # #     #   #   # # # #     # # #   # #   #       # # #   # # #   #     # # # #     #     #   #   # #   # #     #   # #   # # 
# # ##### ##### # # # # # ##### ####### ### ####### # # ### # # ### # ##### # # ##### # ####### ### # ### # ##### ##### # # ### 
# #     #       #   # #   #       #   #   #   # #   # #   #   #     #   #   # #       #       #     #   # #   #   #     # #   # 
# ############### ### ####### ### # # ### ### # # ### ### ##### ####### # ### ############### ######### # ### # ### ##### ### # 
# #   #         # #   #     #   # # #     #   # # #     #     # # #     # # #             #       #   #   #   #   #   #   # #   
# ### # ####### # # ### ### ### # # ####### ### # ### # ##### # # # ##### # ############# # ####### # ##### ##### ### # ### ### 
#     # #     #   #     # #   # # # #     # #   #   # #     # # # # #   # # #     #     # #   #     #       #   #   # #   #   # 
# ##### # ####### ####### ### # # # # ### # # ##### ####### # # # # ### # # ##### # ##### ##### ############# # # ### ### ### # 
# #     #   #   # #   # #     # # #   #   # # #   #   #     #   # #   #   #     # # #     #     #       #     # #   # #     # # 
# # ####### # # # # # # ######### ##### ### # # # # # ####### ### ### # ####### # # # ##### ######### # # ### # ### # # ### # # 
# # #       # # #   # #           #     #   # # # # #   #           # #         #   #   #   #         #   #   #   #   #   # # # 
# # ### ### # ####### ####### # # # ####### # # # ### # ##### ##### # # ##### ### ##### # ##### ######### # ##### ### ### ### # 
# #   # #   #   #   #   #     # # #       #   # #   # #   #     # #   # #   #       #   # #   #   #     # #   # #       #   # # 
##### # # ##### ### ### # ### # ######### ##### ### ##### ##### # ##### # # ### # # # ### # # ##### ### ##### # ##### ##### # # 
#     # #   # #       #   #   # #   #   #     # # # #   #     # # #       #   # # # #   # # #       #   #     # # #   #   #   # 
# ##### ### # ####### ##### ### # # ### ##### # # # # # ##### # # # ######### # # ##### # ########### ### ##### # # ### ####### 
# #   #   # #       #       # #   #     #     # #   # #       #     #         # # #   # #   #   #   # #   #     # #           # 
# ### ### # ### # # ### ### # ########### ### # ##### ############# ########### # # ### ### # # # ### # ####### # ##### ### # # 
#   # #   #   # # #     #   # #   #   # #   # # #     #       #   # #       # # # # #   #   # # #   # #       # #       #   # # 
# # # # ##### # # ####### ### # # # # # ### ### # ### # ##### # # ### ##### # # # # # ### ### # ### # ####### # # ##### # ### # 
# #   #     #   #       #       #   #     #     #   #       #   #     #     #   #   #     #   #               #   #     #   #   
################################################################################################################################
