################################################################################################################################
         #         #           #     #   #           #         #     #   #   #           #         #       #   #   #           #
 ####### # ####### # ### ### ### ##### # # # ####### # ####### ### # # # # # # ##### ##### ####### # ##### ### ### # ###########
 #     # # #     #   # #   #     #     # # #   #     #   #   # #   #   # # #       #       #   #   #     # #       # # #       #
 # ### # # # ### ##### ### ####### ####### ### ######### # # # # ####### # ##### ########### # ######### # # ##### # # # ##### #
 #   #   # # #   #     # # #   #   # #     # #         #   # # #     #   # #     #     #     # #         # #     # #   #     # #
 ### ##### # # # ### # # # # # # ### # ##### ######### ##### # ##### # ##### ### # ### # ##### # ######### # ### ##### ####### #
   #   #   # # #     #   #   # #   # #   #       #     #   # #     # #   #   #   #   # # #     #   #   #   #   #     # #   #   #
 ### ### ##### ######### ######### # ### ### ### ####### # # ####### ### # ##### ### ### # ####### # ### ### # ####### # ### ###
 #   #   #     #           #     #     #     # #   #   # # # #       # # #     # # #     #         #     #   # #     #   #   # #
 # # # ### ##### ########### # ####### ####### ### # # ### # ### ##### # ##### # # ################# ##### ### # ### ### # ### #
 # # # #   #         #       #       #   #           #           #           # #             #       #     # #   # #     #   # #
## # # ############# # ########### ##### # ######################### # ##### # ### ####### # # ####### ##### ##### ######### # #
   # #   #   #       #   #   #   #   #   # #               #         # #   #   #   #       # #   #         #   # #       #   # #
 ### ### # # # ##### ### # ### ##### # ### # ############# # ######### # # ##### ### ####### ### ######### ### # # # ##### ### #
   # # #   # #   #   #   #   # #     #     # #   #         #   #     # # #   #   #   #     #   #         # #     # # #         #
## # # ##### ##### ### ##### # # ######### # # # # ############# ### ### ### # ### ### ### # ########### # ### ### # # ####### #
   #       #     #   # #     # # #         #   # #   #   #     # #   #     # # #   # # #   #           # #         # # #     # #
#### ##### ##### ### # ##### # # # ####### ##### # # # # # ### # # ### ##### # # ### # ######### # ### # ##### ####### # ### # #
     #   # #   #     # #   # #   # #     # #     # #   # # # #   #     #     # # #   #   #       #   #       # #       # #   # #
 ##### # # # # ##### # # # # ##### # ### # # ##### ####### # ########### ####### # ##### # # ############### # # ####### # ### #
     # # # # # #     # # #         #   # # #   #           #   #       #       #   #     # # #             # #   #       #   # #
 ### # # ### # # ##### ######### ##### # ##### # # ########### # ### # ####### ##### ####### # ########### # # ### ######### # #
   # # #     #       #         #   #   #   #   # #             # #   #       #     #         # #         # #   #         #   # #
 # # # ####################### ### # ##### # ### ##### ##### ### # ### ####### ### ######### # ##### ### # ### # ######### #####
 # #   #             #       #     #     #   # # #   #     #     #   # #     #   #       # # #     # #   # #   #   #     # #   #
 # ##### ########### # ### # ### ####### ##### # # # ##### ######### # # ### # ######### # # ##### # # ### # ##### # ### # ### #
 # #   # # #       # #   # #   # #     #   #   #   # #   #       #   # # #   # #     #   #   #   # # # #           # #   #   # #
 # # # # # # ####### ##### ### # # ####### # ####### ### # ##### # ##### ####### ### # ####### # # # # # ####### ### # ##### # #
 # # # # # #   #   #       #   # #         #   # #   #   # #   # #   #   #     # # #   #   #   # # # # # #     # #   #   #   # #
 ### ### # ### # # ######### ### ############# # # ### ### # # # ### # ### ### # # ##### # # ### ### # # # ### ### ##### # ### #
     #   #       #         # #               #   # #   #   # # #   # #     # # # #     # #   # #   # #   # # #   #     # #     #
 ##### ########### ### ### # ### # ####### # ### # # ### ##### # ### ####### # # ##### # ##### ### # ##### # ### ####### #######
 #   #       #     #   #   #   # #     #   #     # #     #   #   #       #   # #   #   # #     # #   #   # #   #   #   #       #
 # # ####### # ##### ### ##### # ####### ### ##### ####### # ### # ####### # # ### # ### # ##### ### # # # # ####### # ####### #
   #   # #   #     #   #     #   #       #       #     #   #   # # #       # #   # #     # #       # # #     #     # #     #   #
###### # # ################# ##### ####### # ### ##### # ##### ### # ####### ### # ####### # ##### # # ####### ### # ### ### ###
     #   #       #       #         #   #   #   # #   #   #   #   # # #     #     #   # #     #       # #   #   # #   # #     # #
 ### ### ####### # ##### # ### ### # # # ####### ### ##### # ### # # ##### ######### # # ##### ##### # # # # ### ##### ####### #
 # # #   #   # # # #     #   #   # # #   #     #     #   # # #   # #   #     #       # # #   # #   #     # # #       #   # #   #
 # # # ### # # # # ####### ##### # # ##### ### ####### # # ### ### ### # ### ##### ### # # # ### # ####### # ### ### # # # # ###
 #   #     #   # #       # #     # #       # #       # # #     #     # #   #   #   # #   # #   # #       # #   # #   # # # #   #
 ### ##### ### # ####### ### # ### # ####### ### ##### ############# # ### ### # ### ### # ### # ####### # ### # # ### # # ### #
   #     # #   #     # #     # #   # #   #   # #       #     #       #   # # #   #       #   # # #     #   # #   # #   # #     #
## ##### # # # ##### # ####### # ### # # # ### ######### ### # # ####### # # ##### ##### ##### # # ### ### # ##### ##### ##### #
 # #     # # # #   # #   #     #   #   # #     #       # # #   #       #   #           # #     #   #   # #   #   #     #       #
 # # ####### # ### # ### ##### ### ### # ##### # ##### # # ### ####### ##### # ##### # # # ######### ### ### # ####### ####### #
 # # #     # #     # #   #       #   # #       #     # #   #         #   #   # #   # # # # #       #     #     #     #         #
 # # ### # # ##### # # ### ### # ### # ############# # ######### # ##### ####### # ### # # ####### ####### ##### ### ######### #
   #     # # #     # #     # # #   # #     #     #   #           #     #   #     # #   # #   #   #       #   #   # #       #   #
########## # # ##### ####### # ##### # ##### ### # ############# ######### # ##### # ### ### # # # ### ##### # ### ####### # ###
         #   # #   # #         #     # #     #   # #           # #         # #     #   #   # # # # #   #     #     #   #       #
 ##### ####### ### # ########### ####### ##### # # # ######### # # ######### # # ########### # ### # ### ########### # # ##### #
   # # #           #       #     #       #   # # # #     #     # #     #   # # # #         # #     #   # #           #   #   # #
## # # # ##### ########### # ##### ####### # # # # ### # ##### # ##### # # # # ### ####### # ######### # # # ####### ##### # # #
 #   # # #   #           # #   #   #   #   #   # #   # # #   #       #   #   #     #     #   #       #   # # #     # #     # # #
 ### # # # # ######### # # # # # ### # # ##### ##### ### # # ####### ############### ### ##### ##### ### # # # ### ### ##### # #
   # #   # #   #     # # # # # #     # #   #   #   #   #   #   #   # #         #     # #   #   #   #   # # # # # #   # #       #
 ### ##### ### ##### ### # # # ####### ### # ### ##### ##### # # # ### # ##### # ##### ### ####### ### # # ### # ### # ####### #
     #   #   #     #     # # #         #   #   #     #     # #   #     #   #   # #   #   #       #   # #   #   #     # #     # #
 ##### # ### ##### ####### # ########### ### # ##### ##### # ############# ##### # # # # ####### ### # ##### ######### # ### # #
       # # #   # # #       #       #   # #   #   #   # #   #         #   #       # #   #       #   #   #   # #   #     #   # # #
######## # ### # # # ####### ##### # # # # ####### ### # ########### # # ######### ### ##### ##### # ### # # # # ########### # #
   #   #   # # #     #           #   # # # #   #   #   # #     #   # # # #     #     #     # #     #     # # # #           # # #
 # # ##### # # ############# # ####### # ### # # ### ### # ### # # # # # # # # # ### ####### # ########### # # ########### # # #
 #   #     # #   # #         # #   #   # #   #   #     #   #   # # #   # # # #     # #       #           # # # #     #     # # #
 ##### ##### ### # # ########### # ### # # ####### ######### ### # ##### # # ##### # # ##### ########### # # # # ### # ##### # #
 #   # #       # #   #           #   # #   # #     #   #   #   # #     # # #     # # #     #           # # # # # #   #     # # #
 # # # # ##### # ##### ############# # ##### # ### # # ### ### ####### # # ##### # # ##### ########### # # # # # ######### # # #
 # # #   #   # #   #   #   #         #         # # # #       #         # #   # # # #   #   #       #   # # #   #               #
 # # ##### # # ### # ### ### ######### ### ##### # # ####### ########### ### # # ##### # ### ##### ##### # ##### ############# #
   # #     #     #   # #   #     #   #   #     #   #   #   #     # #   #   # # #     # #   #     #       #     #     #       # #
#### # ### ##### ##### ### # ### # # # # ##### ### ### # # ##### # # ##### # # ##### # ######### ############# ##### # ##### # #
 #     #   #   #   #   #   #   # # # # #     #   #   #   # #       #     #       #   #     #   # #           # #   # #   #   # #
 # ######### # # # # ### ####### # # # # ####### # ####### ####### ##### ####### # ####### # ### # ####### # # # # # ### # ### #
   #         # # # #   # #       # #   # #       #       # #   # # #   #   #   # # #     # #S    # #     # #     #   #   #   # #
#### ######### # ##### # # ####### ##### # ############# # # # # # # ##### # # # # # ### # ####### # ### # ######### # ##### # #
   # #   #  G#   #   # #   # #     #     #   #     #     #   # # # # #   #   # # # #   #     #       #   #   #     # #     # # #
 # ### # # # ### # ### ##### # ##### ### ### ### # # ######### # # # # # ##### ### ### ### # # ####### # ##### ### ####### # # #
 # #   #   # # #           #   # #   #     #   # # # #     #   # # #   #   # #   # #   #   #   # #     # #     # # #     # # # #
 # # ####### # ### ####### ##### # ### # # ### # # # # ##### ### # ####### # ### # # ### ### ### # ##### # ##### # # ### ### ###
 #   #     # #     #       #   #   #   # # #   # #   #   #   #   #   #     #   #   # # #   #     #     # # #   # #   # #   #   #
 ##### ### # ####### ##### # # ### ##### # # ### ### ### # ##### ### ##### ### ##### # ### ########### ### # # # ##### ### ### #
 #   # #   # #   #   #       #     #   # # # #   #   #   #     #   #     #       #   #   #           # #   # # #   #     #   # #
 # # # # ### # # # ##### ########### # # ### # ### # # ####### # ####### ####### # # ### ########### ### ### ##### ##### ### # #
 # #   #     # # # #   # #     #     # # #   # # # # # #     # #   #   #   #       #   #       #   # #   # #     #     # #   # #
 # ########### # ### # # # ### # ##### ### ### # # # # # ### # # # # # ### ####### ### # ##### ### # # ### ##### ##### # # ### #
 #     #   #   # #   # # # #   # #   #   # #   #   # #   # #   # #   # #   #     # #   # #   #   # #   #     #   #   # # #     #
 ##### # # ### # # ### ### # ### # ##### # # ####### ##### ##### ####### ### ### ### ### ### ### # ##### ### # ### # # # #######
   # #   # #   # # # # #   #     #     #   #     #               #     #     # #     # #   # #   # #     #   # #   # # #     # #
## # ##### # ### # # # # ############# ##### ### # ####### ##### # ### ####### ####### ### # # ### ####### # # # ### # # ### # #
   # #   # # # #   # # #       #   #     #     # # #     #     #   #   #     #       #     # #   #         # # # #   #   # #   #
 ### # ### # # ##### # ### ### # # ### # ##### # ### ### ### # ##### ####### # ############# ### ########### # ### ####### ### #
   #         #   #   #   # #   # #     #     # # #   #   #   #     # #     # # #               # #   #       #   #       # # # #
## # # ######### # ##### ### ### # ######### # # # ### ### ####### # ##### # # # ############# # # # # ##### ### # ### ### # # #
   # # #         #     #     #   # #       #   # #   # #   #       #       # # # #     #     #   # # # # #     # # # #     # # #
 ##### # ############# ####### # ### ##### ##### ### # ### # # ### ######### # # ### # # ######### # # # # ### # # # ####### # #
 #   # #     # #       #       # #   #   # #   #     # #   # # #             # #     # #     #     # #   # #   # #   #       # #
 # # # ##### # # ####### ### # # # ### # # ### ####### # ### # ### ########### ####### ##### # ##### ##### # ### ### # ####### #
   # #     # # # #   # # # # # # # #   # #     #   #   #   # #   # #           #       #     #     #       # #   #     #   #   #
#### ####### # # # # # # # # # ### # ########### # # ### # ##### # # ### ####### ####### ######### ######### # ### ##### # # ###
 #   #     # # # # #   # # # #     #   #       # # # #   #   #   #   # #         # #   #     #   #   #     #   #         # #   #
 # ### ### # # # # ##### # # ####### # # ##### # # # # ##### ##### ### ########### # # ##### # # ### # ### ### # ############# #
 #     # # # # # #     # # #         # # #   # # #   #     #   #                 #   #   # #   #   # #   #   # # #   #       # #
 ####### # # # # ##### # # ### # # ### # # # # # ####### # ### ####### ##### ########### # ####### ##### ### # # # # # ##### # #
   #     #   #   #   # # #     # #   # #   # # #     #   #   #       # #   #             #               #         # #     #   #
## # ######### ### # # # ####### # ### ####### ##### # ############# # # ##### ##### ############# ####### ############### #####
 # # #       # #   #   # #       # #     #     #   # #             # #   #   # #   #             # #   #                 # #   #
 # # # ##### # ### ##### # # ##### # ##### ##### # # ####### ### # # ##### # ### # ### # ####### ### # ### ############# # # # #
   #   #     #     #     # # # #   #       #     #   #       # # # #   #   #   # # #   #       # #   #   # #     #   # # # # # #
 ####### ####### ### ####### # # # ######### ######### ####### # # ### # ##### # # ####### ### # # ##### # ### # # # # # # # # #
       #   #     #   #     # #   # # #       #     #       # #   #   #   #   #   #       #   # # #     # #     # # #   #   # # #
 ######### ##### # ####### # ##### # # ##### # ### # ##### # ##### ######### ########### ##### # ##### # ####### # ########### #
     #     #     # #     #   #   #   # #     #   # # #   # #   #               #       # #     #     # # #     # #             #
 ### # ##### ##### # ### ##### ### ### ######### # ### # # ### ##### ### # ### # ##### # # # ####### ### # ### # # ########### #
   #   #     #     # #   #   #       #           #   # # #   #       #   #   # #   #   # # # #     # #   #   #         #     # #
## ##### ### # ### ### ### ####### # ############### # # # # ############# # # ### ##### # ### ### # # ### ########### # ### ###
   #   # #   # #   #   # #   #     #               #   # # #         #   # # #   #     # # #   # # #   #   #   #   #   #   #   #
 ### # # # ### ##### ### ### # # ##### ### # ##### ##### ########### # # # # # # ### ### # # ### # ##### ### # # # # ######### #
     #   # # #   #   #       # # #   # #   #   #       #   #       # # # # # # #   # #   #     #         #   #   # #           #
## ####### # ### # ### ####### ### # ### ##### # ##### ### # ##### ### # ### # ### # # ############### ### ####### # ###########
   #     #     #   # # #   #   #   #     # #   #     #   # # #   #     # #   #   #   #     #     #   # #   #     # #     #     #
 ### ### ##### ##### # ### # ### ######### # ##### # ##### # # # ####### # ##### ######### # ### # ### # ### ### # ### # ##### #
 # # # #     #   #   #   #   #   #       # # #   # # #   # # # #         #   # # #   #   # #   # #   # # # # #   #   # #       #
 # # # ##### ### # ##### ### # ##### ### # # ### ### # # # # ############### # # # # # # # ##### ### # # # # # ### # # ### #####
 # #   # #   #   #     #   # # #     #     #     #   # # # #   #           # # #   #   # # #     # # #     # # #   # #   #     #
 # ##### # ### # ##### ### ### # ######### ####### ### # # ### # ##### ### # # ######### # # ##### # ####### # ##### ### ##### #
         #     #               #         #             # #     #     #   #   #           #   #               #       #   #     #
