################################################################################################################################
   #                 #   #   #                       #   #                     #                           #     #       #     #
 # ####### ######### # # # # ####### ##### ### ### # # # # # ### ########### # # ### ##### ##### ####### # ##### # ####### ### #
 # #     # #       #   #   #       #     #   #   # #   #   #   #   #       # #   # # #     #   # #     # #           #   #   # #
 ### ### ### ##### ############### # ##### # ##### ########### # # # ##### # # ### # ####### # # # ### # ########### # # ### # #
     # #   #   #   #                     # #     # #       # # # # # #     # #     #   #     #   # #   #     #   #   # #     # #
###### ### ### # ### # ########### ##### ####### ### ##### # # # # # ####### # ####### ### ##### # ####### # # # # ### ####### #
     #     # # #   # # #     #   # #   # #     # #   # #   # # # # #       # #   #   #   #   #   #       # #   # # #   #   # # #
 ### # ##### # ##### # # ### # # # # # ### ### # # ### # ### # # # ####### # ### # ##### ### # # ####### ### ### # # ### # # # #
 # # # #   # #     # # #   #   # #   #       # #   # #   #   # # #   #     #   # #     # #   # # #     #   # #   #   # # #   # #
 # # # # # # ##### # ########### ### ######### ##### ##### # # ##### # ####### ####### # # ### # ### ##### # # ### ### # ##### #
   # #   # #       #   #   #       #   #       #   # #     # #     # #       #   #   #   #   # #     #     # # # #         #   #
#### ##### # ######### # # ####### ### # ######### # ##### ####### # ####### ### ### ####### ######### ####### # # ######### # #
   #   #   # #       # # # #   #   #   # #       #         #     # #       # #   #   #     #           #       #       #     # #
 ##### # ### # ##### # # # # # # ### ### # ##### # ####### # ### # ##### ### # ### # # ################# ############### ##### #
       # # #   #       # # # #       #   #   # # # #   #   # #   #   #   #   #   # #     #   #         #     #   #     # #   # #
 ####### # ##### # ##### # # ### ########### # # ### # ### # ####### ##### ### # ### ##### # ### ##### ##### # # # ### # ### # #
 # #   # #       #   #   # # # # #           # #     #   #         #       #   #   #   #   # #   #     #   #   # #   # # #   # #
 # # # # # ######### # ##### # # # ####### ### ######### ######### ############### # ### ##### ### ##### ####### ### ### # ### #
 # # #   #   #   #   #       #   # #     #     #   #   #   #     #   #             # #   #     # #   # # #   #   #   #   # #   #
 # # ######### # ############### # # ### # ##### # # # ### # # # ### # ############# # ### ##### ### # # # # # ### ### ### # # #
 # #       #   #   #       #   #   # #   # #   # #   #   # # # # # #   #       #     #     #     #   # # # # # # # #   # #   # #
 # ####### # ##### # ##### # # ### # # ##### # ######### # ### # # ##### ##### # # ########### # # ### # # ### # # # ### ##### #
     #   # #   #     #   #   #   #   # #   # # #       # # #   #   #   # #   #   #     #       # #   # # #     # #   #     #   #
#### # # # ### ######### ####### # ##### # # # # ### ### # # ##### # ### # # ########### ####### ### # # ####### ##### ### # # #
   # # # #   # #   #   #         #       #   # #   #     # #     # #   #S# # # #     #   #         #   #     #         #     # #
 ### # # ### ### # # # ##### ######### ####### ### ####### # ### # ### # # # # # ### # ### # ##### ### ##### # # ###############
     # #   #     #   #     #         # #     #     #   #   # #   #   # #   # # # # #   #   # #       # #       # #       #     #
#### # ################### ######### # # ### ####### # # ##### ##### # ##### # # # ##### ### # ##### # # ####### # ##### ##### #
   # #       #           #       #     #   #   #     # #   #   #   #       #   #   #     #   # # #   #   #       #   # #     # #
 # # ####### ### ### ########### ##### ### ### # ##### ### # ### # ### ### ### ##### ### # ### # # ##### # ######### # ##### # #
 # # #     #   #   # #         #     #   #   # # #   # #   # #   #   # #     #   #     # # #   #         #     #     # #   #   #
## # # ### ### ### ### ### # ####### ### ##### # ### # # ##### ##### ### ### ### ##### # # # ########### ##### # ##### # # #####
   #     # #   #   #   # # #     #   #     #   #     #   #     #   #     #     #   #   # # #   #       #   #   # #   #   #     #
 ####### ### ### ### ### # # # # # ### ### # ############# # ### ##### ### ### ### # ##### ### # ##### # ### ### # # # ####### #
 #     #         #   #   # # # # #     #   #   #   # #   # #   #       #   # #   # #   #     #   #   # #   #   # # #     #   # #
 # ### ##### ##### ### # # ### ######### ##### # # # # # # ### ####### # ### ### # ### # ######### # # ### ### # # ####### # # #
 #   #     # #     #   # #   # #         #     # # #   # #   # #     # # #       # #   #       #   # #   #   #   #   #     #   #
 ### ##### # # ##### ####### ### ######### ##### # ##### ##### # ### # # ### ### # # # ####### ### ##### # # ##### # ###########
     #   # # #   #   #     #     #   # #   #     # #     #     # #   # #   # #   #   #   #   #     #     # #       # #         #
###### # # # ### # ### ### ######### # # ### ##### ##### # ##### # ####### ### # ##### # # # ####### ##### ######### # ####### #
       # #   #   #   #   #             #   # #   #     # # #     #       # #   # #     #   #     #   #   #     #     # #     # #
 ########### # ##### ### ################# # # # ##### # ### ########### # # ### ##### # ####### # # # # # ### # ##### ##### # #
 #   #       #     # #     #           # # # # #     # #     #             #   #   #   # #     # # # # # # #   #     #     # # #
 # ### ########### # # ### # ######### # # # ####### # # ################# ### ### # ##### ### # # # # # ### ### ### ##### # # #
 #   #   #     #   #   #   #       # #   #   #       # # #               #   #   # # #   #   # # # # # #     # #   #     # #   #
 ### ### # ##### ####### # ####### # ### ##### ##### # # # ############# # # ### # # # # ### # ### ### ####### # # # ### # #####
 #             #       # # #       # #         #   # # # #     #     #   # #   # #   # #   # #   #   #       #   # # # # # #   #
 ### ######### ####### ### # ####### # ### ##### # # # # ##### # ##### ### ##### ##### # # # ### ### ####### ##### # # # # # # #
     #   #   #   #   #   # #         #   #     # #   # # #   # #     # #   #   #       # # # # #   #   #   #     # # # # #   # #
###### # ### ### # ##### # ############# ####### ### # ### # # ##### # # ### # ##### ### # # # ### # # # # ##### # # # # ##### #
     # #   #       #     #             #   # #   #   # #   # #       # #   # # #   #   # # # # # # # #   #     # # # #       # #
 ### ##### ####### # ##### # ### # ### # # # # ### ### # ### ######### ### # # # # # ### # # # # # # ######### # # # ### ##### #
   #   # #     #   #   #   # #   # # # # #   # # # #   #   #   #     #   # # #   # # #   # # #     # #         # # # # #   #   #
###### # ##### # ##### ##### ##### # # # # ### # # # ##### ### # ### ### ### ##### ### ### # ### ### # ######### # # # ### # ###
   #   #       #   #   #   # #     # #   #   #   #       #   # #   #   #     #   #   #   # #   #     #     #     # # #     #   #
 # # ### ######### # ### # ### ##### ##### ########### ##### # ### ### ######### ### ### # ### ##### ####### ##### # ##### ### #
 #   # #       #   #     # #   #       #         #   # #   # #     #   #   # #     #     #   #     # #       #     #   #     # #
 ##### ####### # ######### # ### ##### # # ####### # # # # # ####### ### # # # ### ### ########### # # ####### # ##### ####### #
     #     #   # #   #   #   #   #   #   #   #   # # #   # # # #   #     # # # #       #       #   # #   # #   #     #       # #
#### # ##### ### # # ### ##### # # # ######### # ### ### ### # # ######### # # ######### ##### # ####### # # # ##### ####### # #
   # # #         # # #         # # # #     #   #   #   #         #   #   # #   #     #   #   # #       # #   # #   #     #   # #
 ### # # ####### # ### ##### ### # ### ### # ##### ### # ######### # # # # ##### ### # ### # # ####### # ##### # # # # # # ### #
 #   # # #     # #   # #     #   #     #   #   #         #     #   #   # #   #   #   #     # #   #   # # #     # # # # # #     #
 # ### # # ### ##### # ####### ######### ####### ######### ### # ####### # # # ############# ### # # ### # # ### ### # # #######
         #   #       #       # #         #       #     #   # #   #   #   # #   #       #   # #   # #     # #   # #   # #   #   #
## ######### ############### # # ############### # ### # ### ##### # # ######### ##### # ### # ### ####### ### # # ### ### ### #
   #         #       #     # # #       #         #   #   #         # # # #           # #     #     #         #   # #     #     #
 # # ########### ### # ### # # ####### # ######### # ####### ####### # # # ######### # ############# ### # ####### ### # #######
 # #   #   #     # # # # #   #   #   # #     #   # # #     # #     # # # #     #   # # #       # #   #   #       #   # #   #   #
 # ### # # # ##### # # # ### ### ### # ##### # # ### # ### # # ### # # # ### ### # ### # ##### # # # # # ### ### ### # # # # # #
 # # #   #   #   # #   #       #     #   #   # #   # #   #   #   #       #   #   #   #     #   #   # # # #   #   #   # # #   # #
## # ######### # # ########### ######### ### # ### # ### ### ########### # ### ##### ##### # ######### # # ### # # ### ####### #
   #           #             #   #     #   # # #   #   # #   #     #   #   #   #   # #   # #   #     # # #   # # #   #       # #
 ### # # ########### # ##### ### # # ##### # # ####### # ### # ### # # # ### ### ### # # # ### # ### # ##### # # ### ####### # #
   # # #   # #       #   # #   #   #   #   # # #       # #   #   #   # # #   #   #   # # #   #     # # #   # # #   #     #   # #
## # # ### # # ##### ### # ### ####### # ### # # ####### # ########### # # ### ### ### # # # ####### # # # # # ### ##### #######
 # # #   #   #   # #   # #   # #       #   # #   #       # #   #       # # #   #   # # # # #   #     #   # # # # #     # #     #
 # ##### ####### # ### # # # # # ######### # ####### ### ### # # ####### # # ### ### # # # # ### ########### # # ### # # # ### #
 #     #   #   # #     # # # # #     #   #       #   #   #   #   #       # # #       # # # #   # #           # #     # # #   # #
 ##### # # # ### ####### # ### ##### # # ### # # # ### # # ####### ### # # # # ####### # ##### # # ########### ####### # ##### #
 #     # # #   # #       #   #       # #     # #   #   # #       # #   # # # #   #   # #     # # #   #         #       #       #
 # ##### # ### # # ######### ####### # ####### ##### ### ####### # ##### # # # ### # # ##### ### ### # ######### ##### #########
 # #   # # #   # # #           #   # # #     # # #   # # #       # #   # #   # #   #   #   # #   #   # #         #   # #   #   #
 # # # # # # ### # # ##### ##### # # # ##### # # # # # # # ####### # # ####### # ######### # # ### ### # ##### ### # # # # ### #
 #   #   # #     # # #     #   # # # #G  #   # # # #   # # #   #     #   #   # # #   #     # #   # #   #   #   #   # # # #   # #
 ### ############# # ####### # # # # ### # ### # # ##### # ### # ####### # # # # ### # ##### ### # # ### # # ####### # ##### # #
     #       #     #         # # # #   # # # # #     #   #   # #       # # # # # #   # #     # # # #   # # # #       #     # # #
 ##### ##### # ######### ### ### # # ### # # # ####### ##### # ### ##### # # # # # ### # ##### # # ### ### # # ########### # # #
 #   # #   #   #   #     #   #   # #   #   # # #     #   #   #         #   # # # # #   # #   #   # # # #   #   #       #   #   #
## # # # ####### # # # ### # # ####### ##### # # ### ### # ####### ### ####### # # ### # ### ##### # # # # ########### # ##### #
   #   #         #   # #   # #     #   #     # #   #   # # #     #   #       # #   #   #   # #     #   # #       #     #   # # #
 ##################### # ### ##### # # # ### # # ##### # # ### # ### ####### # ##### # ### # # ######### # ### # # ####### # # #
   #           #       # # # #   #   # # #   # # #   #   # #   #   #   #   # #       # #   #   #         #   # #   # #     # # #
## ##### # ### # # # ### # # # # ##### # ##### ### # ### # # ##### # ### # # ######### # ####### # ######### # ##### # ##### # #
 #   #   # # #   # # # # # #   #       # #     #   #   # #   #     # #   #   #         # #       # #     #   #       #     #   #
 ### # ### # ##### # # # # ##### ##### # # ##### ##### ######### ### # ####### ######### # # # ### # ##### ### ########### # ###
 #   #   # #   #   #   # #       #     # #     # #             #   # #       # #         # # # #   # #   # # #   #   #   # # # #
 # ####### ### # # ##### ### ##### ### # ##### # # # ######### ### # ####### # # ########### # # ### # # # # # # # # # # # # # #
 #     #   # # # #     # # # #     #   # #   # # # #   #     #   # #     # # # # #           # #   #   #   #   # # #   #   #   #
 ##### # ### # # # ##### # # # ### ##### # # # # ####### ####### # ##### # # # # ########### # ### ############# # ########### #
 #     #   #     #   #   #   # #   #     # # # #       # #     # # # #     #   #   #   #     #   #     #       # #       #   # #
 # ####### ######### # ####### # ### ##### # # ####### # # ### # # # # ########### # # # # ##### ##### ####### # ####### ### # #
 #       #       #   # #     # # #   #   # #   #   #   # #   #         #   #   #   # #   #     #     #   #   #   #     #     # #
 ####### # ##### ##### # ### # ### ### # # ##### # # ### ### ########### # # # # ### ######### ##### ### # # ### # ########### #
 #       #     # #     # #   #     #   #   #   # # #     #   #   #     # #   #   # # #     #   #   # #   # # #   #     #       #
 # ####### # ### # ##### ########### ####### ### ########### ### # ### # ######### # # ##### # # # # # ### # # # ##### ### ### #
 #   #     # #   #     #     #     # #   #       #   #     #     # # #   #     #   # #       # # # # #   # # # #     #   # #   #
 ### ##### ### # ##### ##### # ### # # # ####### # # # ### ##### # # ##### ### # ### ########### # ### # # # # # ####### ### ###
 #   #   # #   # #   #     # # #   # # #   #       # #   #         #       # # # #     # #       #   # # # # # #   #     #   # #
 # ### # ### ### ### ##### # # # # # # ### # ##### ############# ##### ##### # # # # # # # ######### ### ### # ### # ##### ### #
 # # # #     #       #   #   # # # #   # # # #   #     #         #   #       # #   # #   # #       #   #   #   #   #   #       #
 # # # ####### ####### # ##### # ####### # ### # # ##### ####### # # ######### ##### ##### # ### ##### ### ### # ##### # #######
 # # #   #   #         #       #   #     #   # # #   #   #   # # # # #       #       #     # #   #   #     #   # #     # #     #
 # # ### # # ##### ######### ### # # ####### ### ### # ### # # # # # # ##### # # ### # ##### ##### ######### ### # ##### # ### #
   #   #   #     #   #     #   # # #       #   #   # #     #   # # # #     # # # #   # #   #           #   # #   #   #   #   # #
#### # ######### # # # ### ### # # ####### ### ### # ########### # ### ### # # # # ### # ####### ### # # ### # ##### # ##### ###
   # #   #       # #   #   # # # #       # #   #   # #           #   # #   # # # # # # #   #     #   # #   # #       #         #
## # ### # ####### ##### ### # # ### # # # # ### ### # ######### ### ### ### # # # # # ### ##### # ### ### # ################# #
   #   # # #   # #     # # #   # #   # # #   # # #   #   #     #   #   # #   # # #   #   #       # #   # #     #     #       # #
 ##### # # ### # ##### # # ####### ### # ##### # # ##### ##### # # ### # # ### # ####### ######### # ### ### # # # # # ##### # #
 #   # # #     #       # #       #   # # #     # #   #   #   #   #   #   # # # # #   # # #       # #         #   # # # #     # #
 # ### # ######### ##### # ##### ### # # # # ### ### # ### # ##### ####### # # # # # # # # ##### ######### ##### # # # # ##### #
 #   # #   #       #   # #   # # #   # #   #   # # # # #   # #         #   #   #   #   # # #   #         # #   # # # # # #     #
 ### # # # ####### # # # ### # # # ### ####### # # # # # ### ########### ##### ######### # # # ######### # # # ### # ### # ### #
 #     # #   #   # # # # # #   # # #   #     # # # # #   # #     #       #     #         # # # #       #   # # #   #   #   # # #
 ####### ### # # # # ### # ### ### # # ##### # # # # ##### ##### # ############# ######### # # ##### # ##### # # ### # ##### # #
         #     #   #     #         # #       #                 #   #             #         # #       #       #   #   #         #
