################################################################################################################################
#           #     #     #     #         #   #   #   #       #               #         #     #   # #               #   #   #   # 
# ######### # ### # # ### ### # ####### ### ### # # ##### # ### ########### # ### ##### ### ### # # # ##### ##### ### # # # # # 
# #   #   #   #   # #   #   # #   #     #   #   # # #   # #   #   #   #     #   #       # #         #     #     # #   # #   #   
### # # # ##### ### ### ### # ### ####### ### ##### # # # ### ##### # # ##### # ### ##### ######### ##### # ### # # ####### ####
#   #   #   # # # # # #   # #   # #     #   #   #   # # # # #       # #   # # #   #       #       # #   # # #   # #       #   # 
# ######### # # # # # # ### ##### # ### ### ### # ### # # # ######### ### # # ### ##### # # ##### # # ### # # ### ####### ### # 
# # #       #         #     #     #   # # #   # #     #   # #               #   #   #   # # #   # # # #   # # # #   #     #   # 
# # # ####### ####### ####### ####### # # ### # ########### # ########### # ### ### # ##### # # # ### # ##### # ### # ##### ### 
# #   #         #   #   #   #       # # #     #       #   #   #   #     # # #   #   # #     # # #   #   #     #   # #   #       
# ######### ##### # ##### # ####### # # # ########### # ### ### ### ### # ### ####### # ##### # ### ##### # ##### # ### # # ### 
#         # #     #       #         # # #     # #   # #             #   #     #   # # # #     #   #   #   #   #   #     # #   # 
######### # # ####################### # ##### # # # # ######### ### # ##### ### # # # # ######### # # # ##### # ######### ### ##
# #   # #   #     #                   #   #   #   # # #       #   # #     # #   # # # #         # # # # #     # #           #   
# # # # ### ##### ####### ############### ### # ##### # ##### # # # ##### ### ### # # ######### # ### # # ##### # ######### ### 
# # #   #   #   #         #         #   #   # #     #   #       # #     #     #   # # #         #     # #     # #         # #   
# # ##### ##### ########### ##### # # # ### # # ### ##### ##### # ############# ### # # ############### ##### # ### ##### # ### 
#     #   #     #   #       #     #   # #   # #   #       #   # #     #       #   #   # #   #               # #   #     # #   # 
# ##### ####### # # # # ############# ### ### # ########### # ####### # ##### ### ##### # # # ########### # # ### # ### # ### ##
# # #   #     # # # # # #           # #   #   #   #         # #       # # #   # # #     # #   # #         # #       #   #   #   
# # # ### ### # # ### # # ######### ### ### ### # # ######### # ####### # # ### # # ##### ##### # # ################# ####### # 
#   # #     #   # #   # #     #   #   #   #   # # # # #     # #       # #   #   # # #     #   #   # #   #       # #   #     # # 
### # # ######### # ######### # # ### ### ### # # # # # ### # ####### # ##### ### # # ####### ### # # # # ##### # # ### # # ### 
# # # #       #   # # #       # #       #   # # # # #   # # #   #     # #   # # #   #   #   #   # #   # # #   # #   #   # # #   
# # # # ##### # ### # # ####### ####### ### # # ### ##### # ### ####### ### # # ##### # # # ### # ####### # # # ##### ### # # ##
# # # #     # #   #   # #   #   #     #   #     #   #   # # # #       #   # #   #     #   #     # #     #   # #     # #   # #   
# # # ### # ##### # ### # # # ### ### ##### ##### ### ### # # ####### ### # ### ### # ############# ### ##### ##### ### ### ### 
#   # #   # #     # #   # #   #   # #       #     #                 #     #         #   #           # #     #     # #   #       
# ### # # ### ##### # ### ##### ### ######### ############# ############# ######### ##### ########### # ########### # ##### ####
#   # # # #   # #   # #   #   #     # #     # #                   #     # #   #     #   # #         # # #      S#   #     # #   
# ### # # # ### # ### # ##### ##### # # ##### # # ######### ##### # ### ### # ####### # # ##### ### # # # # # ### ####### ### # 
#     # #       # #   #   #   #   # #   #     # #   #       #   # #   #   # #   #     # #     # #   # # # # # #   #       #   # 
# ########### ### # ##### # ### # # # ### ##### ### # ####### # ######### # ### # ########### ### ### # # # ### ### ####### ### 
# #           #   #     # # #   #   # #   #   #   # #       # #         # # #   # #     #   #   #     #   #     # # #   #   #   
# ### ####### # ####### # # # ####### # ### # # ### ####### # ######### # # # ### ### # # # ### ##### ########### # # # # ### # 
# #   #   #   # # #   # #   #   #     #   # # # #   #       #   #   #   # # #     #   #   #   # #       #   #       # #   # # # 
# # ### # # ### # # ### ####### ##### ### # # ### ######### ### ### # ### # ####### ######### # # ##### # # ######### ##### # # 
# # #   # #           # #     #         # # #   # #                 #   # #   #     #       # # # #   #   # #         #     # # 
# # # ### # ######### # # ### ######### # # ### # # ############### ### # ### # ##### ##### # # # # # ##### # ######### ##### # 
# # #   #   #       # # # #   #       # # # #     #     #   #   # #   #   #   # #   #     # # #   # #   #   #         #   #   # 
# # # ##### # ##### # # # # ### # ### # # # # ########### # # # # ### ##### ### # # ####### # ####### # # ########### ### # ### 
#   # #   # #   #   # # # #   # #   # # #   #   #       # #   # #         #   # # #   #   #           #             #     # #   
####### # ##### # ### # # ### ##### # # # ##### # ##### # ##### ######### ### # ##### # # # # # # ################# ##### # ####
#       #       # #   #   # #     # # #   #   # # # #   #   # #     #   #       #   #   #   # # # #     #   #       # #   #     
# ############### ### ##### ##### ### ### # # # # # # # ### # ##### # # ######### # ### ##### # # # ### # # # ####### # ####### 
#     # #   #   #   #     # #   #       # # # # # # # # #   #     #   #     #   # #   # #     # #   #   # # #   #   # #     #   
##### # # ### # ### # ### # # # ####### # # # ### # # ### ##### # ######### # # # ### ### ########### # # # ### # # # ##### ####
#     #       #   #   #     # #   #   #   # #     # #   # #   # # #   # #   # # #   #   #           # # # # #   # #       #     
# ############### ### ##### # ### # ##### # ####### ### # ### # # # # # # ### # # ##### # ######### # ### # # ########### ##### 
# #       #           #   # #   # #   #   # #       # # # #   # #   #   # #   #   #     # #       # #   # # #           #   # # 
# # ##### ############# # # ### # ### # ### # ### # # # # # ### ### ##### # ####### ##### # ##### # ### # # ########### # # # # 
# # #     #             #     # #     # #   # #   # # # # # # # #   #     # # #     #   # #   #   # #   # #       #   #   # # # 
# # # ##### ######### ####### # ####### # ##### ### # # # # # # ### # ##### # # ##### # ##### # ##### ### ####### # # ##### # # 
#   # #     #     #   #       #         # #   # #   # #   # #   #   #     # # #     # #   #   #     #   #   #   #   #   #   # # 
##### # ##### ### # # # ##### ######### # # # # # ### ##### ##### # ##### # # ##### # ### ######### ##### # # ######### # ### # 
#   # #     # # # # # #   #       #     #   # # # #       #       #     #     #   # #   # #     # # #   # # #     # #   # #   # 
### # ##### # # # ### ### # # ### ### # ##### # # # ##### ######### ########### # # ### # # ### # # # # ### ##### # # ### # ### 
#   #   #   #   #   # #   # # # #     #   #   # #   #             # #   # #     # #     #   #   #     #   #     #   #   #     # 
# ##### # ######### ### ### # # ##### ##### ##### ############### # # # # # ################# ########### ##### ### ### # ##### 
# #     #         # #   #   # #       #     #   # #     #   #   #   # #   #     #   #         #       # # #     #     # # #     
# # ### ### ####### # ### ### ####### # ##### # ### ### # # # # # ### ######### # # # ######### ##### # # ########### # # # ####
#   # #   #         #   #   # #     # # #     #     #   # #   # #     #   #   #   # # # #     # #     #   #       # # # #   #   
##### # # ############# ### # # ### ### # ########### ### ##### # ####### # ####### # # # ##### # ##### ### ##### # # # ### # # 
#   #   #   #   #         # #   #   #   # #         # #     #   #   #             #   #   #   # #   #   #   #   # #   #   # # # 
# ####### # # # # ##### # # ######### ##### ####### # ##### # ##### # ####### # # ##### ### # # ### # ### ### # # # ##### # # # 
#         # # #   #     # # #   #     #   #     # # #     # # #       #   #   # #       #   #   #   #   # #   # # #           # 
### ####### # ##### ####### # # # ##### # ##### # # ##### ### # ####### # # ####### ##### ####### ##### # # ##### ##### ##### ##
#   #   #   # #     #   #   # # # #     # #     #   #         #   #     # #       # #     # #   # #   # # # #     #     #   #   
# ### # ##### # # ### # # ### # # ### ### # ######### ####### ### # ##### ####### # # ##### # # # # # # # # # ####### ### # ### 
# # # #       # #     # #     # #     #   #   #       #     #     #     # #   #   # # #   #   #   # # # # # # #     # #   #   # 
# # # ######### ############### ####### ##### ### ##### ### # ########### # ### ### # # # ######### ### # # # # ### ### ##### # 
#   # #         #     #   #   #       #   # #   #       #   #       #     #   #   # # # #           #   #   # #   #   # #   #   
##### # ##### ### ### # # # # ### ####### # ### # ####### ########### ##### # ### # # # ####### ##### ####### ### ### # ### ### 
#     #   #   #   #   # #   #   #       # #   #   #     #   #         #     # # # #   #   #   #       # #   # # # # #   #   # # 
# ####### # ####### ### ####### ##### # # ### ### # ### ##### ######### ##### # # # ### ### # ##### ### # # # # # # ##### ### # 
# # #   # #         #   #   #   #   # # #   #     # #   #   # #         #   # # # #     #   # #   #     # #   #   #           # 
# # # # ##### ####### ### # ### # # # # ### ##### # ##### # # # ######### # # # # ####### ##### # # # # # ##### ##### ######### 
# #   #     # #     # # # #   #   #   #   #       #   #   # # #     #     # #   #       #       # # # # #   #   #   #           
# ######### # # ### # # # ### ################### ### # ### # # ### # ##### # ######### ######### ### # ### ##### # ### ########
#           # #   # #   # # # #   #       #     # #   # #   # # # #   #   # #         #   #       #   #   #   #   #   #   #     
############# ### # ##### # # # # # ##### # ### # # ### ##### # # ##### # # ########### ### ####### ### # ### # ##### ### # ####
#                 #   #G  #   # #   #   #   #   #   #   #     # #       # #     #     # #   #       #   # #   # #     # # # #   
### # # ### # ######### ####### ##### # ##### ### ### ### ##### ####### # ##### # ### # # ### ### ##### ### ##### ##### # # # # 
#   # # #   #     #     #       #     # #   #   #   #   # # #           # #     #   # # # #     # #   #     #               # # 
# ### # # ####### # ##### ######### ##### # ### ### ### # # # ##### ##### ######### ### # ##### # # # # ##### ########### # # # 
# #   # #       # #       #         #     #   #   #     # #   #   # #   # #   #   # #   #   #   #   # #     #   #       # #   # 
### ############# ############# # ### ##### ##### # ##### ##### # # # # # # # ### # # ##### # ####### # ### # # # ##### ####### 
#   #   # #     #   #   #     # #     #   #               #     # # # # # # #       #       # #       #   # # # #   # #   #   # 
# ### # # # ### # ### # # ### # ####### ######### ######### ##### ### # # # ####### ########### ####### # ### # ### # ### ### # 
# #   # # #   # # #   #   #   #         #       #       #   #   #   # # #   #             #   # #   #   #   # #   #   # # #   # 
# ##### # ### # # # ####### ### ##### ### ##### ### ##### ### # ### # # ##### ########### # # # # # ### ### # ### ### # # # ### 
# #         # # # # #     # # #     #   # #     #   #   # #   # #   # #   #   #   #     # # # # # #       # # # #     # # #     
# # ######### # ### ##### # # # ### ##### # ##### ### # # # ##### ### ### # ### # # ### # # ### # ######### # # ####### # ##### 
#       #     #   #     # # #   # #       # #   #   # #   #       #   # # #   # #   # #   # #   #     #   #   #         # #     
######### ####### # ### # # ### # ######### # ##### # ############# ### # ##### ##### ### # # ### ### ### ######### ### # ### # 
#   #     #     # #   #   #               # #       #   # #     #   #           #   #   # #   #   # #     #     #   # # #   # # 
# # # ### # ### # # ########### ######### # ####### ### # # ### # # ### ########### ### # ####### # ####### ### # ### # ### ### 
# # # #   # # # # # #       #   #     #   #   #     #   #   # #   #   # #     #   #     #         #   #   #   #   #   # # #   # 
# # # ### # # # # ### ##### # ### ### # # ### # ##### ####### ### ### ### ### # # ##### ### ### # ### ### ### ##### ### # ### # 
# # #   # # # # #   #     # # #   # # # # #   # #   #   #         # #       # # #     #     #   #   # #     # #   # #   # #   # 
# # ### ### # # ### ##### # # # ### # # # # ##### # ### # ### ##### ######### # ##### ### ### ##### # # ##### # # # # ### # ### 
# #   # #   # #   #   #   # #       # # # # #     #     #   #   #   #     #   # #   #   # #   #     # #     #   #   #     # #   
# ### # # ### ### ### # ### # ####### # # # # ########### # ### # ### ### # ### ### ### # # ### ##### ### # ############# # ### 
# #   # #   #     # # #   #   #   #   # # # # # #       # #   # #   #   #   #   #   # #   # #   #   #   # # #       #     # #   
# ##### ### ####### # ####### # # # ### # # # # # ##### ##### # # ##### ##### # # ### ### # ##### # ### # # # ##### # ##### # ##
#   #   #   #     # #       #   # # #   # #   #   #   #     # # # #   #     # #   # #     #   #   #     # # # #   #   #     #   
# # ##### ### ### # ####### # ### # ############### ####### # # # # # ### # ####### # # ##### # ######### # # # # ##### ####### 
# #     # #     #       #   # #   #     #     #   #           #   # #   # #   #   #   #   #   #     #   # #     # #   # #       
# ##### # # ### ####### # ### # ####### # ### ### ### ############# ### ##### # # ### ### # ####### ### # ######### # # # # ####
#   # #   # # #     #   # #   #     #   # # # #   #   #       #   # # #     # # # #   # # #   #   #       #         #   # # #   
### # ##### # ##### ##### # ####### ##### # # # ### ### ##### # # # # ##### # ### # # # # ### # # ##### ### ############### # ##
#   #     # #   #   #   # #     #   #   # #   #     #   #   # # # # #     #   #   # #   # # #   #     # #   #               #   
# ####### # # # ##### # # ##### # ### # # ########### ### ### # # # # ######### ### ##### # ######### # # ##### # ##### # ##### 
#     #   #   #       # # #   # #     #   #   #       #   #   # # # # #   # #   #   #     #         # # #     # #     # # #     
# ### # ######### ##### # # ### ########### # # ####### ### ### ### # # # # # ### # # ######### ### # # ##### ### ##### # # ####
#   #   #       # #   # # # #       #       # #     # #   # #       #   # # #     # #   #     # #   #   #   #   # #     #   #   
### ##### ##### # # # # # # # ##### # ####### ##### # ### # ############# # ####### ### ##### ### ####### # # # ### ### ##### ##
#     #   #   # # # # #   #   #   # # # #   # #     # #   #   #   #                   # #     #   #     # # # # #   #   #   #   
# ##### ### # # # # # ##### ### # ### # # # # # ##### # ##### # ### ############### # # # ##### ### ### # # ### # ####### # ### 
# #   # #   #   #   # #         #   # #   # # # #       #     #     #           #   # #   #           # # #     # #       # #   
# # # ### ########### # ########### # # ##### # # ####### ########### ######### ### # ##### ### ####### # ####### # ####### # ##
# # #     #   #         #         #   #     # #   #     #       #     #   #     #   # #   # #   #       #       #     #   # #   
# # ######### # ######### ####### # ####### # ### # ### ####### # ##### ### ##### ### # # # # ################# ##### # # # ### 
#   # #               #   # #   # #         # #   # # #     # #   #   #     #   # #   # # # #   #           # #     # # # #   # 
# ### # ### # ####### # ### # # # ########### # ### # ##### # ##### ######### # # # # ### # ##### ######### # ##### ### # ### # 
# #     #   #       #   #   # #   #     #   #   #   #     # #     #   #     # # # # #     #   #   #   #     # #   #     #   # # 
# # ##### ### # ########### # ##### ### # # ##### ####### # # ### ### # ##### ### # ####### ### ### # # ##### # ########### # # 
#   #     #   #             #         #   #             #   #   #                 #                 # #       #             #   
