################################################################################################################################
################################################################################################################################
#   #     #     #       #       #   #   #             #             #                               #   #       #     #     #   
### # ### # ### # ### ### # ##### ### # # ####### # # # ########### # ### # # ### ################# # # # # ##### # ### ### # # 
#   #   # # #   #   #   # #       #   #         # # # #   #   #   #   #   # #   #   #   #         #   # # # #     #       #   # 
# ##### # # # ##### ### # ######### ############# # ##### # # ### ####### # ### ### # # ##### ### ##### # ### ################# 
# #   # #   #     # #   # #   #   #   #   #     # # #     # #   #         #   # # # # #   #   #   # #   # #   #     # #       # 
# # # # ######### # ##### # # # ##### ### # ### # # # ##### ### ### # ### # # # # # # ### # ### ### # ### # ##### # # # ##### # 
#   # # # #     #           #   #   #     #   #   # #     # # #   # # #   # # #   # #   #   # # #   #   # #       # # # #     # 
# ### # # # ### # ############### # ##### ### ########### # # ### # # ##### # ##### ### ##### # # # ### # ######### # # # ######
#   # # # #   #   #               #   #   #   #         #   #     # #     # # #   # #   # #   # # # #         # #     # # #     
### ### # ### ##### ################# # ### ### ####### ################# # ### # # # ### # ### # # # ### # # # # ##### # ##### 
# #   #   # #     #   #             #   # #   #   #   #   #             # #   # # # #   # #   #   #   #   # #   #   #   #     # 
# ### ##### ##### ### ### # ####### ##### ####### ### ### # ### # ##### # ### # # # # # # ### ##### ### ### ### ### # ##### ### 
#   #     # #   #   #   # #   #   #       #     #   #     # #   # #   #     #   # # # # #           #   #   # # #     #   #     
### ##### # ### ### ### # ### # # ####### # ### ### ######### # # # # ### # ####### # # ######### ### ### ### # # ### # # ### ##
#         #     #   #   #   # # #       #   # #   #     #     # #   # # # #     #   # #       #   # #   #   # #   #   # #   #   
### ##### # ### # ### ####### ####### # ##### ### ##### ### ### ##### # # ####### ### ####### # # # ##### # # # ### # # ### ### 
#   #   #   #   #   #       #       # #     #   #     # #   #       # #   #   #   #       #   # # # #   # #   # #   # # # # #   
# ### # ### # # ### ####### ##### # ### ####### ##### # # ### # ##### ##### # # ########### ### ### # # ######### ### # # # # ##
#   # #   # # # # #       #     # # #   #     #   # # #   #   #     #     # # # #         #   #     # #     #     # # #   # #   
# # # ### ### # # ####### ##### ### # ### ####### # # ##### ####### ##### # # # ######### # # ####### ##### # ##### # ##### ### 
# # #   #   # #               #     #           # # #       #           # # # # #         # #       # #   # #     # #     # #   
### ### ### # ####### ### # # ############# ### # # ##### # # ##### ### # ### # # ######### ####### # # # # ##### # ##### # ####
#   # # # #   #       #   # #             # #   # #       # # #       # #     #   #     #       #   # # # #     # #       #     
# # # # # ##### ####### # # ### ######### ### # # # ### ### # # ##### ############# ### # ##### # ### # ####### # ### ######### 
# #   #   #   #   #     # #   # # #   # #     #     #   #   # #     #         #   # # # # #     #   # #       # #   # # #       
# # ######### ### ### # ####### # # # # ##### ####### ### ### # ### ########### # # # # ### # ####### # ####### ### # # # ######
# #   #   #   # #   # #   # #   #   # #       #     #   # # # #   #         #   #   #   #   # #       #   #   #     #       #   
# ##### # # ### ### ### # # # ####### ######### ### ##### # # # ####### ### # ########### ### # ######### # # ##### ####### # # 
#     # # #   #   #   # # # #       #   #     # # #     # # # # #   #   #   # #       #   #   #   #     #   #       #   #   # # 
# ### # # ### ### ### # # # ####### ### # ### # # ##### # # # ### # # # ##### # ##### # ######### # ### ##### ####### # ### # ##
#   # # # # #   # #   # #   #     #     # # #   # #   #   # #   # # # # #     # #     #   #       # #   #   #   #   # #   #     
# # # ### # ### # # ####### # ########### # ##### # # ##### ### # # # ### ####### ####### # ####### ##### # ##### # # ### # ### 
# # #     #   #   #   #   # #   #         # #   #   #   #     #   # #   #       #         # #   #   #     #       #   #   # #   
# ######### # # ##### # # ##### # ######### # # ####### # ### ##### # # ####### ### ##### # # # # ### ####################### # 
# #         #   #   #   #       # #     #   # #       #   # # #     # #       #   # #   # #   #   #   #     #                 # 
# # ####### ##### # ######### ### ### ### ### ############# # # ##### ####### ### ### # # ######### ##### # ### ####### ####### 
# #       #       # #   #   #   #   #     # #     # #       # # #           #   #   # # # #       #       #     #   #   #       
# ####### ########### # # # ### ### # ##### ##### # # ### ### # ######### ### ##### # # # # ################# ### # ##### ##### 
#         #       #   #   #   # #   #   # # #   #   # # #   # # #       # #   #   #   # # #   #       #   #   #   # #     #   # 
# ######### ### # # ######### ### ##### # # # ### ### # ### # # # ##### # # ### ####### # # ### ##### # # # # # ##### ##### # # 
#     #       # # #         # #   # #   #     #   #   #   #   #   # #   # #   #     #   # # #   # #   # # # # #       #     #   
### # # ### # ### ######### ### ### # ####### # ### ##### ######### # ####### ##### # ### # # ### # ### # ### ######### ####### 
# # # # # # #   # #   #   #     #   #       #   #   #   #         #   #     #     # # #     # #   #     #   # #       #       # 
# # # # # # ### # ### # # ####### # ####### # ### ##### # ####### ##### ### # ### # # ####### # ########### # # ######### ##### 
#   #     # #   #   # # #         #       # #   #     # # #   #       # # # #   #   #   #     #   #       # #       #   # #     
########### # ### # # ### ########### ### # ### ##### # ### # # ##### # # # ### ####### # ####### # ##### # ### # ### # ### ### 
#     #   # #   # # #   # #     #   # # #   #         #     # # #     # # #   # #     # #   #   # #   #   #   # #   # #   # #   
# ### # # # ### # # ### # # ### # # # # ####### ############# # # ##### # ### # # ##### ### # ### ### # ##### ##### # ### # # ##
#   # # # #   # # # #   # #   #   # #   #     # #   #       #   # #     # #   #     #   #   #         # #   #     # # #   # #   
### # # # ### # # # # ### ### ##### # ####### # # # ####### ##### # ##### # ######### ### ######### ##### # ##### # # ######### 
# # #   # #   # # #   # #   # #   # # #       #   # #       #     #   #   #           #   #   #   #     # # # #   # #           
# # ####### ### # ##### ### # ### # # # ####### ### # ####### ####### # # ############# # # # # # ##### # # # # ### ########### 
# #   #   # #   #           #   # # #         #   #     #       #   #   #   #           # # #   #     #   #   #   #       #     
# ### # # # # ### ####### ##### # # ##### # # # # ##### # # ### # ######### ############# # ######### ##### ##### ######### ### 
# #   # #   #   # #     #   #     #     # # #   #     #   #   # #   # #   # #   #       # # #           #   #     #   #     #   
# # ### ####### # # ### # ### ######### # # # ####### ### ### ##### # # # # # # # ##### # # ########### # # # ##### # # ##### ##
# #   # #   #   #   #   #   # #       # # # #       #   #   #         # #   # # #     # # # #       #   # # #       #   #   # # 
# ### # # # ##### ### ##### # # ##### # ### ####### ### # # ########### ##### # ####### # # # ##### ### # # ############### # # 
#   # #   # #   #   # #   # # #     #   #   #     #   # # #   # #     # #     # #       # # #   # #   # # #   #             # # 
### # ##### # # ##### # # # # ##### ##### ### ### ### # # # # # # ### # # ##### # ####### # ### # ### # # # ### ### ######### # 
#   #   #   # # #   #   # # #     #     #   #   # # # # # # #   #   # # #   #   #     #   #   #   #   #   # #   # # #   #   # # 
# # ### # # # # # # # ### # ##### ##### ### ##### # # # # ######### # # ### ######### ### # ##### ######### # ### # # # # # # # 
# #     # # # #   # #   # # #   # #   #   #       #   # # #     #   #   # #   #     #     #     #   # #     #     # # #   #   # 
# ##### # # # ##### ##### # ### # ### ### ############# ### ### # ####### ### # ### ####### ### ### # # ### ##### ### ######### 
# #   #   # #   # # #     #     #   #     #             #   # #   #         # # # #   #       #   # # #   #         #     #   # 
# # # ##### ### # # # ############# ####### ############# ### ##### ##### ### # # ### ####### # # # # # # ### ##### ##### # # # 
# # #     #   # #   #       #     #  G#     #           #     #     #   # #   #   #         # # # # # # #   # #   #     #   #   
### ##### ### # ########### # # ##### ##### # ######### ##### # ##### # # # ####### ####### # # ### # ##### # # # ### # ####### 
#   #   # #   #   # #     #   #     #   #   # #   #   #   #   #     # # #   #   #   #     #   # #   #   #   # # #   # #     # # 
# ### ### # ##### # # ### ######### ### # # # # # # # ### # ####### ### ####### # ### ### ##### # ##### # # ### ### # ##### # # 
#   #     #   #   #   #   #     # #     # # #   #   # #   #   #     #       #   # # # #   #   # # #   #   # #   #   # # #   # # 
### # ##### ### ####### ### ### # ####### ############# ##### # ##### ### # # ### # # # ### # # # # # ##### # ### ### # # ### # 
#   # #   # #   #           #               #           #   # # #   #   # # # #     # #   # #   # # #     # #   #   # #   #   # 
##### # # # # ### ############# ########### # ########### # # # # # # # # ### # # ### ### # ##### # ##### ##### ### # # ### ### 
#   #   # # #   # #   #   #     #         # #   #   #     # # # # #   # # #   # # #   #     #   # #     #       # #   #     #   
# # ##### # ### # # # # # ####### ####### # ### # # # ### ### # # ##### # # ### # # ### ##### # # ############### ######### # ##
# # #     # #   # # #   #             #   #   #   # #   #     # # #   # # #   # # # #     #   #   #       #                     
### # ##### # ##### ################### ### # ##### ### ####### # # # # ##### # ### ##### # ####### ##### ####### # ########### 
#   #   #   # #     #       #     #     #   #     #   #   #       # #   #     # #   #   # # #   #   #   #   #     # #   #   #   
# ##### ### # # ##### ### # # ### # ################# ### # ####### ### # ##### # # # # # # ### # # # # ### # ##### # ### # # ##
# #   #   # # #     # #   #   #   # #     #       #   #           #   # # #   # # # # # # #   # # # # # #   #     #   #   # #   
# ### ### # # ##### # ############# # ### # ##### # ### ######### # # ### # # ### ### # ##### # ### # ### ### ######### ### # # 
#   #     # # #       #     #       # # # # #   #   # #       # # # #     # # #   #   #       #     #   #   # #     #   #   # # 
### ##### ### # ####### ### # ####### # # # # # ##### # ##### # # # ######### # ### ################# # ### # # ### # ### ### # 
#   #   # #   #   # #   #     #       # #   # #         #   # #   # #   #   #   #   #     #   #     # # #   # #   # # #       # 
# ### # # # ##### # # ######### ####### ##### # ####### # # # ##### # # # # ### # ### ### # # # ### # # # ####### # # # ########
# #   #         #   # #         # #   # #   # #       # # # # #     # #   #   # # # #   # # #   # #   # #     #   #   #S# #     
# # ##### ##### ### # # ######### # # # # ### ####### # ### # # ##### ####### ### # ##### # ##### ##### ##### # ####### # # ### 
#   #   # #   #     #   #         # #   #     # #     #     # #       #     #     #   #   #     #     # #     # #   #   # # #   
####### # # # ##### ##### # # ##### ##### ##### # ########### ### ##### ########### # # ####### ### # # # ##### # # # ### # ####
#   #   #   #     #       # #   #   #     #   #   # #       #   #                   # #       #   # # #   #     # # # #   #     
# ### ########### # ####### ##### ### ### # # ##### # ##### ### ### # ####### ##### # ####### ### # # ########### # # ### ##### 
#         #       #       # #   # #   # #   #   # #   #   # #   #   #   #     #   # #         #     #   #       # # #   #   #   
######### # ####### ##### # # # # # ### ####### # # ### # # # ### ##### # ##### # # ##### ##### ### # ### ##### ### ### # ### ##
#       # #   #   #   #   #   #   #     #   #   # # #   #   # #       # #     # # #     #         # # #   #   #     #   # #   # 
# ##### # ### ### # # # ############### # # # ### # ######### ####### # ##### # # ##### ##### # # ### # ##### ######### # # ### 
# #   #   # #   #   # #               # # #   #   #         #     # # #   #   # # #   #   # # # #   #   #   # # #     #     # # 
# # # ### # ### ### # ######### # ### # # ####### ######### ##### # # ### ##### # # # ### # # # ### # ##### # # # ### ##### # # 
#   #   #   # #   # # #       # #   #   # #     #         #       # #   # #     # # # #   #   # # # # #       #   # # #   # #   
####### ### # ### # # # ####### ### ##### ##### ##### ############# ### # # ##### # # ######### # # # # # # ### ### # # # # # ##
#     #   #   #   # #   #       # #     #   #   #   #   #   #     #   # #   #   #   #     #     # # #   # #   # # # #   # #     
# ######### ### ### ##### ####### ##### ### # ### # ### # # # ### # # # ##### ########### # ##### # ##### # # # # # ##### ### # 
#   #   #   #   #   #   # #     #   #   #   # #   # # # # # # #     # #     #   #   #     #       #   #   # #   # #     #   # # 
### # # # ### ####### # # # ### ### # # # ### # ### # # # # ### ########### ### ### # # ############# ##### ##### ##### ### # ##
#   # #   #   #     # #   # # #   #   # #   # # #   #     #     #           # # #   # # #   #   #   #   #   #         #     #   
# ### ##### ### ### # ### # # ### ######### # ### ####### ####### ########### # # # # ### # # # # # ### # # # # # ### ######### 
#   #     #     # # #   # #   #   #       #   #   #     # #     #   #   #     # # # #   # #   # # #     # # # # #   #         # 
### ### ######### # # # ##### # # # ##### ##### ##### # # # ### ### ### # ##### ### ### # ##### # ####### # # # ### ######### # 
#       #       # # # #       # # # #   # #     #     #   #   #     #     #   #       # #   #   # #     # #   # # #         #   
# ##### # ##### # # ########### ### # ### ##### # ##### ##### ####### ##### # ####### # ### # ##### ### ####### # ####### # ####
# #   #       #   #     #     #   # # #   #   #   #   # #     #     #   #   #       # #   # #   #   # #   #   # #       # # #   
# # # # ##### ######### # ####### # # # ### # ##### # # # ##### ### # # # ######### # ### # ### # ### ### # ### ####### # # # # 
# # # # #   #   #       #         #   # # # #       # # #     #   # # # #   #       # # #   # # #   #     #     #     #   # # # 
### # # # # # ### ########### ######### # # ######### # ##### ##### # ####### ####### # ##### # ##### ########### ### ##### # # 
#   # # # #   #   #           #         #   # #   #   #     #       #   # #     #   # #     # #   #   #   #   #   #         # # 
# ### ### ### # ######### # ### ############# # # # ##### # ########### # # ##### # # ### # # ### # ### # ### ##### # ### # ### 
# #     # #   # #   #   # # #   # #         #   # #       # #   #   # # # # # #   # #   # # #   # #   # #   #   #   # #   # #   
# ##### # # ### # # # # ### # ### # ############# ######### # # ### # # # # # # ### ### # # ### # ### # ### ### # ### # ##### ##
#   # # # #   #   # # #     # #   #     #     #   #       #   #   # #         # #   #   # #   # # #   #   #   #   #   # #     # 
# # # # ##### ##### ######### # ####### # ### # ### ##### ####### # ####### ### # ### ####### # # # ##### ### ### # ### # ##### 
# #   #           #           #   #   # #   #   #   #           # #         #   # #   #     #   #   #   # #   #   #   #   #   # 
########### ##### ############### # ### ### ######### ######### # ### ##### # ##### ### ### ### ##### ### # ##### ### ##### # # 
#     #     #   #         #   #   #   #   # #       #   #     # # #   #   # #     #     # #     #   #     # #     #   #     # # 
# ### ####### # # # ##### # # # # ### ### # # ##### ##### ### # # ##### # # ##### ####### ##### ### ####### ####### # ####### # 
#   #         #   #     #   #   #             #           #             #                                           #           
################################################################################################################################
