################################################################################################################################
#     #           #         #     #   #             #       #     #   #         #     #     #       #   #   # #             #   
# ### ########### # ######### ### # # # # # ### ### # # # # ### # # # # ##### # # ### # # # # # # # # # # # # # ########### # ##
#   # #       #     #   #   # # # # #   # #   # #   # # # #     # # #   #     # #   #   # #   # # # # #   #   # #     #   # #   
##### # ##### # ##### # # # # # # # ##### ##### # ##### # ####### ##### # ####### ####### # ### # ### ######### # ### # # # ### 
# #   # #   # #   #   #   #   # #   #     #     #       #     # #     # # #   #   #       #   # #   # # #   #   # #   # #   #   
# # ### # # # ### # ########### ### # ##### ############### # # ##### # ### # # ### ########### # # # # # # # ### # ### ####### 
# #     # # #   # # #     #         #     #   #       #   # # #   #   #     #   #   #       #   # #     # #   #   #     #       
# ####### # ### # # ##### ####### ####### ### # ####### # # # # # # ### ######### ### ##### # # ######### ####### ############# 
#     #   #   # # #     #     #   #     #   #   # #     # # # # # # #   #       # # # #     # # #         #     #     #     #   
##### # ##### # # ##### ##### # ### ### ####### # # ##### ### # # # # ### ##### # # # # ##### # # ##### ### ### ##### # ### # # 
# #   #     # #       #       #   # #   #     #   #   # #     # # # # # #   #   # #   # #     # #     # #   #   #   # #   #   # 
# # ######### ####### ######### ### # ### ### ####### # ####### # # # # ### # ### ##### # ########### ### ### ### # # ### ##### 
# #   #         #   #           #   #     # # #   # #   #   #   # # #   #   # #         #   #     #   #   # # #   #       #     
# ### # ####### # # ##### # ##### ######### # # # # ##### # # ### # # ### ### ########### # ##### # ### ### # ############# ####
# # #   #     # # #     # # #   # #   #     #   # #   #   #   #   #   #   #   #   #       # #     # #   #   #       # #   #     
# # ####### # # # ### # # # # # # # # # ######### # ### ####### ##### # ####### # ####### # # ##### # ### ######### # # # ##### 
# #         # # # #   # # # # # #   #   #   #     #     #     #       #       # # #     # #   #   # # #   #   #     #   #   #   
# ### ####### # # # ### # # ### ######### ### ########### ### ####### ####### # ### ### ####### # # # # ### ### ##### ##### # ##
# #   #   #   #   # #     # #   #           # #           # #   #               #   # #         # #   # # #     #     # #   # # 
# # ### ### ##### # ##### # # ### ######### # ##### ####### ### # ########### ### ### ################# # ####### ##### # ### # 
#   # #   # #     #     # #   #   #     # # #       #   # #   # # #   #     #   #   #       # #   #     # # #     #     # #   # 
##### ### # ### # ##### ####### ### ### # # ######### # # # # # # # # # ### ### ### # ##### # # # # ##### # # ##### ### # # ### 
#   #     # #   #     #       # #     #   #       #   # #   # # #   # #   #       # #     # # # # #   #     # #     #   # #   # 
### # ##### # # ##### ####### # ##### ### ##### # # ### ##### # # ####### ####### # ##### # # # # ### # # ### # ##### ### ### # 
#   #         #   #     #   #   #   # # #     # # # # #       # #   #     #   #   #     # #   # # #     #   # # #   #   #   #   
# # ##### ####### # ### # # ##### # # # ##### # # # # ######### ##### ### # # # # ##### # ##### # ####### # # # # # ### # ##### 
# #       #     # #   #   #   #   #   #     # # # # #   #     #   #   #   # # # # #   # # #     # #     # # #   # #   # #       
# ##### ### ### ### # ##### ### ####### ### # # # # ### # ### ### # # ##### # ### # # # # # ##### # ### # ##### # ### # ########
# # #   #   #     # #     #   #     #     # # # # # # # # #   # #   # #     #     # #     # #       #   #       # # # #         
# # # ### ####### ##### # ### ####### ### ### # # # # # ### # # ####### ##### ##### ####### ######### ##### # ### # # ######### 
#   #   #       # #   # #   #   #   #   #     # #     #     # # #   #   #   # #     #     # #     # # #     # #   #   # #     # 
# ######### ### # # # ##### ### # # ### ####### ### # ####### # # ### ### # # # ##### ### # # ### # # # # ### # ### ### # ##### 
# #   #   # #   # # #       #   # # #   #     #   # # #       # #   # # # # # # # #   #   #   # #   # # #   # # # # #   # # #   
# # # # # ### ### # ######### ### # # ####### ### ### # ####### ### # # # # # # # # ########### ##### ### # ### # # ### # # # ##
# # #   #   # # #   #           # #   #     #   #   #               # #   #   #   #     #     # #   #   # # #   # #   #         
### ####### # # ############# # # ######### # ##### ######### # ##### # ######### ##### ##### # # # ### ### # ### ### # ####### 
#   #     # # #   #   #     # # #   #     # #     #   # #     # #     #                       #   #         # # # #   # #   #   
# ### ### # # ### # # # ### # # ### # # ### # ####### # # ##### # ############# ### ####### ########### ##### # # # ##### # ### 
# # # #   # # #     # # # # # #       #             # # # # #   #   #         # #   # #     #     #   # #     #   # #     #   # 
# # # # ### # ####### # # # # ################### # # # # # # # ### # ####### # # ### # # ### ### ### # # ##### ### # # ##### # 
#   # #   # #     # #   # # #     #     #   #   # # # #   #   #   # #     #   # #     # # #   # #     # #   # #     # #     # # 
##### ### # # ### # ##### # # # # # ### # # ### # # # ########### # ##### # ########### # # ### ####### ### # # ##### ##### # # 
#   # #   # #   # #     #   # # # # # #   #   # # # #       #     # #   # #       #     # # #           #   # #   #   #   # #   
# # # # ### # # # ##### # ### # ### # ####### # # # ####### # ##### # # # ####### # ##### # # ######### # ### ### # ### # # ### 
# #   #     # # #   #   #   # # #   #       # #   # #   #   # #   # # #   # #     #   #   # #   #   #   # #   #   #     # #   # 
# ########### ##### # ##### # # # ######### # ####### # # ### # # # # ##### # # ##### # ### ### # # # # # # ### ############# # 
#   #   #     #   #S# #   #   # #   #       #       # #   #     # #   #     # # #     #   #   # # # # # # #         #     #   # 
### # # ####### # # # # # ### ##### # ##### ####### # ########### ##### ##### # # ####### ### # # ### # # ### ##### # ### # ### 
# # # # #   #   #   #   #     #   # # #     #   # #   #     #             #   # #       #   #   # #   # #   # #   #   #   # #   
# # # # # # # ### ############# # # ### ##### # # ######### # ##### ####### ### ####### ### ##### # ####### # # # ##### ##### # 
# #   #   #   #   #           # #   #   #     #     #     #   #   # #       #     #   #   #     # #       # # # #   # #   #   # 
# ############# # # ######### # ##### ### ######### # ### ##### # ### ######### ### # ### ##### # # ##### # ### ### # ### # ### 
#               # # #     #   # #           # #   # # # #       #     #     #   #   #   # #   # # #     # #   #   #   # # #   # 
##### # ### # ##### # # # ##### ### ##### # # # # ### # ######### ##### ### # ### ##### # # ### # ####### ### ### ##### # ### # 
# #   #   # #     # # # #       #   #   # #   # # #   #   #     # #     # # #   # #   # #   #   #           #     # #   #   # # 
# # # ### # ##### # ### ######### ### # ####### # # ##### # ##### # ##### # ##### ### # ##### ########### # ####### # # ### # # 
#   # #   #     # #     #     #     # # #   #   #   # #       #   #     # #     # #   #   # #   #         # #       # # #   # # 
##### # ### ### # ####### ### # # # # # # # # ####### # ##### # ####### # ##### # # ##### # ### # ##### ### # ####### # # ##### 
# #   #   # #   #     # #   # # # # # # # # #       #   #   # #       # # #     # # #     #       #   # # #   #   #   #   #     
# # ##### # ### ### # # ##### # # # # # # # ####### ##### # # ##### # # # # ##### # # ##### # ##### # # # ##### # # ####### # # 
#   #     #   # #   # # #     # # # # #   #       #   #   # #       # # # #       # # #     # #     #   #   #   # #   #     # # 
### # ####### ### ### # # ##### # ### ########### ### # ### ##### ##### # ######### # # ##### # ####### ### # ####### ### ### # 
#   # #     #   # #     # #     # #     #     #     #   #   #   # #     #   # #   #   #   #   # #         #   #     #   #   # # 
# ### # ### # # # ##### # # ### # # ##### ### ############### # # # ##### # # # ########### ### ############# # ### ### ##### # 
#   # # #   # # # #   # # # # # #   # #   #   #     #   #   # #   #   # # #   #     #     # # # #             # # # #     #   # 
##### # ####### # # # ### # # # # ### # ### ### ### # # # # ######### # # ######### ### # # # # # ############# # # ##### # ### 
#     #         # # #     # #   #     # # #   # # #   #   #           #     #     #   # # # # # #   #       #   # # #   # # #   
# ### ########### # ####### ########### # ### # # ######################### # ### ### # # # # # ### # ### # # ### # # # # # # ##
# #       #     #   #           #       # #   # # #         #     # #     # # # #   #   # #   #       #   # # # # # # # #   # # 
# ##### ### ### ##### ########### ####### # ### # ##### ##### ### # # ### # # # ### ##### ################### # # # # # ##### # 
#     #     #   #     #   #   #   #       #     #     # #       #   # #   # #   # # #   #                   # #   #   #   #   # 
##### ####### ### ##### ### # # ### ### # ########### # # ########### # ### ### # # # # ################### # # ######### # ### 
#     #     #     #     #   #   #   #   #     #       #   #   #       #   #     #   # # #           #     #   #       #   # #   
# ### # ### ### ### ##### ####### # ######### # ####### ### # # ######### # ######### # # # ##### ### ### ##### ### ### ### # # 
# #   # # #   #     #     #     # # #       #               # #       # # #           # # # #   # #   #         #   #   #   # # 
# ##### # ### ##### # ##### ### # ### ##### ####### ### # ########### # # ### ######### ### # # ### ### ##### ####### ### ### # 
#     # #   #     # # #   # #   #   # #   #   #   #   # # #         #   #   #       # #   #   #     # #   #   #     #   # #   # 
# ### # # ####### # # ### # ####### # # ##### # # # # # ### ####### ### ### ####### # ### # ######### ### ##### ### ### # # ####
#   #   # #   #   # # #   #         # #   # # # # # # #     #     #   # #   #     # #     #   #   #     #       # #   # # # #   
# ####### # # ##### # # ########### # ### # # # # ### ####### ### ##### # ### ### # ######### ### # ####### ##### ##### # # # # 
# #       # #   #   # # #       #   #   # # #   #   #   #     # #       #   # #   #   #     #   #   #     #   #   #   # #     # 
# # # ##### ### ##### # # ### ### ##### # # ####### ### # ##### ########### ### ##### # ### ### ### # ### # ### ### # # # ######
#   # #     # #   #   # #   #     #   # # #       # #   # #   #     #   # #     #   #   #   #         #   #     #   #   # #     
##### # ##### ### # ### ### ####### ### # # ####### # # # ### # # # # # # ####### # ##### ######### ##### ####### ####### # ### 
# #   #     #   #   #     #           # # # #     # # # #   #   # #   #   #     # #     #   #       #   # #       #         #   
# # # ##### ### ##### ### ##### ##### # # # # ### # # # ### ##### ####### ##### # ######### # ##### # # ### ####### # ##### ####
#   #   #   # #       # #       #     #   # # # # # # #   #     #   #   #     # #             #     # # #   # #     # #   # #   
### ##### ### ### # # # # ##### # ### ##### # # # # # # ####### # # # # ##### # ####### # ##### ### # # # ### # ####### # ### # 
#   #   #   #     # # # # #     # #       # #   #   # #     # # # # # #   #   #         #   #   #   # # #   #   #   #   #   # # 
# ### # ### ### # # # # # # ##### ####### # ### ##### # ### # # ### # ##### ### # # ####### # ### ### ##### # ### # # ##### # # 
# #   #     #   # # # # # # #   #     #       # #     #   #   #     #       #   # # #       # #     #   #   # #   #   #   #   # 
### ######### ##### ### # ### # ##### # ##### # ######### ########### ########### ### ####### ##### ### # ### # ####### # ##### 
#   #       # #     #   #     #   #   # #   # #       # #           # #   #       #   #     # #   #     # #   # # #   # #     # 
# ####### # ### ##### ######### # # ### # # # ####### # ### # ####### # # # # ##### ### ### # # ####### # ### # # # # # ####### 
# #     # #   #         #     # # # #   # # #   #   # #   # #       # # #   #   #   #     # #   #     #             #   #     # 
# # ### # ### ######### # ##### ### ##### # ### # # # ### ######### # # ####### # ### ##### ##### ### # ##### ########### ### # 
# #   # # #   #       #     #   #   #   # #   #   # # #         #   # # #     # #       #   # #   # # # #   #   #         #   # 
# # # # # # ### ##### # ##### ### ### # # ### # ##### ######### # ### # # ### # ######### ### # ### # # # # ### # ######### ### 
# # # #   # #   #     #   #   # # # # # # #   #       #     #     #   # # #   #   #       #   #     # # # #   # # #       # #   
# # # ##### # ### ####### # ### # # # # # # ### ####### ### # ##### ### # # ##### # ####### ######### # # ### # # # ##### # ####
# # #     #   #   #       #   # # # # #   # #   #     #   # # #     #   # # #     #         # #   #   # #   #     #   #   # #   
# ####### ##### ### # ####### # # # # ##### ### # ### ##### # # ##### # # ### ### ########### # # # ######### ####### # ### # # 
#       #   # # #   # #     #   #   #   # #   #     #       # #     # # #   # #           #     # #   #   #   #       # # #   # 
####### ### # # ##### # ### ########### # ### ##### ######### ##### # # ### # ### ######### ######### # # # ### ####### # ##### 
# #   # # #   #   #   # # #         #   #     #   #   #   #       # # # #   #   # #       # #       #   # #     #       #     # 
# # # # # ####### # ### # ######### # ######### # ### # # # ####### # ### ##### # # ##### # # ##### ##### # ##### ########### # 
#   # # #       # # #   #   #     # # #   #   # # #     # #   #     #     #   # #   #   #   # #   #       # #     #         #   
# ### # # # ### # # # ##### # ##### # # # # # # # ##### # ##### ##### ##### # # ### ### ##### # ########### ############### ### 
# # #   # #   # # # # #     #       #   # # #   #     # #   #   #           # #   #         # # #       #     #   #       # #   
# # ##### ### ### ### # ################# ########### # ### # ##### ############# ########### # # # # ### # # # # # ##### # # # 
# #       # #     #   #     #           #   #     #       # # #   #     #     #   #           # # # # #   # # # # # #   # #   # 
# ### ##### ####### ####### ##### ##### ### # ### # ####### # # # ##### # ### # ### ########### # # ### ### ### # # # ### ######
# #               # #       #     #   # #       #   #     # # # #     # # #   #   # #             #   # # #     #   #   #       
# # # ####### ### # # ####### ##### ### # ########### ### ### # ####### # # ##### # # ########### ### # # ############# ####### 
# # # #     #   # # # #     #   #   #     #           # # #   #         # #   #   # # #   #     #   #   #   #       #   #   #   
# ### # ### ### # # # # ####### # # # ##### ##### ##### # # ######### ### ### ##### # ### # ### ### ####### ####### # # # ### ##
#   # # # #   # # # # #         # #     #   #   #       #   #     #   #   #   #   # #     # # #   #  G#   #       # # # #   # # 
### # # # ### ### # # ##### ####### ##### ### # ##### # ##### ### ##### ### ### # # ##### # # ### # ### # ####### # # # ### # # 
#     # #   # #   # #   #   #     # #   # #   #   #   #     # # #     #   #     # # #     # #   # # #   #     # # #   # #   #   
# ##### # # # # # # ### ##### ### # # # # # ##### # ##### # # # ##### ### ####### # # ##### # # # # # ####### # # ##### # ######
#   #   # #   # # # # #     # # # #   #   #     # # #   # # # #     # #   #       # #     # # # # # # #     # # # #     # #     
# ### ### ##### ### # ##### # # # # ####### ##### # ### # # # ##### # # ########### ### # ### # # # # # ### # # # # ##### ### # 
#   #   #   #       # #   # #   # #         #   # #   # # # #     #   #   #   #   #   # # #   #   # # #   #   #   # #   # #   # 
# # ####### # ####### # # # ##### ### ####### # # ### # # # ##### ####### # # # # ### # # # ####### ##### ##### ### # # # # ### 
# #   #   # # #   #   # #   #   #   #     #   # # # #   # #     #   #   #   # # # #   # # # # #         # #     #   # #   #   # 
# ### # # # # # # # # # ##### # ### ##### # ### # # ##### ##### ### # # ##### # ### ### # # # # ### ### # # ##### ### ######### 
#   #   #   #   #   #         #           #   #   #           #       #                 #   #   #     #                         
