################################################################################################################################
#     #   #     #   #         #       #     #     #   #   #                 #     #       #     #       #                     # 
# ### # # # ##### ### ####### # ### # # ### ##### # # # ### ################# ### # ##### ##### # ##### # ####### ########### # 
# #   # #   #     #   #       # #   # # # # #     # #   #   # #     #     #   # # #   #   #   # #     # #   #   #   #   #   #   
# # ####### # ##### ### ####### ####### # # # ##### ##### ### # # ### ### # ### # ### ##### # # ####### ### # # ### # # # # # ##
# # #     # #       #   #   #   #       #   # # #         #     # #   #   #     #   #     # # #         # # # # # #   #   # #   
# # # # ### ######### ### ### # # ########### # # ######### ##### # ### ####### ### ##### # # ####### ### # # # # ######### # ##
# # # #         #     #       #         #       # #       #     # #   # #     # # #     #   #       # # #   # #       #   # #   
# # # ########### ####### ######### ### # ### # # ### ### # ### ####### # ### # # ##### ##### ##### # # # ########### # ### ### 
# # #   #   #   #   #   #   #     #   #     # # #   # #   # # #     #   #   #   # #   # #   # #   # # # # # #   #     #   #   # 
# # ### ### # # ### # # # ### ### ##### ##### # ### # ##### # ##### # ##### ##### # # # # # ### # # # # # # # # # ####### # # # 
# # # # #   # #     # #   #   # # #   #   #   # #                 # #   #   #   #   # # # # #   # # #         #   #     # # # # 
# # # # # ### ########### # ### # # # ### # ### # ######### ####### ### # ### ####### # # # # ### # ### ##### ##### # ### ### # 
# # #       #   #         # #   #   #   # # #     #   #   #   #   # #   # #         # # # #   # # #   #     #       #   #     # 
# # # ### # ### ### ####### ### ####### # # ####### # # # ### # # # # ### ### ##### # # ####### # ### # ### ########### ########
# # #   # #   #   #   #   #     #     # # # #   #   # # #   # # # # #   #   #     #   #     #     #     #   #   #       #       
# # # # ######### # # # # ##### ##### # # # # # # ### ##### ### # # ### ### # ##### ####### # ##### ######### # ######### ##### 
# # # #             #   #       #   # # # #   #     #   # #   # #   #   # # #     #   # #   #         #       #         # #   # 
# # # ############### ########### # # # ############### # ### # ### # ### # # ### ### # # ####### ##### ############### # # ### 
# # #   #   #       #             #   # #     #   #     #   # # #   # #     #   #   # # # #   #   #     #         #   # # #     
# # ### # # # ##### # ### # ########### # ### # # # ####### # # # ### # ####### ### # # # ### ### # ########### ### # # # ######
# #       #   # #   #   # #   #       # #   # # #   #       #   # #   # #       #   # # # #   #   #             #   # # # #     
######### ##### # ##### # ##### ##### ####### # ########### ### ### ### # ### ### ### # # # ### # ####### ##### # ### ### # ### 
#   #   #     # # #     # #   # #     #       #     #   #       #   #     #   # # #     # #     #         #     # # #     #   # 
# # # # ##### # # ######### # # # ##### ####### ### # # # ####### ### # ####### # # ##### ####### # ####### ### # # ########### 
# #   #   #   # #       #   # # # #   # #         #   # # # #         #       #   #     #     #   # #       #   #   #           
# ####### # ### ####### # ##### ### # # ### ######### # # # # ############### ##### ### ##### # ##### ### ### # ### # ### ##### 
# #       #         # #   #       # # #   # # #     # # #   #   #     #   # # #     #     #   # #   # #   #   #   # #   #   #   
# ################# # ##### ##### # # ### # # # ### # # # ##### # ### # # # # ####### ##### ##### # # ##### ##### # ######### # 
#         #       # #       #     # #   # #   # #   # # #     #   # # # # # #       # #   # #     #   #     #   # #   #       # 
######### ### ### # # # ##### ### # ### # ##### ####### ##### ##### # ### # ####### # # # # ####### ### ##### # # ### # ####### 
#       #   #   #   # # #     #   #   # #     #   #     #   #   #   #     #         #   # #     #   #   #   # # #   #   #     # 
# ##### ### ### ##### # # ##### ##### # ##### ### # ##### # ##### ####################### ##### ##### ##### # # ### ####### ### 
# #   #     # # #     # #   # #     # #       #   # #     #       #       #     #       #     # #     #     # #     #       #   
# # ######### # # ##### ### # ##### # ######### ### # ##### ############# # ### # ######### # # # ######### # ########### ### ##
# #       #   #   #   # #   # #   #             #   # #   #       #       # #   # #         # # #   #       #           #   # # 
# ##### # ### ##### # # # ### # # ####### ########### # # ##### ### ####### # ### # ######### # # # ####### ########### ### # # 
# #   # #     #     #   #     # # #     #             # #     #           # #   # #     #   # # # # #     #                 # # 
# # # # ##### # # ############# ### ### ### ########### ##### # ########### ### # ##### # # # # ### # ### ######### ######### # 
# # # #     # # # #       #     #   # #G  #         #   #   # # #     #     #   #       # #   #   #     #   #     #   #       # 
# # # ##### # # ### ##### # ##### ### ### ######### # ### # # # # ### # ##### ##### ############# ##### ### # ### ### # ####### 
#   # #   # #   #   #   # #       #                 # #   #   # #   # # #   #       #     #     #     #   # # # # # # # #       
##### # # ####### ### ### ####################### ### # # ######### ### # ######### # ### # ### # ### ### # # # # # # # ####### 
#     # #     #   # # #   #             #   #   # #   # # #   #   # #   #           #   # # # # # #   #   #   # #   # #   #     
# ##### ##### # ### # # ### ########### # # # # # # ### ### # # # # # ####### ##### ### # # # # ### ### ####### ##### ### # ### 
#       # #   # #   #   #       #     # # # # #     #   #   #   #   # #       #   # # # # # # #     #     #     #   #   #   # # 
######### # ### # ####### ##### # # # # ### ### ##### ### ########### # ####### # # # # # # # ######### # # ##### # ### ##### # 
#   #     # #                 #   # # #   #   #   #   #   # #       # #         # # # # #   #       #   #     #   # # #   # #   
# ### ### # # ### ########### ##### # ### ### # # # ### ### # ##### # ########### # # # ######### # # ######### ### # ### # # ##
#   #   #   #   #         #   #     #   #   # # # #   #   #   #     # #         # #   # #     #   #   #         # # #           
# # ### ##### # ### ##### # ######### # ### # # # ####### # ####### # ######### # ##### # ### # # ##### ######### # # ######### 
# # #   #     #   # #   # # #     #   #   #   # #   #     # #       # #     #   #   #   # # #   # #     #       # # # #         
# ### ### # ##### ### ### # # ### # ##### ##### ### # ####### # ### # # ### ### ### # ### # ##### # ######### # # # ### ####### 
#         #     #   #     #   #   #   #     # #   # #   #     # #   # # # #   # #   #   #   #   # # #       # #   #   # #     # 
# ########### # ### ############### # ##### # # # ##### ##### ### # # # # ### # # # ### ##### # # # ### ### # ####### # # ### # 
#     #     # #   #   #         #   #     #   # #     #     # #   # # # # #   #   #   #       # # #   # #   #       # # # # # # 
##### # ### # ### ### # ####### ### ##### # ### ##### ##### # # ### # # # # ####### # ######### # ### # # ##### ### # ### # # # 
#   # # # # # #   #   #   #   #   #   # # #   # #     # #   # #   # #   # #   #     #   #       # #   # # #   #   # #   #   #   
# # # # # # # # ######### # # ### ### # # ##### # ### # # ### ##### ##### ### # ##### # # ####### # ### # ### ### # ### # ######
# # #   # # # #   #       # # # # #   # #       #   #   # #   #     #       # #   # # # #   #     # #   # #       #   # #   #   
### # ### # ##### # ######### # # # ### ########### ##### ##### ### # ####### ### # # # ### # ##### # ### # ########### # # # # 
#       # #     # #           # # # #   #         #     #       # # #     #   #   # # #   # #   #   #   #   #           # # # # 
# ##### # ##### ############### # # # ### ####### ##### ######### # # ### # ### ### # ### # ##### ####### ### ########### ### # 
#   #   # #   #         #   #   # #       #     #   # #   #         #   # #   #   #   #   # #   #       #     #   #         # # 
# # # ### # ######### # ### # # # ### ##### ### # # # ### # ########### # ### ### ##### # # # # ####### # ####### # ####### # ##
# # #     #           #   #   # #   #   #   # # # # # # #   #     #   # #   #   # #     # # # # #       # #     #   #     # #   
# # ##################### ##### ### ### # ### # # # # # ##### ### # # # # # ### # # ### # # # # ######### ##### ### # ### # ### 
# #   #                 #         #   # # #   # # # # #     #   # # # # # #   # # # #   # #   #   #       #   #   # # # # #     
# ### # ############### ############# ### # ### # # # # ##### # # # # # # ##### # # # ########### # ##### # # ### # # # # # ####
#   # #     #         #             #   # #   # # #   # #     # # # #   # #     # # #           # # #   # # #   # # # # # #     
# # ####### ##### # # ############# ### # ### # # ##### # ##### ### ##### # ##### # ######### ### ### # # ##### # # # # # # ####
# #     #   #     # # # #   #     #     #   #   #       #     #     #   # #   #   #         #   #   # # # #             # # #   
# ##### # ### ##### # # # # # ### ######### ########### ##### ######### # ### ################# ### ### # # ############# ### # 
# #   # # #   #     # #   # #   #   #     #           #       #   #     # #   #     #             #     #   #       #   #     # 
# ### # # ##### ##### ##### ### ### # ### ########### ### ####### # ##### # # # ### # ########### ######### # ##### # # # ##### 
#   # #   #     #   #     #   #   # #   # #   #   # #   #         # #   # # # #   # #       #   #           # #   #   # # #   # 
### # ##### # ### # ##### # # ### # ##### # # # # # ### ##### ##### # ### # ##### # ####### # # # # ### ##### # # ##### ### # # 
# #   #     # #   #     #   #   # #     # # #   # #   # #   # #   #   #   #       #   #     # #   #   #     #   # # #   #   # # 
# ### # ####### ####### ### ##### ##### # ####### ### # # # # # # ### # ############# # ############# ##### ##### # # ### ### # 
# #   # #       #     # #   #   #   # #   #     # # # #   # #   #     #     #   #   # # #     #   # #     #     #   #   #   #   
# # ##### ######### ### # ### # ### # ##### ### # # # ##### ########### ### # # # # # # # ### # # # ##### ##### ### ### ### ### 
#   #   #     #   #     # #   # #   #     # #   #     #     #         #   #   # # #   # #   # # # # #     #   #   #   # # # #   
# ### # ##### # # # ##### # ### # ####### # ##### ##### ##### ####### ### ##### # ####### ### # # # # ####### ### ### # # # # # 
#     # #     # #       # #   #   #   #   #       #     #   #   #     #   #     # #   #   #   # #   # # #   #   # #   # #   # # 
####### # ### # # ##### # ### ####### # ##### ##### ##### # ### # ##### ### ##### # # # ### ### ##### # # # ### # # ### ##### # 
#     #   #   # # #   #   #   #     # # #     #   # #   # # #   # #   # #   #   #   #   #   # #       #   #     #   # #   # # # 
# ### # ####### # # # ##### ### ### # # ##### # # # # # ### # ##### # ### ### # ######### ### ################# ##### ### # # ##
#   # # #     # # # #             #   #     # # # #   # #   #   #   #   # #   #       #   #           #           # #     # #   
##### # # ### ### # ############# ######### # # # ##### # ##### # ##### # ##### ####### ### # # ##### # ######### # ####### ### 
# #   # # # #     # #     #     #   #           #     # #     # #   #   #       #       #   # #   # #   #       #     #   #     
# # ### # # ##### # # ### # ### ### # # ####### ##### # ##### # ### # ##### ##### ######### ##### # ########### ##### # # ##### 
# # #   #   # #   # #   # #   #   #   # #     #   #   # #     #     # #   #   #   #       #     # # #       #       #   #       
# # # ####### # ### ### # ### ### ####### ### ##### ### # ### ####### # # # ### ##### # # ##### # # # # # # # ##### ### ####### 
# # # #     #     # # # #   #   #       # # #     # #   # #         #   # # #   #     # #     # # #   # # # #   #       #     # 
# # ### ### # ##### # # ####### ####### # # ##### # # ##### ####### ##### ### ### ##### ##### # # ### ### # ##### ####### ### # 
# #   #   # # #     #   # #   # #     # # #     # # #     #   #   #   # #     #   #   #   # # # # #   #   #       #   #     # # 
# ### ##### # # ##### ### # # # ##### # # # ##### # ##### ### # # ### # ####### ### ##### # # # # ##### ######### # # # ##### # 
#   # #   #               # # #     # #   #     # #     # #   # #   # # #   #     #   #   # # # #   #   #         # #   #   # # 
### # # # # ######### ##### # ##### # ######### # ### ### # ### ##### # # # # ### ### # ### # # ### # ### ##### # # ##### # # # 
#   #   # # #  S    #     # #     #         # # #   #   # #     #   #   # # # #     # # #         # #   # #     # #     # # # # 
# ####### # # ##### ### # # ##### ######### # # ### ### # # ##### # ### # # # # ### # # ########### ### ### ######### ### # # # 
#   #   #   # #   #   # #   #   #     #     #     #   # # # #     #     # # # #   # # #         #   #   #   #       # #   #   # 
# ### # # ### # ##### ####### # ### # # ######### ### ### ### ######### # ### ### ### ########### ####### # # ### ### # ########
#     #   #   #     #   #     #     # # #           #   #   #   # #     # #     #   # #     #   #       # # #   # #   #   #     
# ######### ####### ### # ########### # # ######### ### ### ### # # ##### # ### ### # # # ### # ####### # ##### # # ##### ##### 
#         #         #   # #     # #   #   #       # #   # #     # # #   #   #     #   # # #   # #       #       # #   # #     # 
######### ######### ####### ### # # ####### ### ### # ### ####### # # ####### # # ##### ### ### # ##### ######### ### # ##### # 
#     #       #   #       # # # #   #   #     #   # #     # #   # # #         # #         #   #   #     #     #   #   #   #   # 
# ##### ### # # ######### # # # ##### # # ####### # ####### # # # # ##### # ##### ####### ### ####### ### ### ### # ##### # # # 
#       #   #                 # #     #     #   #     #   #   #   #     # #     #       #   #     #   #   # #   # # #   # # # # 
####### # ### ########### ### ### ######### # # ##### ### ##### ####### ### ### ####### ### ##### # ### ### ### ### # # # # ### 
#     # # #   #         # #       #       # # #     #     #   # #     #   # #   #         # #   # # #   # #   #     # #   #     
# # # # # ### # ####### ### # ##### ##### ### ##### # ##### # # # ####### ### ### ####### # ### # # # ### # # ######### ########
# # #   #   # # #     #     # #   # #     #   # #   #       #   # #     # #   #   #       #   # # # #   # # #         # #   #   
### ####### ### # ### ####### # # # # ##### ### # ##### ######### # ### # # ### ### ##### ### # # ##### # # ####### # # # ### # 
#   #   #   #   # #   #     # # #   #   #     # #     # #   #   #   # # #   #   #   #   # #   # #       #   #       #   #   # # 
# ### # # # # ### ##### # ### # ####### ### # # ##### # # # # # ##### # ####### # # # # ### ### ######### ########### ##### # # 
#     # # # #   # #     #   # # #     # #   # #     # # # #   # #   #           # # # #   #     #     #           #     # # # # 
# ##### # ##### # # ####### # # # ##### # ### # ##### # # ##### # ##### # ######### # ### ########### # ######### # ### # # # # 
#     # # #   # # #     # # # #   # #   # #   #     # # # #             #   #     # # #   # #         # #   # #   # # # # #   # 
##### # # # ### # ##### # # # ##### # ### # ### ### # ### # ####### ### ### # ### # ### ### # ### ##### # # # # ### # # # ##### 
#   # # #   #   #     #   # # #     # #   #   # #   #     #   #     #     #   #   #     #   #   #     # # #   #   #   #   #   # 
# ### # ##### ####### ### ### # ### # ####### # ############# # ##### ######### ##### ### # ### ##### # # ####### ####### # # # 
#     #     # #     #       #   # # #       # #   #     #     #   #   #         #   #     #     #     # # #     #       #   # # 
# ######### # # ### ####### ##### # ####### # ### ### # # ### ### ##### ### ##### # # # ############### # # ########### ####### 
# #       # #   #   #     #   #   #   #   #   # #     # #   #   #     #   # #   # # # #     #   #       # #     #   #   #       
# # ##### ####### ### ### # # # ##### # # ##### ####### ### # ####### ### ### # ### # ####### # # ####### ##### ### # ### ######
# #     #         #     #   #           #                   #       #   #     #     #         #                     #           
