################################################################################################################################
################################################################################################################################
       #       #           #   #         #             #           #           #   #   #       #               #               #
 ##### # # ### ### ####### # # ######### # ### ### ##### ######### ### # ##### ### # # # ##### # ##### ######### ### ######### #
 # #   # #   #   #   #   #   #       #   #   # #   #   #   # #   #   # #   # #     # #   #   #   #   #   #   #   #   #   #     #
 # # ####### ### # # # # ### ####### # # ### # ##### # ### # # # ### ##### # ##### # ##### # ####### ### # # # ####### # # ### #
   #       #   # # # # #   # #     # # # # # # #     #   #   # #     #     #               # #         #   #   #     # # # #   #
## ####### # # # ### # ### # # ### # # # # # # # ####### ##### ####### ####### ############# # # ######### ##### ### # ### # ###
 #   #   # # # #     #   #   #   # #   # # # # # #     #     # #   #   #       #   #   #       #   #     #     # # # # #   #   #
 ### # # # # # ################# # ##### # # # # ### ####### # # ### ### ##### # # # # ### ####### # ### ### ### # # # # ##### #
   # # #   # #   #               #     #   # # #   #   #   #   #   # #   #   # # #   #   # #     # # # #   #   #   # # # #   # #
 # # ############# ################### ### # ##### ### ### ####### # # ### ### # ####### # # ### ### # ### ### ##### # # # # # #
 # #               #       #         # #   #   #   #             #   # #       #       #   #   # #   #     #   #     # #   # # #
## ################# ####### ### # # # ### ### # ### ####### ### ##### ######### ##### ### ### # # ############# ##### ##### ###
   #     #       #           # # # # #   # #   # #   #     #   # #     #       #     #   # # # # # #   #     #   #   #     #   #
 ### ##### ### # # ########### # ### ### # # ### ##### ### ### # # ##### ##### # # ####### # # # # # # # ### # ### # ##### ### #
 # #   #   # # # #   #         #   #   # #     #   #   # #   # # #   #   # #   # # #     #     # # # # # #   #   # #   # #     #
 # ### # ### # ##### # ####### ### ##### # ####### # ### ### # # ##### ### # ### # # ### ##### ### ### # # # ### # ### # ##### #
           # #   #   #   #     # #       # #     #   #     # # #     # #   # #   # #   #     #         # # #   # #   # #     # #
 ######### # ### # ##### # ##### ######### # ### ##### ##### ####### # ### # # ####### ##### ######### # # ##### ### # ### # # #
 #     # # #   #   #     #     #     # #     # #             #   #   #     # #       #   # #     #       #     #   # #     # # #
 # ### # # ### ##### ######### ##### # # ##### ############### # # ####### # ##### ##### # ##### ####### ##### ### ######### # #
 #   # #               #     #       # #     #   #         # # #   #   #   #   #   #     #     #       #     #     #       #   #
###### # ##### ######### ### # ####### ##### # # # ####### # # ##### # ### ### ##### ##### ### ####### ##### ####### ##### ### #
     #   #   #     #     #   #     #       # # # #   #     # # # #   #   # #   #   #   #     #   #     #   #     #   #   # #   #
 ### # ### # ####### ########### ### # ##### # ####### ##### # # # ##### # # ### # ### # # ####### ##### # ##### # ### # # ### #
   #   #   # #       # #       #     #             #   #   # # # # #     # # #   #   # # # #     # #   # # #     # #   # #   # #
#### ### ### # ####### # ##### # ################# # ##### # # # # ####### # # ### ### # # # ### # # # ### # ##### # ### # # ###
     #   #   #         # # #   #     #       #   #   #   #   # # #     #   #   # #     # # # # # #   #   # # #     #   # # #   #
 ##### ### ########### # # # ####### # ####### # ### ### # ### # ##### # ####### ######### # # # ####### # # # ####### # ##### #
     #   #   #   #     #   # #     #   #       #   #   # #     #     # #     #       #     # # #         #     #       # #     #
 ### ####### # ### ######### ### # # ### ######### # # # # ##### ### # ##### # ##### # ##### # ############# ### ####### # ### #
   # # #     # #   #       # #   # # #   #     #   # #           #   #   #   # #   #       #   #   #   #   # # #     #     #   #
 # # # # ##### # ### ### # # # ### ### ### ### ### ########### # # ##### ### # # # ### ### ##### # ### ### # # ##### ####### # #
 # #   #   #         #   # #   # #   # # # # #   # #       #   # # #   #   # # # #   #   #       #       # # # #   #     #   # #
 # # ##### # ######### ### ##### ### # # # # ### # # ##### # ### # # # ### # # # ### ### # # # ######### # # # ### ##### # ### #
 # # #   #   #     #   #     # #   # # #   # #   #   #     # #   #   #           #   #   # # #     #   #   # # #     #   # # # #
 # ### ##### # ### # ### ### # ### # # ##### # ####### ##### ##### ############### ### ### # ##### # # # ### # # ##### ### # # #
 #     #   # # # # # #   #           #       #   #   # #   #     # #         #     #   #   # #   #   # #           #   #   #   #
 ####### ### # # # ### # ########### ####### ### # ### # # ##### ### ####### ####### ####### # ####### ### ### ##### ##### ### #
       #   # #   #     # #       #     #   # #   #     # #   #   #   #     #   #   # #     # # #       #   #   #     #     #   #
## ####### # ########### # ##### # ### ### # # ### ######### # ### ####### ### # # # # ### # # # ####### ### ### ##### ##### ###
   #     # #     #     # # #   # # # #   # #   # #   #       #     #     #   # # # #     # # #   #       # #   # #         #   #
 ### ### # # ##### ### # # # # # # # ### # ##### ### # ################# ### # # ######### # ######### ### ### # ##### ### ### #
   #   # # #     # # # # # # #   #   # # #     #     #       #     #     # # # #     #     # #     #   # #   # #     #   # #   #
 # ##### # ##### # # # ### # ######### # ##### # ######### ### ##### ##### # # ##### # ##### # ### # ### ### # ##### # ### #####
 #       #     # # # #   # #     #   #   #     #         # #     #   #       # #   #   #   # # #   # #         #     # #   #   #
 ### ######### # # # ### # ##### # # # ### ############# # # ##### ### # ### # ### ##### # # # # ### # ######### ##### # ### # #
   # #       #   # #   #   #   # # # # #         #     # #   # #   # # #   # #   #   #   #   # # #   # #         #     #   # # #
 # ### ##### ### # ### ##### ### ### # # ####### # ### # # ### # ### # ### ##### # ### ####### # # ##### ######### ####### # # #
 # #   #     #   #   # #     #   #   # #       # # # #   #     #   #     #     # #     #   #   #   # #   #   #           #   # #
 # # ### ##### # ### # # # ### ### ### # ##### # # # ######### ### # ####### ### ####### # # ####### # ##### # ######### ##### #
 # # # #     # # #   # # #     #   #     #     # # #         #   #   #     # #   #     # # #   # #   # #   # # #   #   #     # #
 # # # ##### # ### ### # ######### # ##### ####### # ### # # ### # ### ### # # ##### # # ##### # # # # # # # # # # # # ### ### #
 # #   #   # # #   #   #     #     # #   # #     # #   # # #   #   #   #   # #     # # #       #   # #   #   # # #   #   #   # #
 ######### # # # ##### ##### ### # # # # ### ### # ### ### ### ### # ############# # # ############# ######### # ####### ### # #
       #   #   # # #       # #   #   # #     # #   # #   # # #   # #     #     #   # #       #   #         #   #   #   #   # #S#
## ### # ##### # # # ##### # # ##### # ####### ##### # # # # ### # ##### # # ### ### ####### # # # ##### # ######### # ### # # #
   # #         # # # #   # # #   #   #   #   #   #   # # #   #           # #   # # # #     # # #   #   # #           #   #   # #
 ### # ######### # # # # # # ##### # ### # # ### # ##### ##### ########### ### # # # # ### # # ##### # # ############### ##### #
 #   # # #       #   # # # #     # #   # # # # # #       #   #     #     # # # # #   #   #     #     #   #   #   #   # #       #
 # ### # # ##### ##### # # ##### ##### # # # # # ### ##### # # ### # ### # # # # ############### ########### ### # # # ####### #
 # # #   #     # #     # #     #     # # # #         #     # # #   #   #   # # #     #         # #     #   #     # #   #     # #
 # # ######### # # ##### # ### ##### # # # ##### # ### ##### # # ##### ##### # ##### # ####### # # ### # # ##### # ##### ### # #
   #   #     # # #   #   # # #     # #   # #   # #   # #     # #     #   #   #     #   #     # #   # #   # #     # #     # #   #
 ### # # ### # ##### # ### # ##### # # ### # # ####### # ##### ##### ### # # ### ####### ### # # ### ##### # ##### # ##### ### #
 #   #   #   #       # # #       #       #   # #     # # #         #       # # # #     #   #   #   # #   # #     #   #         #
 # ############# ##### # ### ########### # ##### ### # # ######### ####### # # # # # ##### ##### # # # # # # ### ##### ### ### #
   #   # #     # #   # #   # #       #   #   #     #   #     #   # #     # # # #   # #   #     # # # # # # # #   #   # #   #   #
 ### # # # ### # # ### ### # # ##### # ####### ############# # # # # ### ### # ####### # ##### # # # # ### # ##### ### # ### ###
   # #   # # # #   #   #   # # # #   #         #             # #       #   #     #   # # #     # #   # #   #           #   #   #
 ### ##### # # ##### ### ### # # # ############### ########### ####### ### ####### # # # # ##### ##### # ######### ####### ### #
   #   # #   #       # # #   # # # #     #       # #     #     #   # #   #       # # # # # #     #   #   #     #   #       #   #
 # ### # ############# # # ### # # # ### # ##### ### ### # ##### # # ### ####### ### # ### ####### # ##### ### # # # ####### ###
 # #   # #   #   #       # # #   # # # # # #   #     # # #   #   # #   # #     #     #   # #   #   #   #   #   # # #   #     # #
 # # ### # ### # ####### # # ### ### # # # ### ####### # ##### ### ### # ##### ######### # # # # ##### # ####### # ### # ##### #
 #         #   #       #       #     # # #   # #       # #     #   #   #       #   #   # #   #   #     #       # #   # #       #
 ########### ######### ##### ######### # ### # ####### # # ##### ### # ####### # # # ### ### ##### ########### ### # # #########
 #     #     #       #     #   #           #   #     # #   #   # #   #   #   # # # #   #   #     #     #   # #     # #   #     #
## ### # ### # ##### ##### # # # ############### ### # ##### # # ##### # # # # # # ### ### ########### # # # ####### ### # # ###
   # # #   # # #     #   # # # # #     #   #     # # #     # #   #   # #   #   # # #     #           # # #         #   # # #   #
 ### # ### ### # ####### # # ### # ### # # ##### # # # ### # ##### # # # ##### # ### ############### # # ######### ### # # ### #
 #       #   # # # #         #   # #   # # #   # #   #   # #   #   # # # #   # # #   #     # #   # #   # #       # #   #   #   #
 ####### ### # # # # ##### ### ### # ### # # # # ### ### # ### # ### # ### # # # # ### ### # # # # ##### # ##### # # # ##### ###
       #   # # # #   #   # #   #   #   # # # # #   #     #   # #   # # #   # #   #   #G  # #   #   #   #     #   #   # #   # # #
 ######### # # # ### # # # # ### ####### # # # ### ######### # ### ### # ### ### ### ##### # ####### ######### ####### # # # # #
 # #     #   # #   # # # #     #       # #   #   # #     # # # #       # #   #     # #     #     #   #   #   # #   #   # # #   #
 # # ### ##### ### ### # ##### ####### # ######### # ### # # # # ##### # ### # ### # # ######### # ### # # # # # # # # # # #####
 # # #         # #     # #   #   #     #     #   #   #   #   # # #   # #   # #   #   #     #     #   # # # # #   # # #   #     #
 # # ########### ####### # # ### # ######### # # ##### ##### # ### # ##### # ##### ####### ### ##### # # # # ##### ########### #
 # # #     #   # #     #   #     #         # # #       #   # #     #       #     # #     #   #   #   # #   # #     #           #
 # # # ### # # # # ############# # ### ### # # ##### ### # # ################### # # ####### ### # # # ##### # ##### ### #######
   #   #   # # # #         #   #   #   # # #   #     #   #     #     # #     #   #         #   #   # # # #   # #   #   # #   # #
 ####### ### # # ##### # # # # ### # ### # ##### # ### ####### # ### # # ### # ######### ##### ##### # # # ### # # ### ### # # #
       # #   # #       # # # #     #     #       #   #   #     # # # #   #   # #       #     # #   # # #       # #     #   # # #
 ####### # ### ######### # ####### ######### # ##### ### # ##### # # # ####### # ##### ##### # # ### # ######### ####### ### # #
     #   #   #   #   #   #   #   #     #   # # #       # # #     # # #   #   # # # #   #   # # #     #   #             # # #   #
 ##### ######### # # # ##### # # ### # # # # # # ####### # # ##### # # ### # # # # # ### # # # ##### ### # ########### # # #####
     #   #       # # # #   # # #     # # #   # #   # #   # #       # #     # # # #   #   # # #         # # #       #   # # #   #
#### ### # ##### # # ### # # # ####### # ##### ### # # ### ######### # ##### # # ####### # # ######### # ### ##### # ### # # # #
   #   #   #   # # #     # # # #       # #       #   #   #   #     # #     # # # #       # #   #     # #     #     # #   # # # #
 # # # ##### # ### ####### # # ######### # ####### ####### ### ##### ##### # # # # ### ### # ### ### # ####### ##### # ### # # #
 #   # #     #     # #   # #   #   #     # #     #   #   #         #   #   # # # # #   #   #   #   #         #   #           # #
 ##### # ########### # # # ##### # # ##### # ### ##### # ####### # ### # ##### # ### ### ##### ### ##### ####### ######### ### #
 #   # #   # #     #   # #       # # #   # # #   #   # #       # # #   # #   # #     # #   #     # #   # #     #         #   # #
 ### # ### # # ### ##### # ####### # # ### # # ### # # ####### # # # ### # # # ####### ### ### ### # # ### ### ######### # ### #
   #   #   # #   #     # #   #   # # # #   # #   # # # #       # # # # # # # # #     #     #   #   # #     #             # #   #
## ### # ### ### ##### # ##### # # # # # ### ### # # # # ####### # # # # # # # # ##### ##### # # ### ####### ############# # ###
 # #   # #       # #   #       #   # # # #   # #   #   #   #     # # #   # # # #     #       # #   # #     # #       #     #   #
 # # ### ######### # ############### # # # ### ########### # ####### # ### ### ##### ######### ### # # ### ### ##### # ### ### #
   #   #     #   #                   #   # # #           # #     #   # # # #   #   #         # #   # # # #     #   # #   # # # #
#### # ##### # # # ##### ################# # # # ##### # # ##### # ### # # # ##### ######### # # ### # # ######### # ### # # # #
     #     # # # #   #   #         #   #   #   # #     # #       # #     # #     #   #             # # #       #   # #   #   # #
 ### ##### # # # ### # ### ####### # # # ######### ##### ####### # ### ### ##### ### # # ######### # # ####### # ### # ####### #
 #     # # # # #     #   #     # # # # # #   #   #   #     #     #   #       #   #     #     #   # #   #     # #     # # #     #
 ### # # # # ########### ##### # # # # # # # # # ### # ### # ####### # ####### ### ########### # # ######### # ####### # # #####
   # #   # #         #   #   # # # # #   # # # #   # #   #     #     #   #   # #   #       #   #     #     # #           #     #
## # ##### ######### # ### # # # # # ##### ### ### # ######### # ##### # # # # # # # ##### # ##### ### ### # ### ### # ####### #
   #     #     # #   #   # # # # # # #     #   #     #       # #     # # # #   # # #     #   #   #     #         #   #     #   #
 ########### # # # ##### # ### # # # # ##### ### ##### ##### # ##### # ### ####### ##### # ### # ####### ### # # # ######### # #
         #   #   #       # #   # #   #     #   # #   #     #         # #   #       #   # # #   #   #   # #   # # #   #   #   # #
######## # ############### # ### ######### # # ### # ##### ### ### ### # ####### ### # # ### ##### # # # # ##### ### # # # ### #
     #   # # #   #         # #   # #     # # #   # # #   #   #   #     # #       #   # #   # #   # # #   # #   #   #   # # # # #
 ### # ### # # # # ##### ### # ### # ### # ### # # # # # ### ### # # ### # ####### ### ### # # ### # ##### ### ######### # # # #
 # # #   # #   # # #   #   # # # # #   # #   # #   #   # #   #   # # #   #   #   # # #   # # #   # #     #       #   #   # #   #
 # # ### # ##### # # ##### # # # # ### # ### ########### # ### ### ### ####### # # # ### # # ### # ############### # ##### ### #
   #     #         #       #   #       #                 #   #   #     #       #   #       #     #                 #       #   #
################################################################################################################################
