################################################################################################################################
################################################################################################################################
       #       #               #   #             #                 #       # #   #       #                             #   #   #
 ####### ##### # ##### # ####### # # ########### # ################# ##### # # # ### ### # ######### # ### ####### # # ### # # #
       # #     # #   # # #       #   #   #       #   #       #   #   #     #   #   #   # #   #   #   # # # #       # #   # # # #
 ##### # ######### # ### # ########### ### ######### ### ### # # # ### ########### ##### # ### # ##### # # ######### # # # # ###
 #     #       #   #     # #   #   #     # #     # #   #   #   #   #   #         #             #     # # #     #     # #   #   #
 ############# # ### ##### # ### # # ### # ##### # ### ### ######### ##### ####### ####### ######### # # ##### # ### # ####### #
             #   # # #     #     #   #   #     # #   # #   #   #   #     # #   #   #     #   #   #   # #       # #   #         #
 ####### ### ##### # # ########### ########### # # # # # ##### ### ##### # # ### ### ### # # # ### ### ######### # #############
   #   #   #     #   #   #     #   #           #   # #   #           #   #   #   #   # # # # #     #   #         #             #
## ### ### # ##### ##### # ### # ### ########### ######### ########### ##### # ### ### # ### ### ##### # ####### ########### # #
 #     # # # #     #   # #   # # #   #   #   #   #             #   #   #   #     # #   #   #   # #   # #     # # #     #   # # #
 ##### # # # # ##### # # ### ### # ### # # # # # # ##### ####### # # ### # ##### # # ##### ### ### # # # ### # # ##### # # ### #
 #     # # # #   #   # #   #     #   # # # # # #   #   #       # #   #   #   #   # #     #   #   # # # #   # # #       # #   # #
 # ##### # # ### # ### ### ##### ### # # # # ##### ### ####### # ########### # ### ##### # # ### ### # ### # # ######### ### # #
 # #     # # # # #   #   # #   #   #   # # #     # #     #   # #   #     # # # #   #   # # # # #   # #   # # #   #     # # #   #
 # ### ### # # # ### ### # # # # # ##### # ##### # # ### # ### ### # ### # # # # ### ### ### # ### # # # # # ### # ##### # ### #
       #   #   # #   # # # # #   #     #   #   # #   #   # #   # # # #   #       #   #   #   #   #   # # # #       #   # #   # #
###### # ####### ##### # # # ####### # ####### # ##### ### # ### # ### ### ####### ### ### ##### ####### # ######### # # # ### #
   # # #               # # # #     # #       # # #     # #   #   # #   #         #   #     #       #     #   #   #   # # #     #
 # # # ############### # # ### ### ######### # # ##### # ##### ### # ### ####### # ############### # # ##### # # # ### # ##### #
 # # #       # #     #   # #   #       #   # # #     # #   #   # # #   #   #     #         #   #   # #     # # # # # #   #     #
 # # ####### # # ### ##### # ######### # # # # ##### # # # # ### # ### # # ####### ######### # # ### ##### # # # # # ##### ### #
 #             # #   #   # # #     #   # #   #     # #   # #     #   # # # #   #         #   #   #   #   # # # # # #     # #   #
## ##### ####### # ### # # # # ### ### # ##### ### # ##### # ####### # # ### # ######### # ########### # # ### ### # ### # # ###
   #   #   #     #     # # # #   #   # #     #   # # #   # # #           #   #     #   #   #           # #   #   # #   # # #   #
 ### # ### # ########### # ##### ### # ##### ### # # # ### # # ##### ##### ####### # # # ### ########### ### ### # ### ### ### #
   # #   # #   #     # # #       # # # #         # # #       # #   # #   #   #     # # #   # #   #     #     #   #   # #   #   #
 ### ### ##### # ### # # ######### # # ########### # # ####### # # # # # ### # ##### # ### # ### ### ######### ##### # # ### ###
 #   #   #     # #   # #           # #     #       # # #   #   # # # # # #   #       # #     #   #   #   #   #       #   #   # #
 # ####### ##### # ### ############# ##### ### ##### # ### # ##### # # # # ########### ####### ### ### # ### ########### # ### #
   # #     #     #         #         # #   #   #     # #   # #   # # # #   #   # #   #   #       # #   #     #           #     #
 ### # ######### ##### ### # ######### # ### # # ##### # # # ### # # # ##### # # # # ### # ##### # # ######### ######### #######
 #   # #       # #     #   # #     # # #     # # # #   # # # #   #   #     # # #   # #   # #   #   # #     # # #         #     #
 # # # ### ### ### ##### ### ### # # # ####### # # # ##### # # ##### ##### # ### ### # ### # # ##### # ### # # ######### # ### #
 # # #     # #   #   #   #   #   # # # # #   # # #     #   #   #     #   #   #   #   # # #   #   #   #   #   # #       #     # #
 # ######### ### # # ### ### # ### # # # # ### # ##### # ####### ### ### ##### ### # # # # ##### # ##### ##### # ##### ### ### #
 #     #         # #   #     # # # #   # # #   #     # #       # # #   # #   #   # # # # #   # # #     #     #   #   #   # #   #
 ### # # ######### ### ####### # # # ### # # ####### # # ####### # ### # # # ### # ### # ### # # ##### ##### ####### # # ### ###
     # #       #     # #   #   # # # #   # # # #   # # # #   #   #       # #     #     #       # #   # #     #       # #   #   #
###### ####### ####### # ### ### # # # ### # # # ### # # # # # ######### # ############# ##### ### ### # ### # ####### ### ### #
   #         #         # #   #           # #     #         # #   #     #     #   #   #   #   #     #   # #   # #     # #   #   #
 # # # ##### ########### # ### ########### # ##### ####### ##### # ### # ### # # # # ##### # ##### # ##### ### # ### ### ### # #
 # # #   #               # # # #           # #       #   # #     # #     #   # # # # #   # #             #   #   # #     #   # #
## ##### # ######### ##### # # # ########### # ####### # ### ##### # ##### ### # # # # # ############### # # ##### ######### # #
   #     #   #     #     # # # # #       #   # #   #   # #   #   # # #     #   #   #   #     #   #         #   #   #   #     # #
 ### ### ##### ### ##### # # # # # # ### # ### ### # ### # ##### # # # ##### ############### # # # ### ####### # # # ### # ### #
 #   # # #     # #     # # #   # # # #             #   # #       # # #     # # #   #   #   #   # # #   #     #   # #   # #   # #
 # ### # # ##### ##### # # # ### ### ### ######### ### # ######### ####### # # # # # # # # ##### ### ### ### ######### # ### # #
 # # #   # #     #   # #   #   #   #   #   #     #   # # #       #       #   #   #   # # # #   #   #   # #         #   #   # # #
 # # ### # # ##### # # ####### ### ### ### # ### ### # ### ############# ############# # ### # ### # # # ######### # ##### # # #
 # #     # #   #   #   #               #   #   #         #   # #       #     #   #    G# #   #     # # #   #   # #         # # #
 # # # ### # # # ####### ##### ######### ############### ### # # ### ####### # # ### ### # ######### ##### # # # # # ##### # # #
 # # # #   # # #       # #     #     #   #                 # # #   #   #     # #   # # # # #       #   # #   #   # # #   # # # #
 # # # # ### ######### # # ##### ### # # # ############### # # ### ### # ######### # # # # # ######### # ######### # # # ### # #
 # # # #   # #       # # #     # #     # #   # #         #   # #   #   #         # # # # # #   #       #   #       # # # #   # #
 # ### ### # # ##### # # ##### # ########### # # ####### ### # # ############### # # # # # ### # ####### # # ### ### # # # #####
 # #   #   #       # # # #     # #   #     #   # #   #     #   # # #   #     #   # #   # # #     #       #   #   #S  # # #     #
 # # ### ######### # # ### ### # # # # # # ##### # # ##### ### # # # # # ### # ### # ### # ##### # ##### ##### ### ### ####### #
   # #   #   #   # # #   # #   #   #   # #     # # #     #   #     # #   #   # #     #   #     # # #   # # #     #   #       # #
#### # ##### # ### # ### # ########### # ##### # ####### ### # ### # ##### ### # ##### ####### # ### # # # # ### ### ####### # #
   # # #     #     #   #   #         # #   #   #         #     #   # #   #     #     #         #     #   #   #   #   #   #   # #
 ### # # ##### ####### ##### ####### ##### # ################### # # # # ####### ### ######################### # # ### # # ### #
     #   #     #   #   #     #       #   # # #   #   #   #       # # # # #   #   #   #     #   #   #           # # #   # #     #
#### ##### ##### # # ### ####### ##### # # # ### ### # # # ####### # ### # # ### ##### ##### # # # # ### ######### ### #########
   #       # #   # #   #       #   #   #   #   # #     # # #   #   #     # #   #       #     # # #   #   # #     # #   #       #
## # # # ### # ### ### ####### ### # # ####### # # ####### # # # ######### ### ##### ### ##### # ### # ### # ### # # # # #######
   # # #   #   #     #   #     #   # #       #       #   #   # #           #       # #   #   # # #   # #   #   #   # #         #
 ### # ### ######### ### # ##### ### ####### # ####### # ##### ### # ### ######### # # ### # ### # # # # ##### ##### ######### #
 #   #   # #       #     # #   #   #       # # #       #   #   #   #   # #     #   # # #   # #   # # #   #     #   # #     # # #
 # ##### # # ##### ### ### # ##### # ##### # ### ######### # # ######### # ### # ### # # ### # ##### ##### ### ### # # ### # # #
 # #     # # #     #   #   #     # # #   # #   # #     #   # # #   #   #   # # #   # # # #     #     #   #   # #   # # #   # # #
 # # ##### # # ##### # # ####### # # # # ##### # ##### # ### # # # # # ### # # ### # # # ####### # ### # ### ### ##### ##### # #
 # # #     # #   #   # #       # # # # # #     #     #   #   # # #   #   # #   #       #       # #     #   #   #     #   #   # #
 # # # # ####### # # ######### # # ### # # ### ##### ##### ### # ####### ############# ####### # ######### ### ##### ### ### # #
   # # #     #   # #         # # #     #   #   #   #     #   # #       # #       #   # #   #   # #   #   #   # #   #   #   # # #
#### ####### # ### ########### # # ######### # # # ##### ### # ####### # # ##### # # # # # # ### # # # # # # # # # ### ### # # #
   #       # # # #     #       #   #       # #   #     # #   #   #   # #   # #   # #     # #   #   # # #   # #   #     # # #   #
 # ####### # # # ### # # ####### ### ##### ##### ##### # ######### # # ##### # ##### ######### ##### # ##### ########### # # ###
 #   #     #   #   # # #   #     #   #   # #   # #     #     #     # # #   #   #     #       #     # # #   #           #   #   #
 ### # ########### # # ### ####### ### # # # # # # ######### # ##### # # ### ##### ### ##### ##### # # # # ######### ### ##### #
 #   # #   # #   # # #   #     #   #   # #   # # #       #   # #       #   # #     #   #   # #   # # #   #         #     #   # #
 # ### ### # # # # # ### ##### # ####### ##### # ######### ### ########### # # ### # # # ### # # # ### ########### # ##### # # #
 #   # #   # # # # #   #     # # # #   #     # #   #       #   #     #     # # #   # # # #   # # #   #   #   #     #       #   #
 ##### # ### # # # ### # # ### # # # # # ##### ##### ######### # ### ### ### ### # # ### # ### # ### # # # # # ########### #####
       #     # # #     # # #   # #   #   #   #   #   #   #   # #   # #   #   #   # #   # #   # #     # # # # #     #     #     #
########## ### ########### # ### # ####### # ### # ### # # # # ##### # ### ### ### ### # ### # ####### # ### ##### # ### ##### #
           #   #   #       #     #     #   #     #     #   # # #     #   # #   # #   #   # # # #   #   #   #   #   # # #     # #
 ######### # ### # ##### ######### ##### ################### # # ####### # # ### ### ##### # # # # # # ### # ### ### # ##### # #
   # #     #     #     #         # #   # #   #   # #   #   #   # #   #       #   #   #     # # # # # #   #   #   # # #         #
## # # ############### ### # ### # # # # # # # # # # # # # ##### ### ########### # ### ### # # # # # # # ##### ### # ###########
   #   #     #   #   #   # #   #   # #   # #   # #   #   # #   #   #   #   #   # #   # #   #   # # # # # #     #   #           #
 ### ### ### # # # # ### # ######### ### # ##### ### ####### # ### ### # # # # # # ### # ####### # ### ### ####### ####### ### #
   # #     # # #   #   #   #         #   #     #   # #   #   # #   # #   # # #   # #   #     #   # #   #   #     #       #   # #
#### # ### ### ####### ### # # ############# ##### # # # # ### # ### ##### # ##### # ####### # ### # # # ### ### ####### ##### #
     # #   #   #   #       # # #   #       # #   # # # #   #   #   #     # #       #       # #   #   # #       #   #   #       #
 ##### # ### ### # # # ### # ### # # ### ### # # # # # ####### ### ##### # # ############# # ############### # ### # # ####### #
       #   #   # # # # #   # #   # #   #     # # # #   #     #   #     #     #   #       # #               # #   # # #         #
 ############# ### # # ### # # ### ### ####### ### # ### ### ######### # ##### # # ##### # ############### ####### ####### #####
           # #     # #   # #   # #     #     # #   #   # #         # #   #   # #   #   # #   #       #     #       #       #   #
 ######### # ####### ### # ##### ####### ### # # ##### # ######### # ### # # # ##### # # ### # ##### ####### ####### ######### #
   #   #   #         #   #             # # # #   #   # # #   #   # #   # # # # #   # # #   # #   # #         #               # #
## # # # ### # ### ### ### # ### ### # # # # ##### # # # # # # # # # ### # ### # ### # ### # ### # ########### ### # ####### # #
   # #   #   #   #   # #   #   #   # # # # #   #   #   # # # # #   #     #   # #     #     #     #             #   #   #     # #
 ######### ######### # ####### # # # ### # # # # # ##### ### # ##### ####### # ####################### ##### ### ### # # ##### #
     #   #     #     #   #     # # #     #   #   # #   #     # #   #   #     # # #     #               #   #   # #   # #       #
#### # # ##### # # ##### ####### # ################# # ####### # ### # # ##### # # ### # ### # ####### # # ##### # # ###########
   # # #       # # #   #   #     #               #   #     #   # #   # # #     # # #   # #   #       # # # #     # # #   #   # #
## # ########### # # # ### ######### ########### # ### ##### ### # ### # # ##### # ##### # ######### ### # # ##### ### ### # # #
   # #           # # #   #         #   #       # #   #     # # # #   # # # #     # #     #   #     #     # #     #     #   #   #
 # # # ########### # ### ##### ### # ### ####### ### ##### # # # ### # # # # ### # # ##### ### ### ### ### ##### ####### #######
 # # #   # #       #   #     #   # # #   #       #   #   #   #   #   #   # # #   #   #     #   # #   #   #     #         #     #
 # # ### # # # # # ### ##### ##### # # ##### ### # ### ####### ### ####### # ### ######### # ### ### ####### # ########### ### #
 #   #   #   # # #   # #   #     # # # #     #   # #   #           #     # # #             #   # #       #   #   #         # # #
#### # ##### ### # # # ### ##### # ### ### ### # # ### # # ######### ### # # # ### ### ####### # ####### # ### # # ######### # #
   # # #     #   # # #   # #   # #   #     #   # #   #   # #         #   # # #   #   #       # #     # # # # # # # #         # #
 # # # # ##### ### # ### # # ### ### ####### ### ### ##### # ############# # ############### # ##### # # # # # # ### ##### ### #
 # #   # #   #   # #   # # #   #     #       #   # # #   # #     #     #   # # #     #       #     # # # # # # # #     #   #   #
 # ##### # ####### ##### # ### ####### ####### # # # # # # ##### # ### # ### # # ### # ##### ##### # # # # # # # # ##### ### ###
 # #   #   #     #     # #             #     # # # # # #       # #   #   #     # #   # #       #   # # #   # # #   #     #   # #
 ### # ##### ### ##### # # ####### # ####### # # # # ####### # # ### ####### ### # ### # # # # # ### # ##### # # ### ##### ### #
 #   # #   #   # #     # # #   #   #   #     # # # #         # # #   #       #   #     # # # # #   # # #   #   #   #   #   #   #
 # ### # # ### # # ##### # # # # # ### # ####### # ########### # # ##### # ### ########### # # ### # # ### ##### # ### # ##### #
   # # # #   # #   #     # # # # # # # # # #     #   #     #   # # #   # #   # #   #   #   # # # # # #   #       #   #   #   # #
#### # # ### ####### ##### # ### # # # # # # # ##### # ### # # # # # # ####### # ### # # ### # # # # ### ######### # ####### # #
         #           #     #     #   #   #   #       #   #   #       #         #     #   #   #   #   #             #           #
################################################################################################################################
