################################################################################################################################
#         #   #     #     #   #                           #     #           #   #       #   #                       #     #     
# ####### # # # ### # ### # # # ####### ### ############# # ##### # # ##### # ### ##### # # ##### ##### ############# ### # ### 
# #   # #   # # #   #   #   # # #     # #   #   #   #     #   #   # #     #   #   #   # # #       #   # #   #         #   #   # 
# # # # ##### # ### ### ##### # # ### ### ### # # # # ####### # ### # ######### ### # # # ######### # ### # # ######### ##### ##
# # #   #     #   # #   #     #   # #  G#     # # # # #       # #   # #       #   # # # #   #   # # #     #   #     # #   #     
# # ### ######### # # ######### ### ### ####### # # # # # ##### # ##### ##### ### # ### ### ### # # ############# # # ### ##### 
#   # #   #       # #     #   #     #   #     #   # #   # #     #         #   #   # #   # # #   # #     #         #   #   #   # 
##### ### # # ##### ##### # # # ##### # # ### # ### ##### # ############### # # ### # ### # # ### ##### ##### ####### # ### # # 
# #   #   # #     #     # # # # #     # # # # # #   #   #       #   #   #   # #   #   #   # #     #   #       #   # # # #   # # 
# # # # ######### # # # # # ### # ##### # # # # # ### # ### ##### # # # # # ##### ####### # ##### # # ######### # # # # # ### # 
#   # #   #       # # # # #     #     # # # # # # #   #     #     # # # # # #     #     # #       # # #       # # # # # # # #   
##### ### # ####### # # # ########### # # # # # # # ####### # ##### # ### ### ##### ### # # ####### # ####### ### # # # # # ### 
#     # #   #       # # #       #     # # # # # # #   #   # #   #   #     #   #   # # # #   #     # # #     #   # # # # # #   # 
# ##### ######### # # # ####### # ##### # # # ### ### # # # ### ########### ### # # # # # ### ### # # # ### ### # # # ### ### # 
# #         #     # # #     # #   #   # # # #   # #   # # #   #     #       #   #   # # #       # # #   # #   # # # #     #   # 
# # ##### # # ##### # ##### # ##### ### # # ### ### ### # ### ##### # ############### # # ####### # ##### ### # # # ####### ### 
# #     # # # #     #     # #   #   #   #   # #     # # #   #     # # #           #     #     #   #         #             #   # 
# # ### # # # # ######### # ### # ### # ##### ####### # ### ##### # # ####### ### # ##### ### # ### ####################### # # 
# #   # # #   #   #   # # #   # #     #               # #         # #         #   #   #     # #     #                       # # 
# # ### # # ####### # # # ### # ####### ######### ### # ######### # ########### ##### # ### ######### ####################### # 
# #   # # # #     # #   # # #   #   #           #   # #         # #       #     #       #   #       # #           #       # #   
# ### # # ### ### # ##### # ### # ### ##### ### ### ########### # ####### # ##### ####### ### ##### # # ### # ### # ##### # ####
# #   # #   # #   #       #     #     #   #   #   #   #   #   # #   #     #     # #     # #       # # # #   #   # # #   #       
# ##### ### # # ############### ##### # # ####### ### # ### # ##### # ######### # # ### ### ####### # # # ### # # ### # ####### 
#       #   # #         # #   #       # #       #   #   #   #   #   #       #   # # #   #   #     #   # # #   # #     #   #     
####### # ### ### ### # # # # ##### ### ####### ### ### # ##### ### ##### ### ### # ##### ### ### # ### # ### # ######### # ####
#       #     # #   # # # # #     # #   #     #   #   # #     #   #       #   #     #       #   # #     #   # # #       #   #   
# ##### ####### ### # # # # ##### ### ####### ### # # ####### ### # ####### ##### ### ########### # ####### # # # # ######### # 
# #           #   # # #   # #   #     #   #   #   # #   #     #   # #     #     # #   #           #       # # #   #           # 
# ######### ### # # ### ### # ######### # # # # ####### # ######### # ### ##### # # ### ##### ######### # # ### ######### # ####
#   #     #     # #   # #   #     #     #   # # #       #       # # #   # #   #     #   #   #   #     # # #   #     #   # # #   
### # ### ########### ### ####### # ######### # ### ########### # # ### ### # # ##### ### # ### # ### # ##### ### # ### # ### # 
#   #   #           # #   #     #   #   #   # # #   #     #   # #           #   #   #   # #   # # #   # #   # #   #     #     # 
# ##### ############# # ### ### ##### ### # # # # ####### # # # ######### ####### # ### # ### # # # ##### ### # ### ########### 
#       #   #   #   # #   # #   #         #   #   #   #   # # #         #   #     # #   # # # # # #     # #   # #   #     #     
# ######### # # # # ##### ### ### ################# # ### # # ######### # # # ##### # ### # # ### ##### # # ### ##### ### # ### 
#         # # #   #     #   #   # #     #         # #   #   #         # # #   #   #   #   #   #   #   # #   #       # #     #   
# # ##### # # ######### ### ### # # ### # ######### ### ### ######### # # ##### ####### ##### # ##### # ##### ##### # ######### 
# # #   #   #       #   #   #   # # # #   #       # # #   # #       # # #       #     #     #   #     #   #   #   # #         # 
# ### # ########### ### # ### ### # # ##### ##### # # ### # # # ##### # ### ##### ### ##### ######### ### ### # # # ######### ##
# #   # #         #   #   # #   # # #       #   # # #     #   # #     #   # #     # #       #       #   # #   # # #     #   #   
# # ### # ####### ### ##### ### # # # ####### ### # ####### ### # ####### # # ##### ######### # ### # # # # ### # ####### # ### 
# # #   #       #   #   #             #       #   #S#     #   # # #     #   #       #   #     #   #   #   # #   #     #   #     
# # # ######### ### ### # ################# ### ### # ### # # # # # ####### ######### ### # # ######### ##### ####### # ########
#   #   #   #   # # #   # #       #   #   # #   #   #   #   # # #     #   #   #     #     # # #       # #   #     # # # #       
# ##### # # ##### # # ##### ##### # # # # # # ### ##### ##### # ####### # ### # ### ##### # # # ##### # # # ##### # # ### ##### 
# #   #   #       # #     #   # #   # # # # #   #     # #   # #     #   # # # #   # #     # # # #   # #   # #     # #   # #   # 
# ### ######### ### ##### ### # ##### # # # ### ##### # # # # # ### # ### # # ### # # ##### # # # ### # ##### ##### ### # # # # 
#   #   #     #         #   # #   # #   # #       # # # # # # # #   # #   #       # #     # # #   #   #     # #   # # #   # # # 
# # ### # ### # ########### # ### # ##### ####### # # # # ### ### ### # ########### ##### # # ##### ####### # # # # # ####### # 
# #     #   # #     #       # #       #   #   # #   # #   #   #   #   #         #   #     # # #   # #   #       #   # #       # 
# ######### # # ### # ####### # ##### # ### # # # ### # ### ### # # ########### # ### ##### # ### # # # # # ##### ### # ####### 
#     #     # # #   # #       #   #   # #   #     #   # #   #   # #   #   #     #     #   # #   # # # # # # #   #         # #   
# ### # ##### ### ### # ####### # ##### ####### ### ### # ########### # ### ########### # # ### # # # # # # # # ######### # # ##
#   # #     #   #   #       #   #   #   #   #   #   # # #   #         #   #       #   # #     #   #   # # # # #         #   # # 
##### ##### ### # # ####### # ##### # ### # # # # ### # ### # ########### ####### # # # ####### ####### # # # ######### ##### # 
#     #   # #   # # #     #   #     # #   #   # # #     #   #   #       #     # #   # #   #   # #       # # # #       #     #   
# ##### # # ##### # # ### ### # ### # ######### # ##### ####### # ##### ##### # ##### # # # # ### ####### # # ####### ##### ####
#   #   # #     # # # # #   # # #   #   #       #     #   #   # # #     #   #     #   # # # #   # # #   # # #   #   #   # # #   
# # # ######### # # # # ### ### ### ### ####### ##### ### # # # # ####### # ### ### ##### # ### # # # ### # ### # ##### # # # # 
# #   #         # # # #   #   #   # #   #     #         # # # # #   #     #     #   #   # # # #   #       #     # #   # # #   # 
# ##### ########### # # ##### ### # # ### ### ######### # # # # ### # ######### # ### # # # # ############### ### # ### # ##### 
# #   #   #         # #   # # #   # # #     #   #   # #   # # # #     #               #   # #       #   #   # #   # #         # 
# # # ### # ######### # # # # ##### # # ### ### # # # # ### # # ####### ####### ########### ### # # # # # # # # ### # ##### ### 
#   #   # #   #       # # # #     # # # #   # # # # #   #   # #       # #     # #     #     #   # # # #   # # #       #   # #   
####### # ### # ####### # # ##### ### # # ### # # # ### # ### ####### # # ### ### ### # ######### # # ##### # ##### ### # # # ##
#       # #   # #       #   #   # #   # # #       #   # #   # #   #   # # #     #   #   # #       #   #     #         # # # #   
# ##### # ##### # ########### ### # ### # # ######### # ### ### # # ### # ##### ### ##### # # ############# ####### ### # ### # 
# #     #       #         #     # # # # # # #     #       #   # #   #   #   # # #     # #   # #     #     #   #   # #   #   # # 
# # ### ################# ##### # # # # # ### ##### ######### # ####### ### # # ##### # ### # # ### # ### ### # # # # ##### ### 
# #   # #   #           # #   # #   #   #     #     #       # #       # # # # #   #   #     #   #   # #   # # # #   # #   #     
# ### # # # ##### ### # # # # # ######### ##### ### # ##### # ####### # # # # ### # ################# ##### # # ##### # ####### 
# # # # # #     # #   #     #           #     #   # #   #   # #   # # #   # # #   #         #       #   #   # #   #   #         
# # # # ####### ### ################# # ### ##### # ##### ### # # # # ### # # # ########### # ##### ### # ### ### ####### # ### 
# #   #       #   # #   #     #       #   # #   # #         # # #   #   # #   #   # #       # #   #     #         #   #   #   # 
# ####### ### ### ### # # ### # ######### # # # # ##### ##### # ####### ######### # # ####### # # ####### ######### # ######### 
#   #   # #   #   #   #   #   # #     #   # # # # #   #     # # # #     #         #   #         #                   #         # 
### # # ### ### ### ####### ### # ##### ##### # ### # # ### # # # # ##### ######### ### # ##### ########################### # # 
# #   #   #   #   # #   #   # #   #     #     #     # # #   #     #     # #       #     #     #         #         #       # # # 
# # ##### ### ### # # ### ### ##### ##### ########### # ##### ######### # # ##### ### ####### # ####### # ##### # # ##### ### # 
# #     # #     # # #   # #       #   # # #       #     #   # #         # # #   #     #   # # #       #   # #   # #     #   # # 
# # ##### # ##### # ### # # ######### # # # ##### ##### # # # # ######### # # # ####### # # # # # ######### # ### ######### # # 
# # #     #       #   #   #   #     # #   # #   #     #   #   # #       # # # # #   #   # #   # # #     #   #   #     #   #   # 
# ### ##### ######### ####### # ##### # ### # # ##### # ####### # ##### # # # ### # # ### ####### # ### # ##### # ##### # ######
#   # #   #       #   #     #     #   # #   # #   # #   #     # #     # #   #   # #   #   #     # # # # #       # #   # #   #   
### # # # # # # # # ####### ##### # ##### ####### # ### # ### # # ##### ### ### # ######### ### ### # # ########### # # ### # # 
# #   # # # # # #   #     #   #   # #   #   #     #     #   # #   #   # #       #   #   #   #     # # # #       #   # # # # # # 
# ##### ### ### # ### ### ### # ### ### ### # ##### ####### # ##### # # # ##### ### # # # # ##### # # # # ##### # ##### # # ### 
#     #   #   # #   # # #   # # #   #   # #   #   # #   #   #     # # # #   #         # # # #   #   #     #   # #   #   # #     
##### ### ### # # # # # ### # # # ### ### ##### # # # # # ####### # # # ##### ######### # # # ############# ### # ### ### ######
#       #     # # #   #   # # # #             # #   # #   #     #   # # #   # #     # # # # #           # #       #   #         
# ### ######### # ####### # # # # ########### # ##### ##### ### ##### # # # # # ### # # # # ########### # ### ### # ### ####### 
# # # #   #     #         # #         #     #   #     #     # # #   # # # # # # # # #   # # #       #   #   # #   # #   #     # 
# # # # ### ##### ### ##### ##### ### # ### # ### ##### ##### # # # # ### # ### # # # ### # # ##### # ##### # # # # ##### ### # 
#   # #     #       # #   # #   #   #     # #   # #   #   # # #   # #     #     # # #   # # #   # #   #     # # # # #   # #   # 
##### ####### ### # # # # # # # # # ####### ### # # # ### # # ##### ############# # ### # ##### # ##### ##### # # # # # # ##### 
#   #       # #   # # # # #   # # #   # #   #   # # #     # #   #   #       #     #     # #   #   #           # # #   #       # 
# # ### # # # ##### # # ####### # ### # # ### ### # ####### ### # ### # ### # ######### # # # ### ##### ####### # ##### # ### # 
# # #   # # # #   # # #         # #   #   #   #   #   #       # # #   #   # #     #     #   #     #   # #       #   #   # # # # 
# # ##### # # # # # # ########### # ####### ### ##### # ####### # # ####### # ### # ############### # # # ### ### # ### # # # # 
# # #   # # # # #   #       #   # # #     #   # #       #     #   #   #   #   #             #       #   #   # #   #     # #   # 
# # # # # # # # ####### # ### # # # # ### ##### # ####### ### ##### ### # ##### ####### ### # ######### ### ### ######### ##### 
# #   #   # # #       # #   # # # #     #     # # #       #       # #   #     #   #   #   #   #         #   #   #       # #     
# ######### # ####### # ### ### # ####### ### # # # # ########### # # ####### ##### # ### ##### ##### ### # # ### ##### # ##### 
# #       #       #   # # #     # # #   # #   # # # # #         # # #   #   #     # #     #     #   # # # # #   #   #   #   #   
# # ##### ### ### # ### # ####### # # # # # # # # # # # ####### # ##### ### ##### # # ####### ### # # # # ##### ### # ##### # # 
# # #   # #   #   # #   # #   #     # # # # # #   # # #       # #     # #   #   #   # #     #   # # #   # #     #   # #     # # 
# # # # ### ### ### # ### # ### ##### # ### ####### ######### # ##### # # # ### ##### # ### ### # # ##### # ##### ### # ####### 
# #   #     #     # #     #     #     #     #   # #     #     # #   # # # #   #       # #     # # #       # #     # # #   #   # 
# ########### ##### # ##### ##### ##### ##### # # ##### # ##### # # # # # ### # # ### # ##### ### ######### # ##### # ### ### # 
#       #   #   #   #   #   #   #   # # #   # #     # #   #     # # #   # # # # # #   #     #   # #       # #   #   #   #     # 
##### # # # ##### ##### # ### ##### # # # # # ##### # ##### ##### # ##### # # # # ### ##### ### # # ##### # ### ### ### ####### 
#   # #   # #     #     # #       # # # # # # #     #     #       # #   #   #   #   #     #   #   #   # # #   #   #   #       # 
# # ####### # ##### # ### # ##### # # # # # ### ##### ############# # # ########### # # ##### ### ### # # # ##### # ######### # 
# #         # #     #   # # #     # #   # #     #             #   #   # #           # # #   # #     #   # #   #   #       #   # 
############# ##### ### # # ####### ##### ########### ####### # # ##### # ########### # # # # ######### # ### # ######### # ### 
#   #     #   #       #   # #       #     #     #   #     #   # #   #   # #   #   #   #   # #   #     # #   #   #     #   #     
# # # ### # ### ### # ##### # ####### ######### # # ##### # ### ##### ### # # # # ### ##### ### # # ### ######### ### # # ######
# #   #   #   # #   #       # #   #   #         # #   #   # #   #     # # # #   # #   #   # #   # #   # #     #   #     # #     
# ##### ##### # ### ### ##### # # # ### ############# # ##### ### ##### # # ##### # ##### # # # # ### # # ### # ######### # ### 
#   #   #   # #   #   # #     # #   #   #                 #   #     #   # # #     #   #   # # # #   # #   #   #   #   # # #   # 
# # # ### # # ### ##### # ##### ##### ##### ############# # ##### # ### # ### ##### # # ### # ##### # ##### ##### # # # # ### ##
# # # #   # #   #   #   # #     #   #     #         #   # # #   # #   # # #   #     #   #   #     # #   #   #   #   # #   #     
### # # ### ### ### # ### # ####### ##### ######### # # ### # # ##### # # # ### ######### ##### ### # ### ### ######### ####### 
#   # #   #   #   # #   #   # #   # #   # #         # #     # # #     # #   #         #   #   #     #     #         #   #     # 
# ### ### ### ### # ######### # # # # # # # ######### ####### # # ##### ########### # # ### # ############# ######### ####### # 
#   #     #       #             #     #             #         #   #                 # #     #                                   
