################################################################################################################################
################################################################################################################################
           #     #   #       #                     #   #   #   #         #       #   #   #           #   #     #           #   #
#### # ### ##### # # # # ##### ####### # ### ### # # # # # # # # ####### ####### # ### # ##### # ### # # # # ### ##### ##### # #
   # #   #   #     # # #       #   #   #   #   # # # # # # # # #   #   #       # # #   #   #   # #   # # # #     #   #   #   # #
 # ### # ### ### ##### ######### # # ##### ### # # # ### # ### ##### # ####### # # # ##### # ### ### ### # ####### # ##### ### #
 #   # # # #   #   #   #     #   #   # #   # # # # #     #   # #     #       # #   # #     #   #   #   # #   #     #       #   #
 ### ### # ### # # # ### ### # ####### # ### # # # ######### # # ### ##### ### ### # ############# ### # ### # ############# ###
 #       #   # # #   #   #   #   #     # # # # # # #       # # #   # #   #         #           #   #   #     #         #   #   #
 ########### # # ##### ### ##### # ##### # # # # # # ##### # # ##### # # ##### ############### ##### ### ##### ##### # # # ### #
     #   #   # #   #   # # # #   #   #   #     # #   #   #   #     # # #     #               # #     #   #     #   # # # # #   #
 ### # # # ### # ### ### # # # ##### # ######### ##### ########### # # ##### # ############# # # ##### ### ##### # ### # ### ###
   #   # #   # # #     #   # # #     #     #                         #     # #       #     # # #     # #     #   #   # #   # # #
 # ##### ### # # # ######### # # ######### # ### # ### ##### ####### ####### # ##### # ### # # ##### # # ##### ##### ##### # # #
 #     #     #             #   #     #   # # #   #   # #   #       #         #   # # # #   #   #   #   # #     #   # #     # # #
###### ############# ##### ##### ### ### # ### ##### # ### ####### ########### # # # # # ####### ##### # # ####### # # ##### # #
     #   #   #     #   #   #       #     # #   #     #   #       # # #         #   # # # #             # # #   #   #   #     # #
 ### # ### # # ### # # ######### # ####### # # # ####### ####### # # # ##### # ##### # # # # ########### # # # # # ##### # ### #
 # #   #   # #   # # #   #     # # #   #   # # # #     #   #   #   # #     # #     # # # # #   #   #     #   #   # #     # #   #
 # ##### ### ### # # ### # ### # ### # # ### ### ##### ### # # ##### ##### # ##### # ### # ### # # # ############# ##### # # ###
   #   #   #   # # # #   #   #   #   # # #   #   #     # # # #     #       #     # #     #   #   # # #   #       # #   # # #   #
 ### # ####### ### # ####### ### # ##### ##### ### ##### # # ##### ####### ### ### ####### ######### # ### ##### # # # ### ### #
   # # #                   #   # # #   #     # #   #   #   #   #   #   #     #   #   #             # # #   #     #   # #   # # #
#### # # ################# ### # # # # ##### # # ### # ####### ##### # ######### ### # ########### # # # ############# # ### # #
   # # #   #       #     # #   # # # #     # #   #   # #   #   #     #             # #   # #     #   # #           #   # # #   #
 # # # # # # ##### # ### # ##### # # ##### # ####### # # # # ### ####### ########### ### # # ######### ########### # ### # # ###
 # # # # # #   # # #   # #   #   # #   #   # #   #   #   # #     #       #         #   # #           # #   #     # #   # # #   #
 # ### # ##### # # ### # ### # ### ### ##### # # # ####### ####### ####### ####### ### # ########### # # # # ### # ### # # ### #
 #       #   # # # #   # #   #     #   #     # #   #   #     #     #   # # #   # #     #     #     # #   # #   #   # #   #   # #
 ### ##### ### # # ### ### ### ##### ### ##### ####### # ### # # # # # # # ### # ########### # ### # ### ##### ##### ####### # #
   # #     #   # #   #     #   #     #   #     #       # #     # #   #   # #   # #       #   #   # #   #     #   #         #   #
## # # ##### ### ### ######### # ##### ##### # # ####### ################# # ### # ##### # ####### ### ##### ### # ### ### ### #
   #   # #   #   #   #         # #     #   # #   #   # #                 # #     #     # #     #       #     #   # # # #     # #
#### ### # ##### # ##### ##### # ##### # # ### ##### # ######### # ####### # ######### # ##### # ### ### ##### ### # # ##### # #
   #   # #     # #     # #   # #     #   #   #           #   #   #     #   # #       # #   #   #   #       #   #     #     # # #
 # ### # ##### # ##### # ### # ##### ### ### ##### # ##### # # ######### ### # ##### # ### # ### # ### ### # ##### ######### # #
 # #         #     # # #     #   # #   # #   #   # #     # #   #       # #   #     #   # #   # # #   #   # #     # #   #       #
 # ##### ### ##### # # # ####### # ### ### ### # # ##### # ##### ##### # ### ##### ##### ##### # ### ### # ##### ### # # ### ###
 #     #   #       #   # #   #   #   #   # #   #   #     #     #     # #   # #     #           #   #   # #     #   # # #   #   #
 ##### ########### ####### # # ### # ### # # ################# ##### ##### # # ##### ############# ### ##### ##### # # # # #####
   #   #       #   #       # #     # # #   #     # #     #   # #   #       # #   #         #   #   # #     # #     # # # #     #
## # ### ##### # # # ####### ####### # ##### ### # # ### # # # # # ######### ### # ### ##### # # ### ##### ### ####### # ##### #
   #     #     # # # # #   #   #   # #     #   # # #   #   # # # #     #   # #   #   # #     #   #   #   #     #       #   #   #
 ######### ####### # # # # ### ### # # ### ### # # ### ##### # # ##### # # # # ### # ### ######### ### # ####### # # ##### # # #
 #       # #       #   # # #   #   #   # #     # # # # #   #   # #     # #   # #   #     #             #   #   # # #       # # #
 # ####### # ########### # # ### ####### ##### # # # # ### ##### # ##### ##### # ######### ### # ####### ### # # # ######### ###
 #     #   #       #   # #   #   # #           #     #   #       #   #   #     #   #     #   # #   #   # #   # # #   #     #   #
 ##### # ### ### # # ### ##### ### # ####### ##### ##### # ######### # ### ####### # ### # # # ##### # # # ### # ### # ### ### #
 #   # #   #   # #   #   #     #     #       #   #   #   # #     #   # #   #       #   #   # #   #   # #   #   #   #   # #   # #
 # ### ### # # ####### ### ########### ##### # # ##### ### # ### ### # # ######### # ####### ### # ### ########### ##### ### ###
   #   #   # #   #   # # # #     #     #     # # #     #   #   # #               # #       #   # # # #   #       #         #   #
## # ### ### ### # # # # # # ### # ########### # # ##### ##### ### # ########### # # ##### ### # # # ### # ### ### ########### #
   #     #     # # #   # # # #   #          G# #   #   #   #   #   # #     # #   #   #   # #   #       #   # # #   #           #
 ######### ### # # ##### # # # ### ######### # ##### # ### # ### ### # ### # # ##### # # # ######### # ##### # # ### ###########
     #   #   # #   #     #   # #       #   # #     # #   # #     #   #   # #   #   #   # #     #   # #   #   #   #   #   #   # #
#### ### ### # ##### ######### # ##### # # # ##### # ##### ####### ##### # ### ### # ### ##### # # ##### ### ##### ##### # # # #
     #       #   #     #     # # #   # # #     #   #       #       #   # #             #   #   # # #   #   # #   #     # # # # #
 ##### ######### # ### # ##### # # # ### # ##### ########### ####### # ####### ########### # ### # # # ### # # # ##### # # # # #
   #     #       #   #   #     # # #     # #   # #           #       # #     # #     #   # #     #   # #   # # # #     # # # # #
## # ### ######### # ##### ##### # ####### # # # ########### # ####### # ### # # ### # ### ########### # ### ### # # ### # # # #
 # # # #       #   #       #     #   #   # # #   #         # #   #   # # # # #   #   #     #   # #   # #   #   # # # #   # # # #
 # # # # ##### # ########### # # ### # # # # ### # ####### ##### # ### # # # # ### ######### # # # # # ### ### # # ### ### # # #
   # # # #     #     #       # #   #   # # #   # # #     #     # #   #   # # #   # # #   #   #   # # #   #     # #   # #   # # #
 ### # ### ######### ######### ### ##### # ### ### # ######### # ### ### # # ### # # # ### ##### # # ### # ##### ### # ### # # #
 #   #     #       # #   #   #   #   #   #   # #   #     #   #   # #   #   # #   # #       #     # #   # # #     #   #   # # # #
 # ############### # # # # # # ####### ### ### # ####### # ####### ### # ### # ### ######### ### # ##### # # # # # # ### # # # #
 # #     #       # # # # # # # #       #   #   #   #   #   #         # # #   # # #         #   # #   #   #   # # # # #   # # # #
 # # ##### ##### # # # # # # # # ### ##### # ##### # # ### # ##### # # ### ### # ######### ### # ### # ### ### # # ### ### # # #
     #   # #   # #     # # # # #   # #   # #       # # #   #   # # # #   # #   # #       # #   #   #   #   #   # #   # #   # # #
 ##### # # ### # ####### # ### ### ### # # ########### # ##### # # ##### # # ### # ##### # # ##### ##### # # ####### # # ### # #
   #   # #   # #       # #       #     # #                     # # #   #   #     #     # # # #   #       # #       #   # # #   #
 # # ### ### # ####### # ####### ####### ### ##### # ######### # # # # ####### ####### # # # # # ##### # # ##### ####### # ### #
 #   # #   # #       # #   #     # #     #   #     #   #     # #   # #         #     # #   # # # #   # # #     #     # #   # # #
 ##### ### # ####### # ### ##### # # ##### ### ####### # ### ####### ##### # ### ### # ##### # # # # # # ##### ##### # ##### # #
 #   #   #   #     # # # #     #   # #       #       #     #         # #   #   #   #   #   #   # # # # # #   # #   # # # #     #
 # # ### ##### ### # # # ##### # ### ####### ### ### ########### ##### # ####### # ####### ##### # # # # # # # # # # # # # #####
   #         # #   # # #       #   #       #   #   #   #   #   #       # #     # #   # #   #   # # #   # # # # # #   #   #   # #
########## ### # ### # # ##### # ######### ### ### ### # # # # ### ### # # ### ### # # # ### # ### ##### # # ### ####### ### # #
   #   #   #   # #     # #   # # #   #   # # #   #   #   # # #   #   # #   # #   # # #       #     #     # # #   #   # # # # # #
 ### # # ### ### ##### ### # # ### # # # # # ### ### ####### ### ### # ##### ### ### ############# # ### # ### ##### # # # # # #
     #   # # # #     # #   # #     # # #   #   #   # #       # # #   #         #   #     # #     # #   # #     #     #   # #   #
 ######### # # ##### ### ### ####### # ####### ### ### ####### # ################# ##### # # ##### ### ######### ##### ### ### #
 #       # # #     #   # #   #     # # #         #   #   #     # #       #   #     #     # #     #   #         # #           # #
 ### ### # # # ### ### ### ### # ### # ### ##### ### ### # # ### # ##### # # # ##### ##### ##### ### ##### # # # # # # ####### #
     #     #   # # # #     # # #     # #   #   #   # #   # # #   #   # # # # # #     #         #     #     # #   # # #   #     #
###### ######### # # ####### # ####### # # # # # # # ##### # # ##### # # # # # ### ########### ##### # ##### # ### # ##### #####
         #   # # #   #   #   #     #   # # # # # # #   #   #   #     #   # # #   #     #             # # #   #     #       #   #
 ####### # # # # ### # # # ####### # ### # # # # # ### # ######### ### ### # ### ##### # ############# # # ### # ### ######### #
   #   #   #   #   # # #         # # #   # # # # #   #   #         # #   # #   #S# #   # #             # # # # #   #           #
#### # # ####### ### ########### # # ####### # ### # ########### ### ### # ### # # # ### # ############# # # # # # # # #########
     # #         #   #   # #   # # #   #   # #     #       #     #   # # #   # # #   #   # #   #     #   # #   # # # #     #   #
 ##### # ######### ### # # # # # # ### # # ####### ### # # # ##### # # # ### # # ##### ### # # # ##### ### ####### # # ##### # #
   #     #         # # # #   #   #     # #       # #   # #   #     #   # #   #   # #   # # # #   #   #   #   #   # # #       # #
#### ##### ######### # # ### ########### ####### ### ### ##### ####### # # ####### # # # # # ##### # ### # # ### # # ######### #
   # #     #       #   #   # #     #   # #     # #   #   # #   # #     # #     #     #   # # #   # #     # #   #   # #   #   # #
 # # # ##### ############# # ### # # ### # ### # # ### ### # ### # ##### # ### ########### # # # # ####### ### ##### # # # # ###
 #   #   #   #     #     # #     # # #   #   # # # #   #   #     # #     #   #           # #   # #   #     # # # #     # # #   #
 ### ### # ##### # ### # # ####### # # ####### # # # ### ######### # ##### ############# # ### # ### ##### # # # # # ### ##### #
 #   #   #     # #   # # #       #   #     #   # # # # # #         # #                 # #   # #   #     #   # #   #   #       #
 # ### ####### # ### # # ####### ### ### ### ### # # # # # ######### ##### ####### ##### # # # ######### ##### ### ### #########
 # #   #     # #   #   # #   #   #     #     # # # # #   #         #   #   #     #   #   # # #   #     #   #   #     # #       #
## # ### ### # ### ##### # ### ### ### ####### # # # # ### ####### ### # ### ### # ### ### # ### # ####### # ####### # # ##### #
   # #     # #     #               #               # #     #   #     # #   # #   # #   # # # #     #     # # # #     # #   #   #
 ### ##### ############# ############# ############# # ##### # ### ### ##### ### # # ### # # ##### # ##### # # # ### # ##### ###
 # #     #               #   #       #   # #     #   # #   # #   #     #   #   # # # #     #     #   #   # # # # #   #     # # #
 # ##### ########### ### # # # ##### # # # # ### # ##### # # ### # ##### # ### # ### ####### ### # ### # # # # # # ####### # # #
 #   #   #         #   # # # #   #   # #   #   # # #     #   #   # #     #     #   #       # #   #   # # #   #   #     #   # # #
 ### # ### ####### # # ### ##### # ########### # # # ######### ### # ############# # ##### ### ##### # ############# # # ### # #
       #   #     # # #   #       #             # # #       # #   #   #   # #     # # #   # #   #                     # #     # #
## ### # ### ##### ##### ####################### # ####### # ### ##### # # # ### # # # # # # ### ##### # ####### ##### ####### #
 # #         #   # #     # #                 # # #       #   # #   #   # # #   #   # # # # # #     #   #       # #     #     # #
 # # ### ##### # # # ##### # ############# # # # ### # # ### # ### # ### # ### ####### # # # ##### # # ######### ### # # # # # #
   # # # #   # # # #       # #       #   # #   # #   # #   # #     # #   #   #   #     #   #     # # #   #     #   # #   # # # #
## # # # # # ### # # ####### # ### ### # # ##### # ####### # ####### # ### # ### # # ####### ### ### ### # ### # # ### ### ### #
   #   #   #     # #   #   # #   #     # #       #     #   # #   #   #     # #   # # #     # #   #   #   #   # # #   #   #     #
 ################# # # ### # ##### ################### ##### # # # # ####### # ##### ##### # # ### ######### # ##### ### #######
             #     # #     #     # #           #       #     # # # #     #   #       #   #   #   #         # # #     #         #
 ### ##### # # ##### ########### # ### ####### # ####### ##### # # ##### # ########### # ### ### ####### # # # # ##### # ##### #
   # #     # #   #   #         # #   # #       #     #   #   # #       # # #   #     # # #     #     #   # # # # #     #   #   #
 ### ########### # ### ##### # # ### # # ##### ##### # ### # ##### ##### # # ### ### # # ####### ### # ##### # # # # ####### # #
   #     #       #   #   #   # #   #   #     # #   #   # # #     # #   # # #     #   # # #     #   # #   #   # # # #   #     # #
## ##### # ######### ### # ####### ########### ### ##### # ##### ### # # # ####### ### # # ### ### # ##### ##### ##### # ##### #
 #   #   #         # # # # #     #     # #     #   #   #   #   # #   #   #     # #   # # #   # #   #     #     # #     # #   # #
 ### # ########### # # # # # ### ##### # # ##### # ### ####### # # ##### # ### # ### # ##### # # ####### ##### # # ####### # # #
   # # #       # # #   # # # # #     # # #       #     #       #   #     # # #   # # # #     # #   #     # #   # #     #   # # #
## # # # ##### # # ##### # # # ### ### # ############# ####### ##### ##### # ### # # # # ##### ##### ##### # ### # ### # ### # #
     #       #   #       #       #     #                                 #   #           #           #           #   #   #   # #
################################################################################################################################
