################################################################################################################################
#     #   #       #   # #                 #   #         #   #     # #     #     #         #   #                     #     #     
# ##### # # ### ### # # # ####### ### # ### ### ##### # # # # ### # # ##### ### # ####### ### # # # ####### ######### ##### ### 
#       #   #   #   # # #       # #   #   #   # #   # # # # #   #   #     #   # #   # #   #   # # # #     # #       # #     #   
####### ##### ### ### # ####### # ####### ### # # ### ### # ### ######### ### # ### # # ### ### # # # ### ### ##### # # # ### # 
#     #   # # #   #   # #   #   #       # #   # #   #     #   #       #   #   # #   #       #   # # #   #         # # # # #   # 
# ### ### # # # ### ### # # # ######### # # ### ### ####### # ##### ### ### ### ########### # ### ##### ########### # ### ### ##
#   #   # #   #   # # #   #   #   #   # #   #   #         # #     # #   # #   #               # # #   #   #         #   #   #   
### ### # ####### # # # ####### # # ### ### # ##### ### # # ####### # ### # # # ############# # # # # ### # ########### ### ### 
#   #         #   # # #         # #   #   # # #     #   # #   #   # #   #   # # #   #       # # #   #     #   #     #   #   #   
######### ### # ### # ########### ### ### # # ####### ### ### # # # ### ##### # # # # ##### # # ############# # ### # ### ### ##
#   #   #   #   #   # #         #     #   # # #       #   #   # #   # #       # # #   #   # #   #     #       #   # #   # #   # 
# # # # ### ######### # ############# # ##### # ####### ### ### ##### ######### # ##### # # ### ### # # ######### ##### # # # # 
# #   #   # #       # # #             # #   # #       #   #   #   #       #   # #   #   # # # #   # # # #       # #     # # #   
# ####### # ### ### # # # ############# # # # # ######### ### ### # ##### # ### ### ##### # # ### # ### # ##### # # ##### ### ##
# #       #     #   #     #         #   # #   # #   #       #     # #     #   #   #   # #   #   # #   #   #   #   #   #     #   
# # ############# ####### # ####### ##### ##### ### # ##### ####### ### ##### # ##### # ##### # # ### ##### # ####### # ### ### 
# #       #     #   #   #         # #   #     #     #   #         #   # #   # #   #   #   #   #         #   #       # # #   #   
# ####### ##### ### # # ### ##### ### # ##### ######### # ### # # ### # # ### ### # ### # ####### ##### # ########### ### ### # 
# #     # #       # # #   # #   #     # #   #       # # # #   # #   # # # #   #   #   # #       # #     #     #     #     #   # 
# # # ### # ####### # ### # # # ####### # # ####### # # # # ### ### # # # # ### # ### # ####### ### ### ##### ### # ####### ####
# # #   # #   #     # #   # # # # #     # #     #   #   # #   # # # # #   #     #   # # #     #     #   # #   #   #         #   
# # ### # # # # ####### ### # # # # ##### ### ### ####### ### # # # # ### ######### # # # ############# # # ### # # ####### # # 
# # # # # # #   #             # #   #     #   #   #     #   # # #     # #     #     # # #     #   #   #   #     # #   #     # # 
### # # # # ######### ##### ### ##### ##### # # ##### # ### # # ####### ##### # # ### # # ### # # # # ### ####### ### # ##### # 
#   # #   # #   #   #     #   #   #   #   # # # #   # #     # #   #   #     #   #   # # #   # # # # #   #         #   #       # 
# ### ##### # ### # # ### ####### # ### ### # # ### # ####### ### # ### ##### ##### # # ### ### ### ### ### # ### # ########### 
# #         #     # #   #       # # #   #   # #   #   #     #   # # #   #     #     #   #   #   #   #       #   # # #   #   #   
# ### ### # ####### # # ####### # # # ### ### ### # ### ### ##### # # ### ### # ######### ### ### ######### ### # # ### # ### ##
#   #   # # #   #   # # #   #   #   # #   # #   # # #   # #       # # #   #   #         # # #     # #     #   # # #     #     # 
### # ### # # # # ### # # # ##### ### # ### # # # ### ### ######### # # ### # ######### # # ####### # ### ### # # ############# 
#   # #   #   #   #   #   #   #     # # #     # #     #   #     #   # # #   #         #   # #       #   #   # # #       #     # 
# ### # ######### # ######### # ### # # ####### ####### ### ##### ### # ##### # ##### ##### # # ####### ### ### ### # # ##### # 
#     #S#       # # #     #   #   #   # #           #       #   #   #   #     #   # #   #     #       #   #   #   # # #       # 
# ####### ##### # # # ### # ########### # ####### # # # # ### # ### ##### ##### # # # # # # ############# ### ##### # ### ##### 
#       #     # #     #   # #     #   # #   #     # # # # #   #   #     # #   # # #   # # #   #   #     #   # #     #   #   #   
# ##### ##### # ######### # # ### # # # ### # ##### # # ### ##### ##### # # # # # ### ### ### # # # # ##### # # ####### # # # ##
# #   #   #   #   #     # #   #   # #   #   # #     # # #   #   #       # # # # # #   #   # #   #   #     # #   #       # # #   
# # # ### # ##### # ### # ##### ######### ### # ##### # # ### # ######### ### # # ##### ### # ######### ### ##### ### ##### ### 
#   #   # # #   #   #   #     #     #     #   # #     # # # # # #   #   #   #   #       #   #         #   #   #     # #   #     
####### ### # # ##### ### # # ##### # ######### # ##### # # # ### # # # ### ### ######### ####### # ##### ### # ### # # # ##### 
#     #   # # # #     #   # #   #   # #   #   #       #   #   #   #   # #   #           # #     # #     # #   # #   # # # #   # 
# ####### # # # # ##### ### # ### ### # # # # ######### ### ### ####### # ### ### ##### # # ### # ####### # ### # ### # # # # ##
#         #   # # #   #   # # #   #   # # # #         #       #       # #   # #   #   # # # #   #   # #   # #   # # # # #   #   
# ######### ##### # # ### # ### ##### # # # ######### # ### # ######### ### # # ### # ### # # ##### # # # # ### # # # # ####### 
#       #   #   # # #     # #   #   # # #   #       # #   # #           # # # #     #   #   # #   # # # # #   # #   # #   # #   
# ####### ### # # ######### # # # # # # ##### ####### # # ######### ##### # # ### ##### ##### # # # # # # ### # ##### ### # # ##
# #       #   #   #       # # # # # #   #         #   # #         #     # # #   # #   # #   #   # #   # #   # # #     #   # # # 
# # ############### ##### # # ### # # ##### ####### ####### ##### # ##### # ### ### # # ### ##### ##### ### # ### ######### # # 
# #     #     #     # #   # #   # # #       #       #     #   #   #     # # #   #   # # #   # #   #   # #   # #   #           # 
# ##### # ### ####### # ####### # # ### ##### ########### ##### ### ### # # ##### ### # # ### # ### # # ##### # # # ########### 
# #   # # # #     #             # #   #     # #   #       #   #   #   #G# #     # # # #   #   #     #   #     # # #   #         
# # ### # # ##### ############### ### ##### # # # # ####### # ### # # # # ##### # # # ### # # ########### ##### ##### # ####### 
#   #   #   #   #   #   #           #   #   # # #   #       #     # # #   #   #   # #   #   #   #     # # #           #   #   # 
# ### ##### # # ### # # # ####### ##### ##### # ######### # ####### # ##### # ##### ### ##### # ##### # # ######### ### # # # # 
# #   #   #   # #   # #   #     # #     #     #           # #   #   # #     #         # #     #         #   #     #     #   # # 
# # ### # ##### ##### ##### ### ### ##### ############### ### # # ##### ##### ####### # # ### ######### ### # ### # ######### # 
#   # # #   #   #   # # #   # #   # #         #     #     #   # #           #   #   # # #   # #   #   # # #   #   # #   #   # # 
### # # ##### ### # # # # ### ### # # ### ### # # # # # ### ### ############### # # ### ### ### # # # # # ##### ##### # ### # # 
#     #   #   #   #   # # # #   # # #   # #   # # # # # #   # #             #   # #     # #   # #   # # #   #   #     #   #   # 
# # ##### # ### ####### # # ### # # ### ### ##### # # ### ### ############# # ### ####### ### ####### # ### # ### ####### ##### 
# # #     # # # #     # #   # #   # # # #   #   # #   #   # #         # #   #   # #   # #   #       # #   # #     #   #   #     
### # ##### # # ##### # ### # ##### # # # ### # # ##### ### # # ##### # # ##### # # # # ### ##### # # ### # ####### ### ### ####
#   # #   # # # #   #   #   #   #   # # # #   # # #     # #   #   #   #   #   # # # #   #       # # #   # #   #   # #   #       
# ### ### # # # # # ### # ### # ### # # # # ### # # ##### # ##### # ####### # ### # ##### # ### # ##### # ### # # # # ### ##### 
#   #     #   # # #   # #   # #     #   # # #   # #   #   # #     # # #     # #   #       # #   #       #     # #   # #   #   # 
### ##### ### # # ### # ### # ######### # # # ####### # ### # ##### # # ##### # ########### # ########### ##### ##### ##### # ##
#   #   #   # # # # #   #   # #         #   # #       #     # #     # # #     # #       #   #                 # #   # #   # #   
# # ### ### # # # # ### # ### # ############### ############# ##### # # ####### # ##### # ### ##### ### ##### # ### # # # # ### 
# # #     # # #   #   # #     #   #         #   #   #     #   #   #   #       #   # #   #   # #   #   # #   # # #   # # #   #   
### # ### # # ####### # ######### # ##### ### ### ### # # # # # # ### ####### ##### # ### # ### ####### # # # # # ### ####### ##
#       # # # #     # # #   #   #   # #   #   #       # #   # # #     #   #   #     # # # #   # #     # # # # #   #   #     #   
# ##### ### # ### # # # # # # # # ### # # # ######### # # ##### ##### # # # ### ##### # # ### # # ### # # ### ### # ### ### ### 
#     # #   #     #   #   #   # # #   # # #     #     # # #     # #   # #     #     # #     # # # #     #     #   #       #   # 
# ### # # ########### ######### # # ### ####### ####### # # ##### # ##### ### ##### # ### # # # # ############# ########### ### 
# # # # # #         # #     # # #   #   #     #   #     # # #             #       #   # # # #   #     #       #   #     #   #   
# # # ### # ####### # ##### # # ##### # # # ##### # ##### # ######### ##### ##### ##### # # ######### ### ### ### # # ### # # ##
# # #   # #   #   #   #   # # #   #   # # # #     #   #   #   #     # #     #   #         #   #     # #   # # #     # #   # # # 
# # ### # ### ### ##### # # # ### # ##### ### ##### # # ##### # ### ### ##### ##### ##### ##### ### # # ### # # ####### # ### # 
#   # # # #   #   #     #       # # #   #   #     # # #   #   #   #   #     # #     #   # #     # #   # #   #   #   #   # #   # 
### # # # # ### # ##### ######### # # # ### ##### # # ##### # ### ### ##### # # ##### # ### ##### ####### # ### # # # ##### ### 
# # # #   #     #           #   # #   #         # # #   #   #   # #   #   #   # # #   #     # #   #       #     # # #     #     
# # # ######### ####### ### # # # ############### ### # # ##### # ##### # # ### # # ######### # # # # ######### # ####### ##### 
#   #           #     #   # # # #       #       #   # # #   # # #       # #   #   # #     #     #   #     #   # #     # #     # 
# ### ######### # ### # # ### # ####### # ##### ### ### ### # # ######### ### ##### # ### # ############# # # ####### # ### ### 
# #   #         # # # # # #   #         # #     # #       # #   #     # # #       # # # # #   #         #   #         #   #     
# # ### ### ##### # # # # # ############# # ##### ##### # # ##### ### # # ######### # # # ### ##### # # ############### # ######
# #   # #   #     #   # # #   #         # #     #       # #       # #   #           #   #   # #   # # # #           #   #   #   
# ### # ### # ##### ### ##### # ##### # # ##### ######### ######### ################### ### # # # ### # # ### ##### # ##### ### 
#     #   # # #   #   # #   # # #   # # #     #       #               #         #       #   #   #     # #   #   #     #   #   # 
######### ### # ##### # # # # ### # ### ##### ####### # ### ######### # # ### # # ##### # ############# ### ### ####### # ### # 
#   #     #   #     #   # # # #   #       #   #   #   #   # #     #   # # # # # # #   # #     #       #   #   #     #   # #   # 
# ### ### # ### # ### ### # # # ######### # ### ### ##### # # ### # ### # # # ### # # ### ### # # ### ### # # ##### ##### # ### 
#     #   #   # # #   #   # # # #   #   # #   #   #       #   # # #     # # # #   # #   # #   # #   #   # # #   # # #   #   # # 
####### ##### # ### ### ### # # # # # # # ### ### ######### ### # # ##### # # # ### ### ### ######### ### ##### # # # # ### # # 
#       #     #     #   #   # # # # # # #   #   #   #           # # #   # #   # # # # #     #   #   #         #   #   #   # #   
# ### ### ##### ##### ####### # # # ### ### ### ### ##### ### # # # # # # ##### # # # ######### # # ### ##### ### ####### # # ##
#   #   # #   # # #   #       # # #   # # #   #   #   #   #   # # #   # #       # #   # #   #   # # #   #   #   #       # # #   
### ### # # # # # # ### ####### # ### # # ### ### ### # ### ##### # ### ######### ##### # ### ##### ##### # ### ####### # # ### 
# # #   #   # # # # #   #   #   #   # # # # # # #     #   # #     #   #   #               #   #     #     #   #     #   # #     
# # # ####### # # # # ### # ### ### # # # # # # ####### # # # ####### # ### ######### ##### ### ### # ####### ##### ##### ##### 
#   #   #     #     #     #   # # # #   # # # #     #   # # #   #     #     #       #     # #     # #   #   # #       #   # #   
### ### # ######### ######### # # # ##### # # # ### ##### # ### ##### ####### ##### ##### # # ### # ### ### # ####### # ### # ##
#   #   # #     #     #     #   # #     #   # # # #       #   #     #         #   # #   #     #   #   #   # #     #     #   #   
# ### ### # ##### ### # ### ##### ##### ### # # # ######### # ##### ####### # # # ### # ####### ### # ### # ##### ####### # ### 
# # # # #   #     #   #   # #   #     #   # # # #           #     #       # #   # #   #   #     #   #     # #   #   #   # # #   
# # # # ##### ##### ####### ### # # ##### # # # ##### # ######### ####### ######### ##### # ##### # ####### # # ### # ### # # ##
#   #   #   # #     #     #       #     # # # # #   # # #               # #     #   # #   # #     #         # # #   #   # #   # 
# ####### # # ### ##### # ####### ####### # # # # # ### # ######### ##### # ### # ### # ### # # ##### # ### # ### ##### # ##### 
#         # #   #       #         #       # #   # #     # #       #   #   # # #       # #   # #     # #   # # #   #     #   #   
### # ######### ################# # ####### ##### ####### # ##### ### # ### # ######### # ##### ### ### # # # # ####### ### # ##
#   #   #     # #         #     # #               #       # #   # #   #   # #   #       #     #   #   # # #   #       #     #   
# ####### ### # ##### ##### ### # ########### # ######### # ### # ####### # ### # ########### # ##### # # ########### # ####### 
# #       #   #   #   #     # #   #   #       # #       # #     #     # # #     #         #   # #     # #       #   # # #   #   
# # ####### # ### # # # ##### ##### # # # ##### # ##### # ########### # # ##### ######### ####### ##### ####### # ### # # # # ##
# #   #     #   # # # #   #         # # # #   # # #   # #           #   #     # #   #   #   #     #   #   #     #     #   #     
# ### # ######### ### ### ##### ##### # # # # # # ### # ####### ### # ##### ### ### # ##### # ####### # ### ### ####### ##### ##
#     #         #   # # #     # #   # # #   # # #   # #       #   #   #     #   #   # #     # #   #   #   # #   # #         #   
# ############# ### # # ##### # # # # # ##### # ### # ####### ######### ##### ### ### # ##### # # # ##### # ### # # ####### ### 
#             #   # #     # #   # #   #   #   #   #   #     #     #   #     #   # # # # #     # # # #   # #   #   #   #     #   
##### ##### # # # # ##### # ##### ##### ### # ### ### # ##### ### # # ##### ### # # # # ######### # # # # ### ####### # ########
#   #     # # # # #   #   # #     #     #   #   #   #   #   #   # # #       #   # # # #   #   #   #   # #   #       # # #       
# # ##### # # # ##### # ### # ########### # ##### # ### # # ##### # ####### # ### # # ### # # # # ##### # # ##### # # # ####### 
# #   #   # # #     # #                   # #     # #   # # #     # #     # # # #   #     # # # #     # # # #   # # # #       # 
##### # ### ######### ############### ##### # ####### ### ### ##### # ### ### # ### ####### # ##### # # # # # # ### # ####### # 
#     # #   #         #     #     #   #   # #     #   # #   #     # # # #     # # #   #     # #   # # #   # # #     # #     # # 
# ##### # ### ######### ### # ### ##### # ####### # ### ### ##### # # # ####### # ### ### ### # # ### ##### # ####### # ### # # 
#       #   #             #     #       #       #         #       #   #                   #     #           #           #   #   
