################################################################################################################################
# #           #         #   #           #     #   #     #     #                   #   #           #   #     #     #           # 
# # ### ##### # ####### ### ########### # ### ### ##### # ### # ############### ### # # ######### ### # ### # ### # # # ##### # 
#   #   #     #     # #   # #       #   #   # #         #   #           #     #     #   #   #   #     #   # # #   # # #     # # 
##### ### ######### # ### # # ##### # ### # # # ####### # # ######### ### # ############# ### # ######### # # # ### # ##### # # 
#     # #   #   #   # #   #       #   # # # #   #     #   #   #       #   # #     #           # #       # # # #   # # #   # #   
# # ### # ### # ##### # ### ### ####### # # ##### ### # ##### # ####### ### # ### # ### ##### # # ####### # # ### ### # ### ### 
# # #   # #   #   #     #     #           # #   # #   # #     #           #   # # # # #     # #   # #     # #   #   #   #   # # 
# ### ### # ##### # ##### ### ### ######### # # ### ### # ############# ####### # # # ##### # ##### # ##### ### ### ##### ### # 
# #   #   #   # #   #   # # #   #   #     #   #     #   #   # #   #   #         #   #       # #     # #   #     #   #     #   # 
# # ### ##### # ##### # # # ### ### # ### ############# ### # # # # # ####################### # ##### # ######### ### ##### ### 
# # #   #     # #     #       #   # # # #   #   #       # #   # #   # #       #     #     #   #     # #     #   #     #   # #   
# # # ### ##### # ############# # ### # ### # ### # # ### ##### ##### # ##### # ### # ### # # ##### # ##### # ########### # # ##
#   # #   #       #   #       # #   # # #   #     # #         #   # #   #   #   # #   #   # #     # #     #               # #   
##### # ##### ##### # # ##### # ### # # # ######### ############# # ####### ##### ##### ### ### ### ##### ### ####### # # # ### 
# #   # #     #     # # # #   #   #   #   #   #   # #     #       #             #     # #     #     #   #   # #     # # #   #   
# # ### # ##### ####### # # ####### ######### # # # # ### # ########### ####### ##### # ######### ### # ### # # ### # # ##### ##
# #   # #   #   #   #   #         # #       # # # #   #   # #           #     #       # #   #   #     #   # # #   # # #       # 
# ### # ### # ### # # ########### ### ##### # # # ##### # # ##### ##### ##### ####### # # # # # ####### # # ##### ### ######### 
#     #   # #   # # #   #   #   #     #   # # # #       # #     # #     #   #   #   # #   #   #   #     # #   #   #   #   #     
# ####### # ### # # ### # # ### ####### ### # # # ##### ####### # # # ### # # ### # # ########### # ######### # ### ### # # ####
#   #     #     # #   # # #     #     #   # #   # #   # #     #   # # #   # #     #   #       # # #     #   #   # # #   #   #   
### # ######### # ### # # ######### # # # # ####### # ### ### ####### # ### # ########### ### # # ##### # # ##### # # ######### 
#   # #         # #     #   # #     # # #   #       # #   #           #   # #     #     # #     #     # # #         # #   #   # 
# ### ##### ### # ##### ### # # # ### # ##### ######### ##### # ### ##### # ##### # ### ### ######### ### ########### # ### # # 
#     #   # #   #     # #   #   # #           #       # #   # #   # #   # #     #   # #   #   #     #     #             #   # # 
# ##### # ### # ##### # # ####### ########### # ##### # ### # ### ### # # ##### ##### ### # ### ### ####### ##### ### # # ### # 
#       #     #     # # # #       #     #   #       # #     #   #     # #   #   # #   #   # #   # #   #   # #     #   #   #   # 
# ############# ##### ### # # ### # ### # # ####### ######### # ########### # ### # ### ### # ### ### # # # # ############# # # 
# #       #   # #     #   # # #   # #   # #   #   #           # #       #   #   #     #   #         # # #   #       #       # # 
### ##### # # # # ##### ### # ##### # # # ### # # ####### # ##### ##### ####### ##### ### ####### ### # ########### # ######### 
#   #     # #   #       #   #       # # # # # # #       # #     #     # #       #   #       #   # #   # #         # #       #   
# ########### ####################### # # # # # ####### # ##### ##### # # ####### # ####### # # # # ### # ### ##### ##### # # ##
# #     #     #         #     #   # # # #   #   #     # #     # #   # #   #     # # #   #   # # # #   # # #   #   #     # #     
# # ### # ##### ####### # ### # # # # # ######### ##### ### # # # # # ####### ### # # # # ### # # ### # # # ### # ##### ##### ##
#   # # #     # #       #   # # # # # #   #     #   #   #   # #   # # #     #     # # # # #   #     #   # # #   # #   #     #   
##### # ### ### # ######### # # # # # ##### # # ### # ### ### ##### # # ### ####### ### # # ##### # ##### # ##### # ####### ### 
#     #   # #   # # #   #   #   #   #       # #     # #   #   #   # #   # #   #             #   # # #   # #   #   #       #   # 
# ####### # # ### # # # # ################### # ##### # # # ### # # ##### ### # ############# # ### ### # ### # ### ##### ### # 
#   #     # #   #   # # #         #           #   #   # # #   # # #   #     # # #   #     #   #   #         #           # #   # 
### # ##### ### ##### # ######### ### ########### # ### # ##### ### # # ### # # # # # ### # ##### ####################### # ####
#   #   #     # #     #   # #   #   #       #   # # #   #     # #   # #   #   # # #   # #   #   #     #       #           #     
# ##### ##### # ##### ### # # ##### ####### # # ### # ####### # # ### ### ##### # ##### ##### # ##### # ##### ######### ####### 
#     #       #   #   # # #   #   #   #   #   # #   # #     # # # #     #   #   #       #     #   #   # #   #     #   # #     # 
##### ####### ### # ### # # ### ##### # # ##### # ### ##### # # # ##### ### ### ############### # # ### ### ##### # # ### ### # 
#         # #   #   #   # #     #     # #     # # #         #   # #   # #   #   #     #   #   # # #   #         #   #     #   # 
# ##### # # ### ####### # ### ### ##### ##### # # ############### # # ### ### ### # # # # # # # # ### ######### ########### ####
#   #   #     #       # #   # #   #   # # #   # #   #           #   # #   #   # # # # # #   # # #   # #       # #   # #   #     
##### ##### # # ##### # ### # # ### # # # # ### ### # ######### # ### # ### ### # # ### ##### ### ### # ##### # # # # # ####### 
#   #   #   #   #   # # #     # #   #   # #       #   #     #   #   # # #         #   # #     #   #   #   #   # # # # #   #     
# # ### # ####### # # # # ##### # ####### ##### # ##### ##### ####### # # ########### # ####### ### ##### # ### ### # ### # ####
# # #   #   #     # # # #   #   # #     # #     #     #   #   #     # #   #   #       # #     # #   #     # #   #       #   #   
# ### ####### ##### # # ### # ### # ##### # # # ### ### ### ### # # ##### # # ######### # ### # # ##### ### # ### ### ######### 
#     #   #   #   # #     # #     #     # # # #   # #   #   #   # # #   # # #         #   # # # #       #   #   #   # #       # 
# ##### # # ### ### ##### # ########### # # ##### ### ### ####### # # # # # ######### ##### # # ######### ##### # # ### ##### # 
# #   # #   #       #     # #         # # #     #     #   #   #   #   # # #   #   #         #   #               # #     #     # 
### # # ##### ####### ### # ### # ### # # ### # ####### ### # # ####### # ### ### # ########### # # ##### # ##### ####### ##### 
#   # #   #   #       # # #   # # #   #       #   #   #     # # #   # # #   #     # #   #       # # #     #   #   #     #       
# ### ##### ######### # # ### # # # ### ########### # ####### # # # # # # ####### # # # # ####### ### ##### ### ### ### ########
# # #       #     #   # #       # #     #           #         # # #               #   #   #     # #   #         #   # #         
# # ########### # # ### ### ##### # ##### ##################### # ####### ################# ### ### ####### ##### ### ##### ####
# #     #       # #   #   # #     # #   #               #       # #     #       #   #   #   #   #   #   #   #             #     
# # ##### # ##### ### # # # # ##### # ################# # ### ##### ### ####### # # # # # ### ### ### # # ### # # ### # ####### 
# #       # #   #   # # #   # #     # #   #       #   # # #   #   #   #   #     # # # # # # #   #     # #     # #   # # #     # 
# ######### # # ### # # ##### # ### # # # ### ### # ### ### ### # ### ### ##### # # # ### # ### ####### ### ### ### # ### ### # 
# #         # #   # # #   #   # #   #   #     # # #   # #   # # #   # # #         # # #   #   # #     #   #   # #   # #   #   # 
# # ######### ### # # ### # ### ############### # ### # # ### # ### # # ### ##### ### # ##### # # ### ### ##### # ### # ### ### 
#   # #   #   #   # #   # # #       #   #     #   #   #   #   # #     #     #   # #   #   #   # #   #     #     # #   # #   #   
##### # # ### # # # ### # # ### ### # # ##### # ### ####### ### # # ######### # # # ##### ### # ### ####### ####### ### # ##### 
#       #     # # #     # #   #   #   #       # #           #   # # #     #   # # # #   #   # #   # #       #     # #   # #     
### ########### # ####### ### ################# # # # ### # # ### ### ### # ### # # # ##### # ### # ### ### ##### # # ##### ####
#   #           #   #   #   #                 # # # # #   # #   # #   # # #   #     #       #   # #  G#   #     #   #       #   
# ### ### ####### # # ### # ################# # # # # # ####### # # ### # ####### ############# # ### # # ##### ### ########### 
# # # #   #       # #     #                 #   # # # #       # # # #   #       # #       #     #     # #     # #               
# # # ##### ####### ####### ####### # ### # ##### # # ######### ### # # ####### # # ##### # ### ######### # # # ########### ####
# # #   #   #   #           #   #   # # # #     # # #   # #     #   # #       #   #   #   # #             # # #     #   #   #   
# # ### # ### # ### # # # ### # # ### # # ####### # # # # # ##### ### ##### ##### ### # ##### ##### # ##### # ##### # # # ### # 
#   #   # #   #   # # # # # # # # #     # #       # # # # #   #   #   #     #     #   # #     #     #   #   #   # #   # #     # 
# ### ### # ##### ### # # # # ### # # ### # ####### # # # ### # ####### ##### ##### ### # ############# ##### # # ##### ####### 
#   # # # # # #   #   # # # #     # #   #   #   #   # #     # #       #       #   #   # #         #   # #     #   #     #   #   
# # # # # # # # ### ##### # ######### # ##### ### ######### # ####### # ####### # ### # # ####### # ### # ######### ##### # ####
# # # # # #   #   #   #   #           #         # #       # #   #   # #   #     # # # # #       # #   # #   #   #   #   # #     
# # # # # ### ####### # ### ### # ##### ####### # ####### ### # # # # ### # ##### # # # ######### ### # ##### # # ### # # ##### 
# # # # #   # #     # # # # #   # # #   #       #       #   # # # # #   # # #     # # # #   #   #   # #       # # #   # #   # # 
# # # # ### # ### # # # # # # ### # # ### ##### ##### # ### # ### ##### # # ####### # # # # # # ### # ######### # # ### ### # # 
# # #   # # #     #   # # # # #   #   #   #   #     # #   # #   #   #   #           # #   #   #   # #     #   # #   # #   #   # 
# ####### # ########### # # ### ####### ##### # ##### ##### ### ### # ######### ##### ########### # ### ### # # ##### ### ##### 
#         #     #   #   #   #   # #   # #     # #     #   #   #   #   #       #   #   #         # #     #   #           #       
########### # ### # # ##### # ### # # # # ##### # ##### # ### # ####### ##### # # # ####### ### # ####### ######### ############
#   #       # #   #   #     #   #   #   #       #   #   #   # #       #   # # # # #   #   #   # #     #   #       #             
# # # ######### ####### ####### ############### ### # ##### # ########### # # # ##### # # ### # ##### # ### # ### ####### # # ##
# # # #         #         #     # #             #   #   #   #     #     # #     #     # # #   # #   #   #   # # #       # # #   
# ### # ######### # # ##### ##### # ### # ####### ### ### ####### # ### # # ### # ####### # ### # ########### # ####### # # ### 
#     #   #       # #   #   #   #   #   # #   # # #   #   #       #   #   # #   #         # #   #           # #   #   #   #   # 
##### ### ######### ##### ### # ### # ##### # # # # ### # # ######### ####### # ########### # # # # ####### # # # # # ######### 
#   #   # #     # #   #   #   #     #   #   #   #   #   # # #       # #   #   #             # #   #       #   # #   #   #       
# ### # # # ### # ### # ### # ### ##### # ########### ### # # ####### # # # ############# ### # ######### ############# # ##### 
#     # #   # # #     # #   # # #     # #     #     #   # # #       #   # # #       #   #   # # #       #         #   #   #     
##### # ##### # ####### # ### # ##### # ##### ##### ### ### ####### ####### # ##### # # ##### ### ### # ######### # # ######### 
#     # #     # #       #   # #   #   #             #   #   #   #       #   #   # # # #       #     # # #     #   # # #       # 
# ##### # ##### # ######### # ### # ################# ### ### # ### ##### ##### # # # ####### # ##### # # # # # ### # # ### # # 
# #   #   # #   #     #     #   # # #   #   # #   #   #   #   #   #     #       # # #   #   # # #     # # # # #     # # #   #   
# # # ##### # ####### ### # # ### # # # # # # # # # # # ### ##### ##### ######### # ### # ### # # ### ### # # ####### ### ######
#   #   #   #   #   #   # # #     #   #   #   # # # # #     #     #     #   #     #   # #     # # #   #   # #       #   # # #   
# ### ### ##### # ##### # # ################### # # ######### ##### ##### # # ####### # ####### # # ### ### # ### # ### # # # # 
#   #     #   # #       # #     #       #     # #   #         #   # #   # #         # # #     # # # #   #   #   # #   # #   # # 
# ######### ### ######### # ### # ##### # ### # ##### ######### # # ### # ########### # # ### # # ### ### ### # ##### # ##### # 
#         #   # #   #   # #   #   #   # #   #   #   #   #       # # #   # # #   #     # #   #   #     # #   # # #   # #     # # 
### ##### ### # # ### # # ### # ### # # ### ##### # ### # # ##### # # ### # # # # ### # ### ########### ### ### # # # ##### # # 
#   #   # #   # # #   #   #   # #   # #   # #     #     # #     #       #   # #   #   #   #   #       #   # #   # #   #     # # 
# ### # # # ### # # ####### ### # ### ### # # ####### ### ##### ##### # # ### ##### # ### ### # ### ### # # # ### ##### ##### # 
#   # #   # # # #   #     #   #     #   # #   #     #     #   # #   # #   #   # #   #   #     #   #   # # # #   #     #     # # 
### # # ### # # ##### ### # # # ##### ### ##### ### # ##### # # # # # ##### ### # # # ########### ### # # # # # ##### ##### # # 
#   # # #   # # #     #   # # # #   #   # #   #   # # #   # # #   # # #     # #   # #   #     #   # #   # # # # #       # #   # 
# ### # # ### # ### # # ##### ### # ### # # # ### # ### # # # ##### ### ##### ### # ### # ### # ### ####### # # ##### # # ##### 
# # # # #     #   # # #     #     #   # # # #   # #   # # # # #     #   #     #   # # # # # # # #   #   #   # #   #   # # #   # 
# # # # ### ##### # # ##### ######### # # # ##### ### # # ### ####### ##### # ### # # # # # # # # ### # # ### ### ##### # # ### 
# # # #   # #     # # #   # #  S      # # #     # # #   # #   #       #   # #     #   #     #     #   #   #     #     #     #   
# # # # ### # # ##### ### # # ######### # ##### # # ##### # ### ### ### # ####### ########### ##### ####### ##### ### ####### ##
# #   # #   # # #   #     #   #         #     # #   #   # #   # #   #   #   #         #     # #     #     # #   #   # #     #   
# ####### ### ### # ########### ####### ##### # ##### ### ### # # # # ##### ######### # ### ### ##### ### # # # ##### # ### ### 
#   #       #   # # #           #   #       #   #   # #   #   # # # #     #   #       # # #     #   #   #   # #     # # #       
# # # ######### # # # ####### ### # ####### ####### # # ##### # # ####### ### # ####### # ####### ##### ##### ##### # # ########
# # #   #   #   # # # #       # # # #           #   # #     #   # #       # # #   #     # #             #   # #   #   #   #     
### # ### # # ##### ### ####### # ### ##### ### # ### ##### ####### ####### # ### # ##### ##### # ####### # # # # ### ### # ### 
#   # #   #   #     #   #       #     #     # # #   # #   #         # #     #   # #   # # #     # #     # # # # #       #   #   
# ### # ####### ##### ### ############# # ### # ### # ### ########### # # ##### ##### # # # ##### # ### # # # # ####### ##### ##
#     #         #     #                 #     #                         #     #       #     #     #   #   #   #       #     #   
