################################################################################################################################
   #   #   #                               #     #   #     #           #   #         #     #       #             # #   #       #
 ### # # # # ######### ################# ### ### ### # ### # ##### ### ### # ### ### ##### # ##### # ### # ##### # # # # ### # #
     #   # # #   #     #                 #   # #     # #   # #     # #   # #   # #   #   # #   # #   # # #     #   # #     # # #
########## # # # ################### ##### ### ####### # ##### ##### ### # # ### # ### # # ### # ##### # # ### ##### ####### # #
 #         # # #     #       #   #   #     #       #   #     # #   #   # # # #   # #   #   #   # #     # # # # #     # #   # # #
 # ######### # ##### # ##### # # # ### ########### ######### # # # ### # # # # ### # ####### ### # ##### # # # # ##### # # # # #
             # #   # #     #   # # #   #   #     #   #     #   # #     # # # # #                 #   #   # # #         # # # # #
 ######### ### # # # ##### ##### # # ### ### ### ### ##### ### ####### # # # # ############# ####### # ### # ######### # # # # #
   #   #   #   # # # #   #   #   # #   # #   #     #     #     #     #   # # #     #       # #       # #     #     #   # #   # #
## # # # # # ##### # # ##### # ####### # # ### ### ##### ##### # ### ### # # ##### # ##### # # ####### # ##### ### ##### ##### #
   # # # #         #   #     # #   #         #   #   # # #   # #   #   #   #   #   # #     #         # #   #   # # #     #   # #
 ### # # ####### ####### ##### # # ### ##### ### ### # # # # ##### ### # ##### # ### # ############### ##### ### # # ####### # #
 #   # # #     #         # #   # #   # #   #   #   #   # # #   # # #   # #   # # #   #       #         #     # #   #       # # #
 # ### ### ### # ######### # ### ### # # # # ##### ##### # ### # # # ### # # # # # ######### # ######### ##### # ##### ### # # #
 #   #     # # #       # #   #   # #     # #     #     # #   # #   #   # # #   # # #     #   # #     #       #       #   # #   #
#### ####### # ####### # ##### ### ####### ##### ##### # ### # ####### # # ##### # ### # # ### ##### # # ### ####### # ### ### #
     #     #  G#       #     #     #   #   #         #   # # #       #         # #   # # # #   #     # #   #       # # #   #   #
 ######### # ######### ##### ####### # # ### ####### ##### # ####### ####### # ##### # ### # ### ##### ### ####### # # # ### # #
 #   #   #       #   #         #   # # #   #     #         #       # #       #     # # #   #     #     #   #   #   # # # # # # #
 # # # # ####### # # # ######### # # ##### # ### # ### # ########### # ##### ####### # # ######### ##### # # # ##### ### # # # #
   #   #       #   # # #         # # #     #   # # # # #     #     # #     # #       # # # #   #   #     # # #     #     # # # #
########## ### ##### # # ######### # # ######### # # # # ##### ### # ####### # ####### # # # ### ####### # # ##### ####### # ###
     #   # #   # #   #   #   # #   # # #   #   # # #   #   #   # # #       # # #       # # #   # # #   # # # #   # #     # #   #
 ##### # ### ### # ### ### # # # ### # ### # # # # ######### ### # ####### # # ### ##### # ### # # # # # ### # # # # ##### ### #
 #   # #     #   #   # # # #   #   # # #   # #   #           #   #   #     # #   #     # #       #   #   #   # #   #     #     #
 # # ######### # ### # # # ####### # # # ### ##### ########### ##### # ##### ### ##### # ####### ######### ### ######### ##### #
 # #           #           #     # #   # #   #     #   #   #   #   #   # #       #   # #       # #           #   #   #   #   # #
 # ######################### ### ####### # ##### # ### # ### ### ####### # ####### # # ####### ### ############# # # # # # # # #
       #   #     #   #       #         # #   #   #     # #   # #         # # #   # # # #     #   # #   #   #   # # #   #   #   #
#### ### # # ### # # # ############### # ### # ######### # ### # ##### # # # # # ### # ##### ### # # ### # # ### # #############
   # #   #   # #   # #           #   # #     #           # #   # #   # #     # # #   # #       #   # #   # #   # # #           #
 # # # ####### ##### # ######### # ### ####### ##### ##### ### # # ### # ##### # # ### # ########### # ### ### # # # ######### #
 #   #       #       #         # #   #             #     #   #     #   # #   # # #   # #     #         #   # #   #   #       # #
#### ####### ########### ##### # ### ######### ######### ### # ##### ##### # # # ### # ##### # ##### ### # # ##### ### ####### #
     #     #       #   # # #   # #   #       # #     # #     #     #       # # # #   #     #   #   # #   #   #   # #   #       #
 ##### ### ####### # # # # # ### # # # # ### # # ### # ####### ### ######### ### ### ##### # ### # # # ####### # ### ### ##### #
     #   #     #   # #   #   #   # #   # #     # # # # #       #   #       #   #   #     # #   # # # #   #     #   #   #     # #
#### ### ##### # ### ######### ### ### # ### ### # # # ### ### ##### ##### ### ### ##### # ### # # ##### # ####### ### ##### ###
   # # #     #   #           #   #   # #   # #     # #   #   #     # #       #     #   #   # # # #     # # #   # # #   #   #   #
 # # # ##### ##### ######### ### ### # ### ### ##### ### ### ##### # # ##### ####### # # ### # # ##### ### # # # # # ### # ### #
 # #   #   #     #     #   # #   #   #   #     # #   #   #   #     # # #             # # # #   # #   #     # #   #   #   #     #
## ### ### ##### ### ### # # # ### ### ######### # ### ### ### ####### ####### ####### # # # ### # # ####### ### ##### ####### #
   # #         # #   #   #   # #   # #           #   # # #   #       #     #   #             #   # #       # #         #     # #
 # # ######### # ##### ####### # ### ### ####### ### # # # # ####### ##### # ### ############# ### ####### ### ##### # # ### # #
 # #   #   #   #     # #       # #       #   # #   #   #   #     #   # #   # # # #   #       #     #   # #   # #   # #   #   # #
 # # ### ### ####### ### ####### ### ##### # # ### ##### ####### ##### # # # # # # # # ##### ######### # ### ### # # ##### ### #
 # #   #   # #     #     #     # #   #   # # # #         #     #     #   # #   #   # #   #   #     #   #   #     # #   #   #   #
 # ### ### # # ########### ### # # ### # ### # # ##### # # ### ##### ########### ####### # ### ##### ### # ####### # ### ##### #
 #     #   # #       #   # #   # #   # #     # #   #   # #   #     #         #     #     # # # # #   #   # #   #   # #   #     #
## ##### ### ####### # # # # ### # ### ####### # # # ####### ##### ### ##### ### # # ##### # # # # ##### # ### # ##### ### #####
   #   #   # #   # # # # # # # # # #   #     # # # #       #     #   #     #   # # #   # #   #           #     # #   #   # #   #
 # # # ### # # # # # # # # # # # ### ### ### # # # ####### ##### ### ##### ### # ##### # ####### ############# # # # ### # # # #
 # # #   # #   # # #   # # #   #   # # # # # # # # #     #     #   #   #     # #     # #         #       #   # # # # #   #   # #
## # # ### ##### # ##### # ### ### # # # # # # ### ##### ##### ### ### ### # # # ### # # # ####### ##### ### # # # # # ####### #
   # # #   #   #     #   # #   # # # #   # # #     #     #   #   #   #   # # # #   #   # #   #     #   #   #   #   # #     #   #
 ### ### ### ####### # ### # ### # # ##### # ####### ### ### # ##### ### # ### ### ##### ### # ##### # ### # ####### ##### # ###
           #   #   # #   # # #   #   #                 #   # #       #   # #   # # #   # #   # #   # #     #       #       #   #
########## ### # ### ### # # # # ####### ##### ####### ### # ######### ### # ### # # # ### # # # # # ####### ################# #
         #   # #   #   #   #   #         #   # #       #   # # #   #   #   # #   #   #     # #   # #   # #   #     #           #
 ####### # # # # # ### ########### ####### # ### ####### ### # # # # ### ### ### ########### ##### ### # # # # ### # ######### #
   #       # # # #   #   #   #   # #       #     #     #   #   # # # #   #   #   #         #   #   # # #   # # #   # #         #
## # ##### ### # ### # ### # # # # # ######### ####### ### # ### # # ##### ### # ### ### # ### # ### # ##### # # ### # ### ### #
   # #   #     #   # # #   # # #   #     #   # #     #   #   #   # #S#     #   #   # #   # #   #     #         # #   #   # #   #
 ### # # # ####### ### # ### # ### ####### # ### ### # ##### # ### # # ####### ### # # ### # ################# ### ####### # # #
   # # # # #     # #   # # # # #   # #     #     #   #       # # # # #   #   #   #   #   #   #   #   #       # #   #       # # #
 # ### # # # ### # # ### # # # # # # # ########### ######### # # # # ### # # ### ####### ##### # ### # ##### # # ##### ##### # #
 #   # # #   # # # # # # #   # # #   #     # #   # #       # #   # # # # # #   #       # #     # #   #   #   # #     # #   # # #
#### # # ##### # # # # # ##### ########### # # # # ####### # ### ### # # # ####### # ### # ##### # ##### # ### ##### ### # # ###
   # # #     #     #   #       #   #       #   # # #     #     #     # # #       # #   #   #   # # #     #     #   #   # # #   #
 # # # ##### ##### ### ####### # # # ######### # # # ### ##### ####### # ####### ##### ##### # # # # ##### ##### # ### ### ### #
 #   # #   #     # # #   #     # # # #       # # #   # #   # # # #     #   #   #             # #   #     # #   # #   #   # #   #
 ##### # ####### # # ### # ### # # ### ##### # ####### ### # # # # ####### ### ####### ################### # # # ### ### # # ###
   #   #   #     #         #   # #     #     #     #   #   # # # #   #     #               #       #   #   # # # # #   #   #   #
## # ##### # ##### ############# ####### ##### ##### ### ### # # ### # ##### ############# # ##### # # # # # ### # # ####### # #
 # # #     # #     #   #               # #   #   #   #   #     #     # #         #     #   #   #   # #   # # #   #   #   #   # #
 # # # ##### ####### # # ########### ### # # # # # ### ### ##### ##### # ####### # ##### ##### # ### ##### # # ####### ### # # #
   # # #     #       #   # #       # #   # #   # # #   #   #   # # #   # #     # #   #   #   # #   # #     # #     # #     # # #
 ### # # ##### ########### # ##### # # ####### ### # ### ##### # # # ### # ### # ### # ### ### ### ### ### # ##### # ##### ### #
 #   # #     # #     #   # # #   # # #     # # #   #   # #   #   # #   # #   #     # #   #   # # #     #   #               #   #
 # ### ##### # ##### # # # # # # # ####### # # # ##### # # # ### # ### ##### ####### ### ### # # ####### ####### ##### # ### ###
 #       # #   #       #   # # # #       # #   # #     # # # #       # #     #     #     # #   #   #     #   #   #   # # #   # #
 ####### # ##### ########### ### ####### # # ### # ##### # # # # ##### # ##### ### ####### ##### ### ### # ### # # # # # # ### #
       # #     #       #   # #         #   #     #   #     # # # #     #       # #               #   #         # # #   # #   # #
 # ### # # # ### ##### # # # # # ##### ##### ####### # ##### # # # ##### ####### ########### ##### # ########### # ######### # #
 #   # # # #     # #   # #   # # #   #   #   #       # #   # # # #   # #                   # #     # #         # #   #       # #
 ### # # # ####### # ### ##### ### ##### # ### ######### # # ### ### # # # # ##### # ##### # # ####### ####### # ### # ####### #
 #   # # # #       #   #     #     #   # # #   #   #     # #     #   #   # #     # # #     # #   # #   #   # # #   # #       # #
 ####### # ####### ######### ####### # # # # ##### ####### ##### # ####### ####### # ####### ### # # ##### # # ### # ####### # #
     #   # #     #   #       #     # #   #               #     # #   #       #     # #         #   #       # #   # # #     #   #
#### # ### # ### # # # ####### ##### ##### ######### ### ##### # ### ####### # ##### # ##################### ### ### # ### #####
   # #   # # #     # # #     #   #   #   #         #   #   #     #   #     # #   #   #       #   #   #         # #   # #     # #
 # # ### # ### ####### # ### ### # ### ### ####### ### ### # ##### ### ### # ### # # ####### # # # # # ### ### # # ### # ### # #
 #   #   #     #       # # #     #   #   #   #     #   # #   #   #   # #   # # # # #   #     # #   # # # #   # # # #   # #   # #
 ##### ####### # ####### # ##### ### # # ### # ##### ### ##### # # # # # ### # # # ##### ##### ##### # # ### ### # # ### # ### #
 #   #         # #   #   # #   # #   # #     #     #       #   # # #   # #   # # # #     #     #   # # # #   #   # # # # #   # #
 ### ######### ### # ### # # # # # ### ########### ##### ### ### # ##### # # # # ### # ### ##### # # # # # ### ### # # # ### # #
     #       #     #   # #   #   #   #       #   # #   #   #   # #     # # # #   #   # #   #     # # # # #   #     #   #   #   #
 ##### # ############# ### ######### ### ### # # # # # ### ### # ####### # # ### # ##### ### ##### # # # ### ####### ##### ### #
   # # #             #   # #     #     # #   # # #   # #   # # #   #     # #   # #       #   #     #   #     #     #   #   # # #
 # # # ##### # ######### # ### # # ### # # ### # # ### # ### # ### # ##### ### # ######### ### ############### ### # ### ### # #
 #   # #     # #         #     #   #     # #   # #   # #     # #     #     # # #   #     #   #       #       #   #   #   #   # #
 ##### ####### # ################### # ##### ### # # # # ##### ####### ##### # ##### ### ### ####### # ##### ### ### # ##### # #
       #     # # #   #   #   #       # #     #   # # # # #   #   # #         #       #   # #   # #   # #     #   #   #     # # #
 ####### ### ### # ### # # # # ####### # ##### ##### # # # # ### # # # ############### ### ### # # ### # ################# # # #
 #       # #     #     # # # # #     # # # #   #     # # # #   # #   #   #           #   #   # # #   # #   #       #     # # # #
 # ####### ####### ####### # # ##### # # # # ######### ### ### # ##### ### # ########### ### # # ### ##### # ##### # ### # # # #
 # #             # #   #   # #     #   #   # # #       #   # #   #     #   # #     #   # #   # #   #       #   #     # # # #   #
## # ##### ####### # # # ######### # ####### # # ### ### ### ####### # # ### # ### # # # # ### # ############# ####### # # # ###
   #   #   #   #   # # # #         # # #     #   #   #   #   # #     # # # #   #   # #   #   # #           # #       # # # #   #
 ##### # ### # # ### # # # ######### # # ############# ### ### # ### # # # ######### # ##### # ### ####### # ####### # # ##### #
 # #   # #   # # #   #   #       # #   # #           #     # #   #   #   # #   #     # #   # #   #     # # # #   #   # #     # #
 # # ##### ### # # ####### ##### # ### # # # ####### ####### ##### ####### ### # ##### # # # ### ##### # # # # # # # # ##### # #
 #     #   # #   #   #   #     # #   # # # # #     # #       #         #       # #     # # #     #   # # # # # #   # #   # # # #
 ##### # ### ####### # # ##### # ### # # ### ### # # # # ### # # ##### # ####### # # ### # # ##### # # # # # # ######### # # # #
   # # #               #   #   #   #   #     #   #     # # #   # #   # #   #     # # #   # #   #   #   #   # #           # #   #
## # # ##### ############# # ##### # ######### ### ##### # ### # # # # ### # ##### # # ### ### # ########### ############# ### #
 # #         #     # #   # # # #   #       #   #   #     #     # # # #     #     # # #   #   # # #                 #     #   # #
 # ######### # ### # # ### # # # ####### # # ### # # ##### # ### ### ########### # ##### ### # # # ##### ##### # # # ### # ### #
 # #       # # # # #   #   #   # #     # #   # # # #     # #   #   #   #     # # #     #   # # # #     # #   # # # #   # # #   #
 # # ##### # # # # ### # ####### # ### # ##### # ####### ##### ### ### # ### # # ########### # # # ### # # # ### # ##### # # ###
   # #   # # # #   #   # #       # #   #   #     #     #   #     #     # #   # # #           # #   # # # # #     # #       # # #
 ### # # # # # ### # # # # ### ### # ##### # ##### ### ### # ############# ### # # ########### # ### # # # ####### # ####### # #
 #   # # # # #   # # # #   #   #   #       #   #   # # #   #   #           # # #   #   #   #       #   # #     # #   #     # # #
 # ##### # ##### # ### ####### # ### ########### ### # # ### # # ########### # ####### # # # # ### ##### ##### # # ### ### # # #
   # #   #       #   #         #   # #     #     #   #   #   # #         #     #       # # # #   #   #   #   # #     # # # #   #
#### # ############# ############# # # ### # ##### ######### # ######### # # ### ####### # # ### ### # ### # # ####### # # ### #
                                   # #   #   #               #             #             #   #   #   #     # #           #     #
