################################################################################################################################
   #             #                 #     # #   #               #           #       #       #     #     #       #         #     #
 # # ####### ### # # ### ### ### ### ### # # ### ### # # ####### ######### # ### ### ##### # ##### ### # ####### ####### ##### #
 # # #     #   # # #   #   #   # #   # # #   #   # # # #       #   #   #   # # #   #     # # #   #   #         # # #     #     #
 ### ##### # # # # ### ### ##### # ### # # ### ### # # ####### ### # # # ### # ### ####### # # # ### # ####### # # # ##### #####
     #     # # #   #   #   #   # #   # # #       #   #   #   #   # # #   #   #   # #   #   #   #     # #     #   # # #   #     #
 ##### ##### # ##### ### # # # ##### # # # ########### # # # # ### # ##### ##### # # ### ####### ####### ### ##### # ### ##### #
 # #   #   # #     # #   # # # #       # #           # #   # #   # # #   # #   #   # #   #       #     # #   #     #   #       #
 # # ### ### ####### # ### # # # ####### # ######### # ######### # # # ### # # ##### # ######### # ### # # ####### ### ####### #
   # #       #       # # # # # # #   #   # #   #   # #     #   # # # #       #       # #     #   # # # # #       #   #   #     #
## # ####### # ####### # # # # # # # # ### # # ### # ##### # ### # # ######### ##### # # ### ### # # # # ####### ### ### # ### #
   #       # #   #     #   # #   # # # #   # #   # # #   # #   #   #       # # #   # # # # #   # # #     #     # #   #   # #   #
 ######### ### # ### ##### # ##### # # ### # ### # # # # # ### ########### # # # # # # # # ### # # ####### ### # # ### ##### ###
         #   # #   #   #   # #     # #   # #   # # #   # #     # #       # #   # # # #   #     # #   #     #   # #     #   # # #
 ########### ##### # # ##### # ##### ### # ### # # ##### # ##### # ##### # ##### # # ##### ##### ### ### # ### # ##### # # # # #
   #       #     # # # #     # #   #   # #     #     # # #   #   # #     # #     # #     #   #     #   # #   # #     # # # # # #
 # # ##### ##### # # # # ##### # # ### # ########### # # # # # ### # ##### # ##### ##### ### ##### ### ##### # ##### # # # # # #
 # # #     #       # # #   #   # #   # #     #   #   # # # #   #   #   #   #   # #   # #   # #   #   # #     # #     #   # # # #
 ### # ############# # ### # ### ### # ##### # # # ### # # ### # ####### ##### # ### # # ### # # ### # # ##### # ######### # # #
     #           #   #   # # # #   #   #   # # # #     # #   # #       # #     # #   # # #   # #     # # #   # #     #   # #   #
 ############### # ##### # # # ### ##### # # # # # ##### # # # ####### # # ##### # ### # # ########### # ### # ##### # # # ### #
 #             # #   #   # # # # #   #   #   # #   #     # # # #     # # # #   #   #   # #     #   #   #   # #   #   # #   # # #
 # ############# ### # ### # # # ### # ####### ##### ##### # ### ### # # # # ####### ### ##### # # # ##### # ### # ####### # # #
 # #   #       # #   #   # #   #   #   #           #     # #       # # #   #         #   #   #   # # #     # #   #       # #   #
 # # # # ##### # # ####### ##### # ##### # ############# # ######### # ##### ######### ### # ##### # # # ### # # ####### # ### #
   # # # #   # # # #     #       #       # #     #     # #       #   # #               #   # #     # # #     # # #   #   #     #
 ### # # # # # # ### ### ######### # ### # ##### # ### # ### ### # ### # ############### ### # ##### ######### # ### # ####### #
     # # # # # #     # # # #   # # #   # #     # # #   #   # #   # #   # #       #       # #   #     #   #     #               #
 ####### # ### # ##### # # # # # # ### # ##### # # # ### # ### # # # ### # ##### # ####### ######### # # # ################### #
 #   #   #     #     #   #   #   # #   # #   # #   #   # # #   # #   #     #   # #   #         #   # # # #       #   #       # #
 ### # ########### # ##### ####### ##### # # # ####### ### # ### ####### ### # # ### # ######### # # # # # ##### # # ### # ### #
   # #       #   # #       #     #   #   # #   #   # #   # # # #   #   # #   # #     # #     #   # # # # # # #   # #     #     #
## # ####### ### ####### # # ### ### ########### # # ### # # # # # ### # # ### ####### # ### # ### ### # # # # ### ##### #######
 #   #   # #   #   #     #     #   #   #   #     #   # #   # #   #     # #   #   #   # # # #   # # #   # #   #   #   #   #     #
 # ### # # ### ### # ##### ####### ### # # ### ##### # ##### ##### ##### ### ### ### # # # ##### # # ### ############# ### ### #
   #   # #   # #     #   # #     #   #   #   # #   # # #     #         #   #   #   #     # #     #   #   #       #     #   # # #
 ### ### # ### # ####### # # ### # ######### # # # # # # ##### ### # # ### ### ### ##### # # ######### ### ##### # ##### ### # #
   #   #   #   # #     # # # #     #         #   # #   # #     #   # #   # # # # # #   # # #         #     #     #     #     # #
 # ##### ### ### # ### # ### ##### # ################# # ####### ##### ### # # # # # # # # # ##### ######### ######### ####### #
 #   #   #   #   # # # #     #   # # # #   #   #   #   #       # #   #     #   # # # # # # # #   # #       # #                 #
 ##### ### ####### # # ##### # # ### # # # # ### # # ######### # ### # ##### ### # ### # # # # # ### ### # # # ####### #########
 #       #   #   # # # # #   # # #   #   #       #   #       # #     #       #   #     # #   # #   # #   # # # #     # #       #
 # ######### # # # # # # # ### # # ######### ##### ### # ### # ####### # # ### # ####### # ### ### # # ### # ### ### # ### ### #
   #   #   # # #   #   #   #   #   #       # #   #   # # #   # #   #   # #     #     #       # # #   #   # # #   #   #   #   # #
 ##### # ### # ##### ####### ####### ### ### # # ### # # ##### # # # ### ########### # # # # # # ####### ### # ######### ### # #
 #         # # #   #         # #       #     # #   # # # #     # #   # #           #   # # #   #     #   #   #         # #   # #
 # ### ### # # # ############# # # ########### ### # # # # ##### ##### ########### # ### # ######### # ### ########### # ### ###
   #   #   #   # #   #   #     # #             #   #   # #   # # #   # #   #   #   # #   #   #     #   #   #         # #   #   #
 ####### # ##### # # # ### ### # ############### ### ### ### # # ### # # ### # # ### # ### # # ### ### # ### ####### # ### ### #
 #     # #       # # #   #   #   #               # #   #   # # # #   # # #   #   #   # #   # #   #   # # #         #   #       #
## ### # ##### ### # ### ### ##### ############### ### # ### # # # ### # # ####### ### ### ##### ### ### # ##### # ##### ### ###
   # # # # #   #   #   #   # #   # #     #   #     #   #   # # #   #     #     # #   #   # #   # # #     #   # # #         # # #
 ### # # # # ### ##### ### # ### # # ### # # ##### # # ### # # ##### ######### # ### ### # # ### # ####### # # # ##### ### # # #
 #   #   # #   # #   #   #       #     #   #     # # # #   # # #     # #   #   # #     # # #     # #       # #   #   #   # #   #
 ### ##### ### # ### ### # ############### ##### # # ### ### # # ##### # ### ### # ### # # ####### # ####### ### # # # ### #####
   #   #   #   #   # #   #           #   #     # #   #   #   #         #   # #   #   # # #         # #   #   #   # # # #   #   #
## # # ### # ##### # # ### ######### # # ##### # ### # ### ####### ####### # ### ### ### ### # ### # # # # ####### # ### # # # #
   # #     # #     #   # #   #   #   # #   #   # #   #G  #     #   #     # #   #     #   # # #   # #   # # #       #   # # # # #
 ######### # # ######### ### # # # ### ### ##### # ########### # ### ### # # # ####### ### # # # ####### # # ######### # ### ###
 #     #   # #   # #       # # #   #     #     # # #   #     # #     #   # # #       #   #   # #         #   #     # # #   #   #
 # ### # # # ### # # ### ### # ############### # ### # # # ### ### ### ### # ####### # # ############# ####### ### # # # # ### #
 # #   # #   #   #     #     # #   #       #     #   #   #   #   #   # #   # #       # # #           #         # #   # # #     #
 # # ##### ### ####### ######### # # ##### # ##### ######### ### ### # # ##### ######### # ######### # ##### ### ##### # #######
   # #   #   #       # #   #     #       # # #     #     #     #   # # #       #     #   # #     #   # #   #   #     # #       #
 ### ### ### # ##### # # # # ########### # ### ####### # ####### # # ############### # ### # ### # ### # # # # # # # # ####### #
   #   #   #   #   #     #   #         # #   #       # # #     # # #   # #           #   # # #   #   # # # # #   # # #     # # #
 # ### ### ### # # ### ####### ####### ##### ####### # # # ### ### ### # # ####### ##### # # # ##### ### # # ##### ####### # # #
 #   #     #   # #   #       # #     #   #         #   # # # #     #       #     # #   #     # #   #     # #   #   #       #   #
#### ########### ### # ##### # # # ##### # ##### ####### # # ####### ####### ### ### # ######### # ####### ### # ### ######### #
   # # #   #   # #   #     #   # # #   # # #   # #       # #       #       # # #     #   #     # #         #   #   #   #       #
 # # # # # # # # # ### ########### # ### # # # ### ####### ####### # ##### # # ######### # ### # ################# ### ####### #
 #   # # #   # # #         #     # #   # #   #           #   #   # # #     # #   #   #   #   # #   #     #           #       # #
 ##### # ##### ##### ##### # ### # ### # # ########### ##### # # # # ####### ### # # # ##### ##### ### ### # ##### # ####### ###
 #     # #   # #   #   #   # # # # # #   # #     #   # #     # #     #     # #   # # # #   #     #   #     # #     # #     #   #
 # ##### # ### # # # # ##### # # # # ##### # # ### # ### ######### ### ### # # # ### # ### ##### ### ##### # # # # ### ####### #
       # #   #   # # # #   # # # # #       # # #   # #   #       #   # #   #   #   #   #     #   #   #     # # # # #   #     # #
 ####### ### ##### # # # # # # # # ### # ### # # ### # ### ### # # # ### ######### ##### ### # ### ### ##### # # # # ### ### # #
 #     #   #       # #   #   # # #     # #   # # # #   #   #   # # #     #   #   # #   # #   #   # #   #     # # # #     # #   #
## ### ### ######### ### ##### # ####### # ##### # ##### ### ### # ####### # # ### ### # ### ### # ##### ##### # # ####### #####
   # #     #   #       #     #   #       # #     #       #   # # #   #     # #   #   #   #     #   #     #     # # #   #   #   #
 ### ####### # # ##### # # ####### ####### # ##### ##### # ### # ### # ##### ### ### ### # ### ##### ####### # # # ### # ### # #
 #   #   #   #   #   # # # #   #           #   # #     # #   # #     # #   #       #   # #   #   #   #   #   # # #     #     # #
 # ### # # ######### # # ### # # ####### ##### # # ### # ### # ##### # ### ### ### ### ##### ### # ### # # # # # ####### ##### #
 #     #   # #     #   # #   # #   #   # #   # # # #   #   # #       #     #   #     #     #   #   #   # # # # #   #     #   # #
 # ##### ### # ### ####### ### ### # # # # # # # ### ##### # ##### ######### ### ### ##### # # ####### # # # # # ### ### # # ###
   #   # #   #   # #       # #   # # # # # # # #     #   # # #   #     #     #   #   #   # # # #   #   #   # # #     #   # #   #
## # # # # # ### # # ####### ### ### # ### # # ####### # # # # # ##### # # # # ### ##### # ### # # # ######### ########### ### #
   # # #   # #   # # #         #     #   # # #   #     #   #   #     #   # # #   #     # # #   # #   #       #             # # #
 # # # ####### ### # ######### ######### # # ### ################### # ##### ### ##### # # # ### ########### ############### # #
 # # #     #   #   # #         #       # # #   # #         #     #   # #   #   #     #   #   #               #         #   #   #
## # ##### # ####### # ####### # # ### # # ##### # ####### # ### ####### # # ########### ##### ################# # ##### # #####
   #     # #       #   #     # # # #   # #       #   #   #   # #         # # #   #     #       #         #     # # #     #     #
 ####### # ####### ######### # ### # ### ######### # # # ##### ########### ### # # ### # ### # # ####### ##### # # # ####### # #
 #   #   # #       # #   # # # #   #   # # #       #   #     # #   #   # # #   # # # # # #   #   #     # #   #   # #     # # # #
 # ### ### # ####### # # # # # # ### ### # # # # ########### # # ### # # # # ### # # # ### # ##### ##### # # ### ####### # # ###
 #   #   #   #       # # #   #   # # #   #   # #   #     #   # #     #   # #   #   # # #   # #       #   # # #   #     # # #   #
 ### # ##### # ##### ### # ####### # # ########### # ### # ### ######### # ### ##### # # ### # # ### # ### # # ### # ### # ### #
     # #   # # #   #         #     # # #           # #     #       #   # #     #     #   # # # # #   #   # # #     #     #     #
 ##### # # # # # ############# ### # ### ######### # ####### # ##### ### ####### ######### # # # # ##### # # # ########### #####
       # # #             #     # # #     #   #   # #   #     # #     #           #     # # #   # # #   # # # #       #   # #   #
 ####### # ############# # ##### # ####### # # # # ### # ####### ##### # ### ### # ### # # # ### # # # # ### # ##### # # ### # #
 #     # #       #       # #   # # #     # # # #   #   #   # #   #     #   # # # #   #   # #   # #   # #     #     #   # #   # #
 # # ### ####### # # ##### # # # # # # # # ### ##### ##### # # ### ####### # # # ### ##### ##### # ### ####### ### # ##### ### #
 # # #   #     # # # #   #   # #   # # #       #     #     # #     #     # #   #       #   #     #   #   #   # #   # #     #   #
 ### # ##### # # # ### # ##### ####### ### ##### ##### ##### ##### # ##### ########### # ### ##### ### # ### # # ### # ##### ###
 #   #       # # # #   #   #   #     # #   #     #   #             #       # #   #   # #   # #     #   #     # #   # # #   #   #
 # # ######### # ### ##### # ### ### ### ### ##### # ########### # ######### # # # # # ### # # ### # ##### ### ### # # ### #####
 # #   #   # # # #   #     #     # #     #   #     #   #         #           # #   # # #   # # # # #     #   #   # # #         #
 # ### # # # # ### ### ########### ##### # ### ####### # ######### ### # # # # ##### # # ### # # # ##### ##### ### # ######### #
   # #   #   #   # #   #     #           # #   #     # #   #       #   # # # # #   #   #     #   #     # #     #   #   #     # #
#### ### ####### # # ##### # # ##### ##### # ### ### # # # # ####### ### # ### # # ### ####### ### ##### # ##### ### ### ### # #
 #       #     #   #       #   #     #     # #   # # # # # #   #     #   # #   # # #             #   #   # # #   #   #     # # #
 # ####### ######### ######### # ##### ##### # ### # # ### # ### ##### ### # ### # # ### ########### # ### # # ####### ##### # #
   #       #     #   #   #     #     #   #   # # #   # #   # #   #     #   #   # #   # #     # #   # #     # #     #S  #     # #
 ### ####### ### # ### # ########### ### # ### # # ##### ##### ### # ### ##### # ##### ##### # # # # ####### ##### # ### ##### #
 #   #     #   # # #   #       #   # #   #   # # #       #     #   #   # # #   #     # #   #   # # #     #   # #   #   #       #
 # ####### ### ### # ######### # # # # ##### # # ######### ########### # # # ####### # # # ##### # # # # # # # # ##### #########
 #   #       #     # # #     # # # # # #   # # #   #       #   #     # # # #   #   #   # #   #   #   # # # # # #       #       #
 ### # ##### ##### # # # ##### # # ### # ### # # # # ####### # # ### # # # ### ### ##### ##### ######### # # # ######### #######
 #   # #   #   #   # #           #   # #   #   # #   #   #   # # #     #     #   # #     #   # #   #     # # #       # #       #
 # ### # # ### ### # ##### ######### # ### ##### ##### # ### # # ############### # ##### # # # # # ### ### # ### ### # # ##### #
   #   # # # #   # #     # #     #   # #         # #   #     #   #   #     #     #     #   # #   #   #   # #     # # #       # #
 ##### # # # ### # ##### ### ### # ### ### ##### # # ##### ####### # # ### # ######### # ########### ### ######### # ##### ### #
   #   # #     #       # #   # # #   #   #     # #   #     #       #   #   #                       # #   #   #     #     # #   #
## # ### ##### ### # # # # ### # ### ### ### # # ##### ##### ########### ########################### # ### # # ### ##### # # ###
   # # # #   #     # # #   #   #   #   #   # # #     #     # # #         #   #             #         # #   #   # #   #   # # # #
 ### # # # # ######### ####### ### ### ### # # ##### ####### # # ########### # ########### # ######### # ####### # ### ### # # #
     #   # #                     #   #     # #     #           #             #           #   #                   #         #   #
