################################################################################################################################
################################################################################################################################
#           #   #   #                 #   #   #         #       #   #   #     #                               #     #           
# ####### ### # ### # # ### ### # ### # ### ### ####### # ##### # # # # # ### # # ##### # ####### ####### ### # # ### ##### ####
#       #   # #   #   #   # #   #   #   #   #   #         #   # # #   # #   # # #     # #   #   # #     #   # # #     #   #     
####### ### # ### ####### # ####### ### # ### ### ### ##### # # # ##### ### ### ##### # # # ### # # ### ### # # ####### # ##### 
#     #   # # # #     #   #     #   #   # #   # # #   #   # #   # #   #     #       # # # #     #   # # #   # #   # #   #       
##### ### # # # ##### ######### # ### ### # ### # # ### # ##### # # # ##### # ####### # ######### ### # ##### ### # # ##########
#   #   # # # # #   #           # # #   #   #   # #   # #     #   # # #   # #   #     #   #     #     #   #     #   # #     #   
# # ### # # # # # ##### ######### # ### ##### ### # ### ##### ####### ### # ### # ##### # # ### ### ##### # ####### # ##### # # 
# #     # # #   #       #       # #   # #   #     # #   #   #   #   #         # # #     #     #   # #   # # #     # #       # # 
# ##### # ########### # # ##### # # # # # # ####### # ### ##### # # ####### ### # ### # ######### # # # # # # ### # ######### # 
# #   # #             # # #   #   # # #   #         #   # #   # # #       # #   # #   #     #     # # #   #     #   #         # 
# # # ##### ##### ##### # # ####### # ############# ### # # # # ######### # # ### # ######### ##### # ######### ##### ######### 
# # #     # #     # #   #   #     # #     #         # # #   #         #   #   # # #   #       # #   #         #     #       #   
# # ####### # ##### # ####### ### # ##### ####### # # # ############# ### ### # # ### # ####### # ##### ##### ### # # ##### ####
# #         #   #   # #   # # # # # #   #       # #   #     #   #   #   #   #   #   # # #   # #   #   #   #   #   #   #   #     
# ######### ### # ### # # # # # # # # # ####### # # ####### # # # # ### ### ### ### # # # # # # ### # ##### ######### # # ##### 
# #         # #   # # # #   # # # #   #   #     # # #       # #   #   # #     #   # # # # # # # #   #       #       # # # #     
# # # ##### # ##### # ### ### # # ####### # ##### # # ####### ####### # ##### ### # # # ### # # # ######### # ##### # # # # ### 
#   #     #   #     #     #   # # #       #       # #     #   #   #   #   # # #   # # #     #   # #         #   #   # # #   # # 
####### # ######### ####### ### # # ############### ####### ### # # ##### # # # ### ########### # ### ######### # ### # ##### # 
#     # #         # #   # #   #   # #       #         #     # # # # #           #   #   #       #   # #   #     # #   #   #   # 
# ### # ######### # ### # ##### ### ##### ### # ##### # ##### # ### # # ######### ### # ########### # # # # ##### ### ### # ### 
# #   #   #   #   #   # # # #   #   #   #     # #   # # #     #     # #         # #   # #         # # # #   #   #   # # # #     
# ##### # # # # ##### # # # # ####### # ####### # ### # # ### ####### ######### ### ### # ####### # # # ##### ##### # # # ##### 
#   # # #   # #     # # # # #     #   # #   #   #     # #   #             #   #     # # # #   # # # # # #   #       #   #   #   
### # # ##### ##### # # # # ##### # ### # # ####### ### # ##### ######### # # ####### # # # # # # # # # # ### ############# # ##
# # #       #     #             #   #   # #     #   #   #   #   #     #   # #       # # #   #   #   # #   #   #     #       #   
# # ######################### ####### ### ##### ### # ### # ##### ### ##### ####### # # ############# ##### ##### # # ######### 
# #   #   #           #     # #     #   # #   #   # # #   #     # # #     # #     #   #     #       #     #       # #       #   
# ### # # # ######### # ### ### ### ### ### # ### # # # ####### # # ##### # # ### ######### # ####### # # ######### ####### # ##
# #   # #   #   #   # #   #   #   # # #   # #     # # #       #   #   #   #   # #         # # #   #   # #     #   # # #     # # 
# # ##### ### # # ### ####### ##### # ### # ######### ##### ######### # ####### ######### # # # # # ####### ### # # # # ##### # 
#   #   # #   # #         # #           # # #       # #   # #   #     # #   #   #     #   # #   #   #     #   # #   #   #     # 
# ### # ### ### ######### # # ####### # # # ### ### # # # # # # ##### # ### # ### ##### ### ##### ##### # ### # ######### # # # 
# #   #     # # #   #     #   #     # # # #     # # # # # # # #     # #     #   # #     #   #     #   # #     #   #       # #   
# # ######### # # # # ##### ### ### # # # ####### # # ### # # ##### # ######### # # ##### ######### # ########### # ### ### ####
# # #       #   # # #   # # #   #   # # # #   #   # #   #     #     # #   #       #     #     #     #             #   #   #     
# # ####### # ##### ### # # # ### ### # # # # # ### ### # ########### ### ####### ##### ##### # ######################### ### # 
# # #     # # #   #   # #   # #   #   #   # #   #   #   #   #   #       #           #   # #   #     #                     #   # 
# ### ### # # # # ### # # ### # ####### ### ##### ### ### # # # ####### ########### # ### # ####### # ##################### ####
# #   #   # # # #   # # #     # #     #       #   #   #   # # # #   #           #         #         # #   #             #   #   
# # ### ### # ##### # # # ##### # ### # # ### # ### ### ### # # # # ########### # # ################# # ### ########### # ### # 
#   #   #               #   #   #   # # # #   # #         #   #   #   #       #   # #       #       # #     #   #   #   #     # 
##### ### # ######### ##### ######### # # ##### # ### # # ####### ### # ##### ##### # ##### # # ##### ####### # # # # ######### 
#     # # #         #       #     #   # #           # # #       #   # # #   # #   #     # #   #     # #       #   # # #   #   # 
# ##### # ######### # ####### ### # ### ######### # ### ####### ##### ### # # # # ##### # ######### # ########### ### # # # # # 
#     # #       #   #         #   # #   #   #   # #   #   #     #   # #   # # # #     # #   #     # #   #   #     #   # #   #   
##### # ####### # ### ####### ##### # ### # # # # ### # # ####### # # # ### # ####### # ### # ### ##### ### # ##### ### ####### 
#             # #   #   #   # #     # # # #   # # #   # # #       # #     # #   #   # # #   #   #     #   #   #   #   # #   #   
# ####### ##### ### ##### # ### ##### # # ##### ### ##### # ####### ####### ### # ### # # ##### ##### ### ### # # ### # # # ### 
# #     #       # #       #     #   #   #   # #   # #     #     # #   #     # # # #   # #     # #   #   #   #   #       # #     
# # ### ####### # ################# # ##### # ### # ### # ##### # ### # ##### # # # ### ##### # ### # ##### ############# ##### 
# #   # #     # #     # #         # # #   # #     #   # # #   # #   # #     #       #   #     # #   #     #       #     # #     
# ### # # ### # ##### # # ####### # # # # # # ####### # ### # ### # # ##### # ##### # ### ##### # ##### ######### # ### # # # ##
# #   #   #   #         #       # #   # #   #   #   # #   # #     #   # #   #     #       #           #         #   # # # # #   
# # ####### ### ####### ####### # ##### ####### # # # ### # ########### # ### ### ##### # # ####### # ### ### ####### # # # ### 
# #       # #     #   # #     # #   #   #   #   # #   # #   #       #   # #   # #     # # #   #   # #   # # #     #   # # #   # 
# ####### # ####### # ### # ### ### # ##### # ### ##### ########### # ### ### # ##### # ##### ### # ##### # # # # # ### # ##### 
# #   #   #   #     # #   # #   # # # #     #   #   #   #         # #   #   # #       #     # #   # #     # # # # #   # #     # 
# # # # ##### # ####### ### # ### # # # # # ### # # ### # # ##### # ### ### # ############# # # ##### ##### ### # ### # # ### ##
# # #   #   # #   #   #   # #   #   # # # # #   # #   # # #     #   #   #   #   #   #     # # #   #   #   #     # #   # #   #   
# # ####### # ### # # ### ##### # ##### # ### ### ### # ####### ### # ### ### ### # ### ### # ### # # # # ####### # ### # ##### 
# #     #   #     # #     #   # # # #   # #   # #   # #     #   #   #     #   #   #   #     # # #   # # #   #     # #   #     # 
# ##### # # ####### ####### # ### # # ### # ### # # # ##### ##### # ####### ### ##### ####### # ####### ### ####### # ##### # # 
#     #   #   #   #         #     #   # # #   #   # #     #       # #         #   # #         #   #     # #       #   #   # # # 
# # # ####### # # ######### ####### ### # ### ##### ##### ### ##### # ####### ### # ####### ### ### ##### ####### ##### # # # # 
# # # #     # # #   #   # #         #   # #   #   #     # #   #   #   #     #   #     #   #     #   #   #     # #       #   # # 
### # ##### # # ##### # # # # ### ### ### # ### ####### # # # # # ### # ### ##### ##### # ####### ### ####### # ##### # ####### 
#   #           #     # # # #   #     # #   # #         # # # # #   # # # #   #   #     #   #   # #       # # #   #   #     #   
# ####### ##### # ##### # # ### # ##### ##### ### ##### # ### # ### # # # ### # ### ####### # # # # # # # # # # # # ######### # 
# #       #   # #     #   #   # #       #   #     #   # #   # #   # # # #   #     # #     # # # # # # # #   # # #   #         # 
# # ### ### # # ##### ######### # ######### # ##### # ##### ##### # # # # ######### # ##### ### # # # ####### # # ### ######### 
# #   #   # #   # #   #   #     #   #     #   #   # #     #       # #   #     #   # # #   # #   # # #     #   # # #   #         
# ####### # ### # # ### # # ##### # # ### ##### # ####### ####### # # ### ### # # # # # # # # ### # ##### # ### # # ### ########
# #       # # # # #     #   #     # #   # #     # #   # #       # # #   #   # # #   # # # #     # #     # #     # # #       #   
# # ####### # # # ########### # ### ### # # ##### # # # ####### # # ### ### ### ##### # # ##### # ##### # ####### # ######### # 
# # #   #   #   #             # #   #   # # #   #   # #         # # # #   # #           # #   # #   #   # #       #           # 
# # ### # ### ### ##### ### ##### ### ### # # # ##### ####### ### # # ### # # ############# # ##### # ##### # ### ############# 
# #     #   #     #   # #   #   # #   # #   # # #   #       #   # # # # #   #   #     #     #       #       # #       #         
# ### ##### ### ### # # # ### # # # ### ####### # ######### ### ### # # ### ### # ### # ##################### # ### # # ########
#   #   #   #   #   # # # #   # #   #   #         #       #   #     #     # # # # # # #     #             #   #   # # # #       
### ##### ####### ### # # # ### ##### ##### ####### # ### ### ########### # # # # # # ##### # ########### # # ### # # # ####### 
#   #   # #     #   # # #   # # #     #   # #       # #   # # #         #     # # #   #   # # # #   #   # # # # # # # #     #   
##### # ### ### ### # # ##### # # ##### # # # ####### # ### # # ####### ##### # # ##### # # # # # # # ### # # # # ### ### ### ##
#     # #   # #     #   #     # #   #   #   #   # #   #     # # #     #   #       #     # #   #   # #     # #   # #     #     # 
# ##### # ### ########### ##### ### # ######### # # ####### # ### ### ### # ##### # ############### ####### ##### # ########### 
#   # # # #     #         #   #   # # # #     #   #       # #     # # # # # #             # #     # #       # #   # #     #     
### # # # ##### # ### ### # # ### # # # # ### ### ####### # ####### # # # ### ### ####### # # ### # # # # ### # ##### ### # ####
#   # #   #   #   #   #   # #   #   #   #   #   # #     # #       # # #   #   #   #     # # #   # #   # #     #   #   # # # #   
# ### ##### # ### ##### # # ########### ### ### # # ### # ####### # # # ### ### # # ### # # ### ##### # ######### # ### # # # # 
# #         # #   #     # #               # #   #   #   #   #     # # # #   #   # # #   #     #       # #   #   #   # # # #   # 
# ####### # # ##### ##### ### ########### # ##### ######### # ##### # # ### ####### # ####### ### ### # ### # # ##### # # ##### 
#   #     # #   #   #         #   #     #       # #     #   #       # #   # #       #   #   #     #   #   # # #   #   # #   #   
### # # ### ### # ### # ####### # # ### ####### # # ### # ########### ### ### ######### # # # # # # ##### # # ### # ### ### # ##
#   # #   # # #   #   # #       #   #   #   #   # #   #   #         # #    S  #   #   #   #   # # #     #   # # #   # #     #   
# ######### # ##### # ### ########### ### # # # # ### ##### ####### # ########### # ####### ### # ##### ##### # ##### ######### 
#         # #       # #   #     #   # #   # # # #   #     # #     # #       #     #   #     #   # #     #             #   #     
# ####### # ######### # ####### # # # ### # ### ### ####### # ### # ####### ##### ### # ##### ### # ##### ### # ####### # # ### 
# #     # # #         # #       # # #     # #   # # #       #   # #     #   #     # # # #     # # #       #   #         # #   # 
# # ### # # # ### ### # # ######### ####### # ### # # ########### ##### # ### ##### # # # ##### # ######### ### ### ##### ##### 
# # #   # # # #   #   #   #   #   #       # #       # #   #     #     #   #         # # #     #   #       #   #   # #   #   #   
# # ##### # ### ### # ##### ### # # ### ### ##### ### # # ##### # ### ##### ####### # # ##### ### # ##### ### ### # # ##### # ##
# #   #   #   # #   # #     #   # #   #   #     #   #   #       # #         #     # #       #   #       # #   #   # #   #   #   
##### # ##### # # ### # ### # ### ### ### ##### ### ############# ####### # # ### ##### ### ### ######### # ####### ### # ##### 
#     # #     # #   #   # # # #   #   # #   #   #   #                   # # #   #     # #     #   #       #       #   #   #   # 
# ##### # # ### ######### # # ##### ### ### # ### # # ### ############# # ##### ##### ### ### ### # ############# # ####### # # 
#   #   # # #   #       #   #             # #     # # #   #         #   #     #   # #     #   #   #         #   # #   #   # #   
### # ##### # # # ##### ####### ##### ### # ####### # # ### ####### ##### ####### # ####### ### ########### # # # # # # # ##### 
# #   #     # # # #   #       # #   #   # #   #   #   #   # #     #   #   #     # # # #       # #   #     #   # # # #   #     # 
# ##### ##### # # ### ####### # # # # # # ### # # ####### # ##### ### # ### ### # # # # # ### # # # # ### ####### # ######### # 
# #     #     #   #   #     #G  # # # # # #   # # #       #       #   #   # # # #   #   # #   #   # # # #       # #         #   
# ### ### ######### ### ### ##### # ### ### ### # ##### ########### ####### # # ####### # # ####### # # ### ### # ######### ####
# #   #   #   #         #     #   #   #   # #   #   #   #   #   #     #   # # #   #     # #     # #   #   #   # #     #         
# # ### ### # # ### # ### ##### ##### # # # # ##### # # # # # # # ##### # # # # # ### # # ##### # ####### ##### ##### # ### ####
#   #     # #   #   #   #   #   #   # # # # #     # # # # #   # #   #   # # # # #   # # # #   #   # #   #       #   # #   #     
##### ### # ########### ### # ### ### ### # ##### # ### # ##### ### # ### # # ##### # ### # # ##### # # ######### # # ### ##### 
#     #   # #     #   #   # #   #     #   #   #   # #         #     # # #   # #     #   #   #     #   #     #   # # #   #   #   
# ### # ### # ### # # ##### ### ##### # ####### ### # # ##### ####### # ##### # ####### ##### ############# # # # # ### ### ####
#   # #     # #     #     #   #     # # # #     # # # # #   #   #     #     #   #   #   #   #       #       # # # #   # #   #   
### # ##### # ########### # ####### # # # # ##### # # # # # ### # ######### ##### # # # # ######### # ######### # ### # ##### # 
#   # #   # #   #       # #       # # #   #   # # # # # # #     # #     #         #   # #         #   #   #     #   #   #     # 
# ##### # ##### # ##### # # ####### # ####### # # # # ### ##### # ### # # ############# ######### ##### # # ####### ### # ##### 
#     # #     # #     #   #   #   # #       # # # #   #   #   # #   # # #     #         #     #   #   # #   # #     #   # #   # 
##### # ##### # ##### ######### # # ####### # # # ### # ##### # ### # # ##### # ######### # ### ### # # ##### # ######### # ### 
#     #     #   #               #   #         #       #       #       #       #           #         #         #           #     
################################################################################################################################
