################################################################################################################################
#     #       #   #   #     #     # #   #         #       #   #                   #     #       #       #               #   #   
### # # ##### # # # # ### ### ### # # # ### ### # # ##### # # # # ####### ####### ### # # ##### # ####### # ########### # # # # 
#   # # #   #   #   #   #   # # #   # #     #   # # #     # #   # #   #   #     #   # # #     # # #       # #     # #   # #   # 
# ### # # # ########### ### # # ##### # ##### ### # ####### ### ### # ### # ### ### # # ##### # # # ##### # # ### # # ### ##### 
#   #   # #   #       #     #       # # #   # #             #   #   # #   #   #   #   #     # #   # #     # # #   # # # # #   # 
### ##### # # ### # # # ########### # ### # ### ############# ### ### # ##### ### ######### # ##### # # ### # # ### # # # # # # 
# # #     # #   # # # # #           #   # # #   #     #   #   #   #   #   #   # #   #               # # #   # # #   # # # # # # 
# # # ##### ### ### # # # ############# # # # ### ### # # # ### ### ####### ### ### # ################# # ### # ### # # # # # ##
#   # #     #       #   #   #     #     # #   #   # # # # #   #   #           # # # #     #       #     #   # #       # #   #   
####### ##### ####### ##### ### # # ##### ##### ### # # ##### ### ########### # # # ####### ##### # # ##### ######### # ####### 
#       # #     #   #           #   #   # #   #   #   #       #   #   #     #     #   #     #   # # #     #   #     # #   #     
# ### ### # ### # # ############### # # ### # ### ########### # ### # # ### ######### # ####### # ####### ### # ### # ### # ####
#   #   #   #   # #         #   #   # #     #     #   #   #   # # # #   # #   #     # #   # #   #   #   # #   #   # #   # #   # 
####### ### # ### ######### # # ##### ############# ### # ##### # # ##### ### # ### # ### # # # ### # # # # # ##### ### # ### # 
#     #   # #   #     #   #   #       #   #     #       #     #   # #   #       #   #   # #   # #   # # # # #   #   # # #   #   
# ### ### # ### ##### # # ############### # # ### ########### ### # # # # ####### ##### # ##### # ### # ### # ### ### # ### ### 
# # #   # # #       # # #                   # #   # #     #   #   #   # # #   #         #     # #     #     # #   #   #   # #   
# # ##### ### ### ### # ##### # ########### ### ### # ### # ### ####### ### # ############### # ##### ####### # ##### ### # # ##
#         #   # #   # #     # # #         # #         #   #     # #   #   # #   #             #       #     # # #   #   #       
########### ### ### # ##### # ### ####### # # ####### # ######### # ##### # ### ##### # ####### # ##### ### ### # # # ### ##### 
#         # #   #   # #   # #     #   #   #   #     # # #         #   #   #   #   #   #   #   # # #     # #     # #   #   #   # 
# ### # # # # ### ### # ### ####### # # ### ### ### ### # # ### ##### # ######### # ##### # ### # # ##### ####### ### # ### # ##
# #   # #   #   # #   # #   #       # # #     # # # #   # #   #       #           #   #   #   # # # #           #   #   #   #   
# # ### # ##### # # ### # ######### ### ####### # # # ### ### # ####################### ##### # ### # # # ### # ##### ### ##### 
# # #   # #   #   # #       #   #   #   #       #   #     #   # #   #         #       # #     # #   # # # #   #     # #   #   # 
# # # ##### # ##### ####### # # # # # ### ################# ### # # # ####### ####### # # ##### # ### ### # ####### # # ### # # 
# # #   #   #     #     #   # # # # #   # #               # #     #   # #     #     # # # #     #   # #   # #     # #     # #   
### ##### ####### ##### # ### # # # ### # ####### # ##### # # ######### # ##### ### # # # # ### ### ### ### # ### # ##### ######
#   # #   # #   #       # #   # # #   #   #   #   #   # #   #           #       #   #   # #   # # #   # #   # # # # #   # #     
# ### # ### # # ######### # ### # ### ##### # ####### # ##### ### ##### ######### ####### ### # # ### ### ### # # # # # # # ### 
#     # #   # #     #       # # # #   #   # # #   #   # #       #     #     #   #   #         # #   #     #   #   # # #   # #   
####### # ### ##### ######### # # # ### # ### # # # ### ############# # ##### # # # ########### ### ########### ### ##### # ####
#     # #     #   # #       #   # # #   #   #   #   # # #         #   # #     # # #     #     #   # #   #     # # #         #   
# ### # # ##### # # # ##### ### # # # ##### ######### # # ####### # ### # ##### ####### # ### # # # # # # ### # # ####### ### # 
# #   # #   #   # # # #   #   #   # #     #       #   #   #     #   # # # #   #     # #     # # #   # #     #   #   #     #   # 
# ##### ### # # ### # # # ### ##### ##### ####### # # ##### ######### # # ### ##### # ####### # ##### ##### ####### # ### # ### 
#   #         # #   # # #     #     #   # #   #   # # #   #         #   #   #     # #   #     #           #         # # # #   # 
### # ####### # # ### # ####### ##### # # ### # ### # ### ######### ### ### # ##### ### # ####### ### # # ### ####### # # ### ##
# # # #     # # # #   # #             # #   # # #   #     #               # #     # #   #     #   #   # # #   #       #         
# # # # ### ### # ##### # ############# ### # # ### ##### ### ####### ### # ### # # # ### ### # ######### # ### ############### 
#     #   #   # #       #   #   #     #   # #   #   #   # #   #     # #   #   # # #   #   #   #     # #   #   # #     #       # 
# ##### ##### # ######### # # # ##### ### # ##### ##### # # ### ### # # ##### # ####### ### ####### # # ##### # ##### # ##### # 
#   #   #   # # #         #   #   # # # #   #   #       #   #   #     #   #   #   #       #       # #   #     # #     #     #   
# ### ### # # # # # ############# # # # ##### # ############# ### ####### # ##### ####### ####### # ####### # # # ############# 
# #   #   # # # # #     #     #   #         # #               #     #   # #   #           #       # #       # # #     #         
# # ####### # # # ##### # ### # ######### ### ################# ##### # # ### # ########### ####### ### # ### # ### ### ####### 
# #     # #   #   #   # # #   #         #     # #   #     #     #     #   #   # #       #   #       #   # #   #     #   # #     
# ##### # ######### # ### ########### # ####### # # # ### # ##### ######### ### # ##### # ### # ### # ### ########### ### # ### 
#   #   #         # #     #         # # #         # # # # # #   # #       # #   # #     # # # #   # #   #       #   #   # # #   
### # ####### ### # ####### ####### ### ######### ### # # # # # # # ##### # ##### # ##### # # ##### ### ##### # # # ### # # # # 
#   #         #   #     #   #   # #   #         #   # # # #   # #   # #   #       #       #     #   #     #   # # # #   #   # # 
# ############# ####### # ### # # ### ######### ### # # # ##### ##### # ##################### ### ######### ### # ### ##### # # 
# #   #       #       #   # # #     #   # #     # # #   # #           #       #       #     # #   #       # # # #   #     # # # 
# # ### # ### ### ### ##### # ##### ### # # ##### # ### ### ####### # ### # # # ### ### ### ### ### ##### # # # ### ##### ### # 
# #     #   #     #       #   #   #   # #   #       # # #   #     # #   # # # #   # #   # #   #   # #   # # #     #     #   # # 
# ### ##### # # # # ##### ##### # ### # ##### ##### # # # ### ### # ##### # # ### # # ### ### ### # # # # # ### # ##### ### # # 
#     #     # # # # # #   #   # # #   # #     #   #   #   #     #   #     # #   # # # #     # #   # # # # # #   #     #     # # 
# ##### ####### # # # # # # # # ### ### ####### # ### ####### # ##### ##### ### # ### # ##### ##### ### # # # # ### # ####### # 
#   # # # #     # # # # # # # #   #   # #     # # #           #     #     #   #   #   #     #     #     #   # # # # #   #     # 
### # # # # ##### # # # # # # ### ### # # ### ### ######### ####### ##### # ####### ### ### ##### ########### # # # ##### ##### 
#   # #   #   #   # # # #   #     #     #   #     #     #   #     #     # # #       # # # # # #   #     #     #   #   #   #   # 
# ### ####### ##### # # ####### ### ### ### ####### ### ##### ### ####### # # ####### # # # # # ### ### ### ######### # ### # # 
#   #   #   #     # # # # #   #     #     # #     #   #     # # #       # # # #       # #   # #   # #   #   #     #   #     # # 
### ### # ####### # # # # # # ####### # # # ### ### ####### # # ####### # ### # ### ### ##### ### # # ### ### ### # ######### # 
# #     # #     # #   #   # # #     # # # #   #   # #       #   #       #     #   #             # # #   # #   # # #     #   # # 
# ####### # ##### ######### # # ### # # # ### ### # # ######### # ####### ####### ############# # # ### ### ### # ####### # ### 
#       #   #   #   #       #   # #   # #   #   # # #           # #     #           #   #     # # #   #     # # #       # #   # 
# ####### ### # # # # # ######### ##### ### ### # # ############# # # # ### ####### ### # ### # # ### ####### # ####### # ### # 
#     #   #   # # # # # #   #     #     # # # #   # #   #       # # # # #   #     #     # # # # #     #       # #       # # # # 
# ### # ### ### ### # # # # # ##### ##### # # ### # ### # ##### # ### # # ### ### ####### # # # ####### # ##### # ####### # # # 
# # #     #   # #   # # # #   # #   #     #     # #   #   #   # #   # #   #     #     #   # # #     #   # #   #   #       #   # 
# # ######### ### ### ### ##### # ####### ##### # ### ##### # # ### ####### ######### # ### # # # # # ### # # ##### ####### ### 
#       #     #   # #   # #     #       #       #   #   #   # # # #     #   # #   #   # # #   # # # # #   # #   # # # #   #   # 
# ####### ##### ### ### # ##### ####### ####### ### ### ### ### # ##### # ### # # # ### # ##### # # # # ### ### # # # # # ### # 
# #     #       #     # #         #   # #   #       #     #   #   #   # # # # # #   #   #       # # # #     #   #   #   #   # # 
# # ### ######### ### # ######### # ### # # # ##### # ### # # ### # # # # # # # ##### ### ### ### # # ####### ####### ### ### # 
#   #     #       #   #   #       # #   # # # #   #   #   # #   # # # #   # # #       #   #   #   #         # # #     # #   # # 
# ### ### # ##### ####### # ####### # # # ### # # ##### ### # ### ### ##### # ######### ### ### # ########### # # ##### ### # # 
# # #   #   #   #       # #     # # # # #     # #   #   #   #   #           #   #     #   # #   #   #     #   # #   #     #   # 
# # ### ##### # ### ### # ##### # # # # ####### ### # ### ##### ### ####### ### # # # ### # # # ### # ### # ### ### ##### ##### 
#     # #     #   # #   #   #   # #   # #       # # # # # #   #   # #     #   # # # # #   # # # #   # # # # #     #       # #   
##### # # ####### ### # # ### ### ####### ####### # # # # # ##### # # ### ##### ### # ##### ### ### # # # # # ### ####### # # # 
#     #   # #   # #   # #   #         #   # #   # #   #   #     #   # #   #   #     #     #   #   # # # #   #   #     #   #   # 
# ######### # # # # ####### ######### # ### # # # ####### ### ##### # # ### # ########### ### # # # # # ##### # ### ### ####### 
#   #     # # #   #       # #   #   # #   #   # # #           #   # # #     #           #     # # # # # #   # #   # #   #       
### ### # # # ############# # # # # # ### ##### # # ##### ##### # ### ########### # ### ####### # ### # # ### ### ### ### ##### 
#       # # #     #       # # #   # #   # #   #   # # #   #     #   #   #   #     #   #         #   #   # #   # #     #   #   # 
######### # ####### ##### # # ##### ### # ### ### # # # ### ####### # # # # # ####### ##### ##### # ##### # ### ####### ### # # 
#       # #     #   #     #   #   # #   #   #     #   # # # #   # # # # # #   #   #   #     #   # #     #   #       #   #   # # 
# ##### # ##### # ############# # # # ##### # ######### # # ### # # ### # ##### # # # # ##### # ##### # # ### ### # # ### ### # 
#     # #       #     #         # # # #     #         # # #     # #     # # #   #   # # #     #  S    # #   #   # #   # #   # # 
##### # ####### ##### # ######### # # # ######### # # # # ####### ####### # # ####### # # ################# ### # ##### ### # # 
#     #   #     #   # # #   #   # #   # #   #     # # #                     # #       # #       #   #     #   # # #     #   # # 
# ####### ### ### # # # # # ### # ##### # # # ##### # # # ####### ### ####### ######### ####### # # # # ##### # # # ##### ### # 
# #         #   # # # #   #     # #   # # # # #     #   # #     # #   # #     #       #   #   # # #   #       # # # #   # # # # 
# ######### ### # ### ####### ### # # # ### # # ######### # ### # # ### # ##### ##### ### # # # # ############### # # ### # # # 
# #   #   #   # # #   #     #   #   # # #   # #         #   # # # #   # #   #   #     # # # # #   #   # #   #   #   #   #   #   
# # # # # ### # # # ### ### # # ####### # ##### ####### ##### # ##### # ### # ### ##### # # # ##### # # # ### # # ##### ####### 
#   # # # #     # #     #   # # #     #   #   #       # #     #   # #   # #     # #     # # #   #   #   #   # # #     # # #   # 
##### # # ##### # ####### ### # # ### ####### ####### # # # ##### # ##### ##### # ### ### ##### # ######### # # # ### # # # # # 
#   #   #   #   # # #   # #   # #   #   #     #       #   # #     #     # #   # # #   #   #     # # #     #   # #   # #   # #   
# # # ##### # ### # # # # ### ##### ### # ################# # ######### # # # # # # ### ### ##### # # ### ##### # # ##### # ### 
# # # #   # #   #   # # #     #   # # # #     #     #       #   #     #   # # # # # # #     #   #       #       # #   #   #   # 
### ### # ### ### ### ####### # # # # # ##### # ### # ######### # ####### # # ### # # ######### ####### ############# # ##### # 
#   #   #   # #   #   #     # # # #   #   # # # # #   #       # #   #   # # #   # # #   #     # #   # #             #   #     # 
# ### ##### # # ### ### # ### # ##### ### # # # # ### # ##### # ### # # # # ### # # ### # ### # # # # ############# ### # ##### 
# #   #             #   # #   #     # #   # #   #   # # #   # #   # # # # # #   # #   # # # # #   # # #   #   #   #   # #     # 
# # ### ########### # ### # ####### # # ### ####### # # ### # ### # # # # # ##### ### # # # # ##### # # # # # # # ### # ##### # 
# #   # #         #   #           # # # #         #   #   # # #   #   #   #     # #   # # # # #     #   #   #   #     #     # # 
# ### # # ####### # ######### ### # # # # ####### ### ### # # # ### ########### # ### # # # # # ##### ####### ########### ### # 
#   # # #     #   # #   #   #   # # # # # #   #         # # #   #   #     #     #   # #   # #           #   #     #     # #   # 
### # ####### # ##### # # # ### ### # ### # # # # # ##### # ####### # ### # ####### # # ### ############# # # ### # ### ### ### 
# #   #   #   #     # #   # #   #   # #   # #   # #   #   #   #       #   # #       # #     #   #     #   # #   # # # #   #   # 
# ### # ### ####### # ##### ### # ### # ### ##### ### # ##### # ##### ##### # ####### ##### # # # ### # ### ### # # # ### ##### 
# #   #     #     # #     #     # # #G  #   #     # # # #   #   #   #   #   #     # # #     # # # # #   # # #   # # #     #   # 
# # # ####### # ### ##### ##### # # ##### ### ##### # # ### ##### # ### # ####### # # # ##### # # # ##### # ##### ### ##### # # 
# # # #     # # #   #     #   #           #         # #     #     #   # # #   #   # # #   #   # # # #     #     #     #     #   
# # # ##### # # # ######### # # # # ####### # ####### ####### ####### # # # # # ### # ### # ### # # ### ####### # ############# 
#   #       # # # #     #   #   # # #   #   # #   # # #     # #       # #   #   #       # # #   #   #   #       # #       # #   
##### ####### ### # ### ### ##### # # # # ### # # # # ##### # # ####### ######### ##### # # # ####### ### ####### # # # # # # ##
#   #   #   # #   # # #   # #     # # #   #   # #   #   #   # # #       #             #   # # #     #   #   # #   # # # #   # # 
# # # # ### # # ### # ### # # # ### # ### # ### ####### # ##### # ### # # ### ##### # ##### # # ### ### ### # # ### # # ##### # 
# #   #       #     #   # # # # #   # #   #     #     #   # #   # #   #   # #     # #   #   #     #     #   # # #   # #     #   
# ########### ######### # ### ### ### ####### ####### ##### # ### # ### ### ##### ##### # ####### ####### ### # # ### ### # ### 
#           #     #   # # #   #   #   #     #     #   # #     #   # #   #       #     #     #   #   #   # #   #     #   # #     
########### # # ### # # # # # # ####### ### ### # # ### # ##### ### # ### # ######### ####### # ##### # # # ########### # ######
#           # #     #   #   # #         #   #   #               #   #     #         #         #       #   #             #       
