################################################################################################################################
################################################################################################################################
#           #     #           #   #           #                             #                           #   #     #   # #       
# ####### ### # # # ######### # ### ######### ####### ####### ############### # ########### # ######### # # # ### ### # # ##### 
#   #   #     # # # # #       # #   #     # #   #     #     #   #         #   #           # #     #   #   #     #     # #     # 
# # # # ##### # # # # # ####### # ### ### # ### ####### ### ### # ####### # ############# # # ### # # # ####### ####### ####### 
# #   #     # # # #   #   #   # # #   # # #   #       # #     # # #   #   # #           # # #   #   # # #     #       #   #     
# ######### # # # ####### # # # # # ### # ### ####### # ##### # # # # ##### # ##### ##### # ######### # # ### # ##### # ### ####
#     #   # # # # #   # # # # #   # #   #     #     # #   #   # # # # #   # # #   # #     # #     #   # # # # # #   # # #   #   
##### ### # # # ### # # # # ####### # # ####### ### # ### # ### # # # # # # # # # ### ####### ### # ##### # # # # # # # # ##### 
#   #   # # # #     #   # # #   #   # #       #   # #     # #   # # # # #   # # # #   #     #   # # #   #   # #   # #   #     # 
# # ### # # ########### # # # # # ##### ##### ### # ####### # ### # ### ##### # # # ### ### ##### # # # ### # ##### ######### # 
# #   # # #     #     # # #   #   #   #   # # #   #   # #   # #         #   # # #   #   # #       #   #     #     #         #   
# ##### # ##### # ### ### ### ##### # ### # # # ##### # # ### # ##### ### # # # ##### ### ################### ### # ### ####### 
# #     #   #   # # #   #   # #     # #   # # #     #   # #     #   #     #   #     # # #       #   #       #   # #   #     #   
# # ####### # ### # ### ### # # ##### # ### # # ######### ####### # ####### ####### # # # ### ### # # ##### ### # # ####### # ##
# # #   #   # #   #   #     # #   #   # # #   #     #     #       #               # # # #   # #   # # #   # #   # # #     # #   
# # # # # # # # ##### ####### ### # ### # ##### ### # ##### ############### ##### # # # ### # # ### # # ### ##### ### ### # ### 
# #   #   # # #       #   #       #               # # #     #         #   # #     # # #     # # # #   #   # #   # #   #   #     
# ######### ######### # # ########### ########### ### # ##### ######### # # ####### # # ####### # ####### # # # ### ### ### ####
# #         #         # #           #     #       #   # #   #   #     # #   #   #       #       #   #     #   #     #   #       
# # ######### ##################### # ### ######### ### # # ### # ### ### ### # ####### # ####### ### ######### ##### ### # # ##
#   #   #   # #               #     #   #         #   #   #     #   #   # #   #   #   # # #   #       #       #   #   #   # #   
# ##### # # # # ############# # ####### ######### ### # ########### ### # # ##### # # # # # ### ####### ##### ### # ### ### ### 
# #   #   # #   #     #       #       # #     # # # # # #         #   # #   #     # # # # # #     #   # #   # #   # #     # #   
# # # ##### ##### ### # ############# # # ### # # # # ### ####### ### # # ######### # ### # # ### # # # # # # ##### ####### # ##
#   # #   #       #   #   #         # #   #   # # # # #   #     # #   # # #     #   #     #     # # # # # # #       #     # # # 
##### # ### ##### # ##### # ######### ##### ### # # # # ####### # # ### # # ### # ########### # ### # # ### ######### ### # # # 
#     #   # #   # #   #   # #     #   #   # #   #   #   #       #   #   #   #   #   #       # #     # # #   #       #   # # #   
# ####### # # # # ### # ### ### # # ### # # # # ######### ########### ##### ####### # ##### # ####### # # ### # ### ### ### # ##
#       #   # #   # # #   #     #   #   # # # # #       #   # #     # #   #   #     #   #   #       # # # #   #   #   #     #   
####### ##### ##### # ### ######### ### ### ### # # ### ### # # ### # # # ### # ####### # ### ##### ### # ### ##### # ######### 
#     #       #         #   #     #   #           #   # #   # # # # #   #   #         # # #     #   #   #   # #   # #           
### # ### ####### ##### ### # ### ### # ######### ### ### ### # # # ####### ####### ### # ##### # ### ##### ### # # ########### 
#   #     #     # #       # #   # # # #         # #   #   #   # # #       #       #     #   #   #   #     #     #   #   #     # 
# ### ##### ### ### ##### # ### # # # # ####### # ##### ### ### # ##### # ####### # ####### # ##### ##### ########### ### ### # 
# #   #     # #   #     # #   # # #           # #           #   #     # #     #   #     # # #   # #     # #         #     # # # 
# ### # ##### ### ####### ### # # ### ##### ### ####### ##### ####### # ####### ### ### # # ### # ### ### ### ##### ####### # # 
#   # #     #   #     #     # # #   # #   #   # #     # #     #       #         # # #   # # # #   # #   #   #   #         # #   
### ####### ### ##### # ##### ##### # # # ### # # ### # # ##### ### ############# # ##### # # ### # ### ### ##### ####### # ### 
# #   #     #     #   #     #   #     # # #   #   # # # # #       # #   #     #     #   # # # #   #   #   #     # #     #       
# ### # ##### ### # ### ### ### # ##### # # ####### # ### # ##### ### # # ### # ##### # # # # # ##### # # ##### ### ### ####### 
#     #     #   # # # # #   #   # #     # #         #     # #   #     # #   # # #     # # # #       # # #     # #   # # #     # 
############# # # # # # # ### ### # ##### ######### ####### # ######### ##### # # ##### # # # ####### # ####### # ### # # ##### 
#             # # # #   #           #   #         #       # #         #   #           # #   #       #   #   #   #     # # #     
# ############# ### # ##### ########### # ####### ##### # # # ####### # ### ######### # ##### ##### ##### # # ### ##### # # ### 
# #         #   #   # #   # #   #   #   #       #   #   #     #   #   #   # #     # # #   # # #   #       # #   # #     #   # # 
# # # ####### ### ### # # ### # # # # ### ### ##### # ####### # # ####### # # ### # # ### # # # # ######### ### # # ######### # 
# # # #     #   # #     #     # # # # #   #   #   # #       #   # #     #   #   # # #   # # # # #         # # #   # #     # #   
# # # # ### ### # # ########### ### # ##### ### # # ####### ##### # ### # ####### # # # # # # # ########### # ##### # ### # ### 
# # #   # #   #   #     #   #   #   #     # #   #   # #     #     # # # #   # #   #   # # #   # #         #       # # # # #     
# ##### # # ####### ### # # # ### ####### ### ####### # ##### ### # # # ### # # ######### # ### # ####### ######### # # # ##### 
#     # # #           #   # #     #   # #   # #       # #   # #   # # #   #   #   #   #   # #   #   #   #           # #       # 
##### # # ##### ####### ### ####### # # ### # # ####### # # # ### # # ### ### ### # # # ### # ##### # # ############# ####### # 
#       #     #       #   # #       # # # #   #   #     # #   #   # #   #   # #   # #   #     #   #   # #   #   #   #       # # 
# ##### ##### ### ### # ### # ####### # # ####### # ##### ##### # # ### ### ### ### ##### ### # ####### ### ### # # ####### # # 
#     # #   #   # #   # #   #     #   #   #     #   #     #     # #       #     #   #   #   #   #     #     #   # # #     # #   
# ### ### # ### # # ### # ######### ##### # ### ##### ##### ############# ####### ### ### # ##### ### ####### # # # ### ### ### 
# # # #   #   # # #   # # #       #   # # # #     #   # #   #   #   #   # # #       #     #       #   #     # # # #     #   #   
# # # # ##### # ##### # # # ##### ### # # # # ### ### # # # # # # # # # # # # ### # # ################# ### ### # ####### ### # 
#   #   #     #       # # # #   # #   # #   #   #     #   # # #   # # #   #   #   # #       #           # #   # # #   #   #   # 
### ##### ############# # # ### # # ### ### ### ######### # ####### # ########### # ####### # ########### ### # # ### # ### ### 
# #   # #         # #   #   #   #   #         # #   # #   #         #   # #       #       #   #         #     # # #   # #     # 
# ### # ######### # # # ##### # ####### ### # # ### # # ############### # # ### # ####### ##### ####### # ##### # # ### # ### ##
#     #   # #   # # # #     # #   #   # #   # # #   #   #       #   #   #   #   # #     #     #       # #   #   #   #   #   #   
# ##### # # # ### # # ### # ##### # # ### ### # # ### ### ##### # # # ####### ### ##### ##### # ##### ##### # # ### # ##### ### 
#       # # #     #   #   #       # #   # # # #   #   #   #   #   # # #       #         #     # #   # #       # #   #   #     # 
######### # ########### ### ####### ### # # # ######### ##### ##### # ### ############### ####### # # # ####### # ##### # ##### 
#       #   # #       #   # #     # # # # #   #     #   #         # #   # #   #           #       #     #   #   #     # # #     
# ##### ### # # ##### ### # # ### # # # # ##### ### # ########### # ### # ### # ########### ####### ### # # # ### ##### ### ### 
#   #   #   # #   # #   # # #   # #   # # #   # # #   #         # #   # #   # #   #         #   #   #   # # #     #   # #   #   
### ####### # ### # ### # # ### # ##### # # # # # ##### # ##### # ### # # # # ### ##### # ### # # ### # # # ####### # # # ### # 
# #   #   #     #     # # #     #     # # # # # #       #   #   #   # # # #     # #   # #   # # # #   # # # #   #   # # #   # # 
# ### ### ### # ### ### # ######### ### # # # # ########### ### ### # # # ####### # # ####### # # # ### # # # # # ### # ### # # 
#   #   # #   # #   #   # #     #   #   # # #   #         #   # #   #   # # #     # #         # # # #   # #   #   #   # #   # # 
### ### # # ### # ### ##### ### ### # ##### ##### ####### ### # # # ##### # # ################# # # # ### ######### ### ##### # 
#     # #   #   # # #   #   # #   # #   #   #     #   #       #   #     #   #             # #   # # #   # #   #   #   # #   # # 
##### # ##### ### # ##### ### ### ##### # ########### ### ############# # ######### ##### # # ##### ### # # # # ##### # # # ### 
#   # #     #   # #     #   #   #       #       #   #     #       #   # #   # #   #   #   # # #     #   #   # #         # #   # 
# # # ##### ### # ### # ### ### ############### # # ##### # ##### # ### # # # # # ##### ### # # # ### # ##### # # ########### # 
# #       # #   #   # #     #   #     #       #   #     # # # #   #   #   #   # #       #   #   # #   # #   # # #   #         # 
# ####### # ### ### # ##### # # # ### # ##### ######### ### # # ##### ##### ### ########### ### ### ### # ### ##### # ######### 
# #       #   #       #   #   # # # #   #         #   #   # # # # #           # #       #   #   #   # # # #   #     # #         
# # ######### ######### # ##### # # ##### ######### # ### # # # # # ### ### # # ####### # # # # # ### # # # ### ##### # ### # ##
# #  S# #     #   #     #   # #       # #     #     # #   # # # # # #   #   # #     # #   # # # # # #     #   #     # # #   #   
# ### # # ##### # # ####### # # ##### # ##### # ##### # ### # # # # # ### ######### # ##### ### # # # ### ### ##### # # ####### 
# # #   #       # # #     # #   #   # #       # #   #     # # # #   #   #         # #     #   # # # # #     #   #   # # #     # 
# # # ########### # # ##### ##### # # ######### # # ####### # # ################# # # ### ### # # # # # ### ### ##### # # ### # 
# #   #     #   # # # #   # #     # #     #     # # #   #   #   #                 # #   # # #   # #   #   #   #       # # # # # 
# # ### # ### # # # # # # # # ##### # ##### ##### ### # # ### ### ############### # ### # # ### # ####### ### ########### # # # 
# # #   # #   # #   # # # # #     # # #               # #   # #     # #       #   #   # #     # # #     #   #       #   # # #   
### # ### # ### ##### # # # ####### # # ######### ########### ##### # # ##### # # ### ####### # # # ### ### ### # # # # # # ### 
#   #   # # #   #     # # #       #   #   #     # #   #   #   #     # #     # # #   #   #   #   # # #   #   #   # #   # # #     
# ##### # # ##### ##### ######### # ##### # ### ### # # # # ### ##### ##### ### ### ### # # ##### # # ### ### ### ##### # # # ##
#     # #   #         #           #   #   #   #   # #   #   #   #         #     #     # # #     # # #   # #     #   # #   # # # 
# ##### ##### ####### # ##### ##### # # ##### ### # ######### ### ##### # ####### ##### # ##### # # ### # ##### ### # ##### # # 
#   #   #     #     #   #   #   # # #   #   #   # #     #       #   # # #             #   #   # # # #     #       # #       #   
### # ### ### # ### ##### # ### # # ##### ##### # ##### # ##### ### # # ####### # ### ####### # # # ####### ### ### # # ########
#   #     #   #   #   #   #   # # #     #     # #       # #   #   #   # #     # #   #         # # #   #     #   #   # #     #   
# ########### ####### # ##### # # ##### ##### # ######### # # ### # ### # ### # ### ########### # ### ### ##### # ####### # # # 
#   # #   #   # #     # # #   # #   #         #   #   #   # #     # #   #   #     #         #   #   # #   #     #   #   # #   # 
# # # # ### # # # ##### # # ### ### # ########### # # # ### ######### ############### ####### ### ### # ### ####### # # ########
# #   #   # #   #     #   #   #   #             #   # #   # #       # # #             #       #   #   #   #       # # # #       
# ####### # # ####### ####### ### ##### ##### ####### # # # # ##### # # # ####### ##### ######### # ##### ####### # # # # ##### 
#       #   #   #   #     # # #   #   #   #   #   #   # # # #   #   #   # #       #   #         # # #     #       #   #     #   
####### ##### # ### ##### # # # ### # # # ### # # # ### # # ### # ####### ### ##### # ####### # # # # ########### ######### # ##
#           # # #   #     #   #     # # #   # # #   #   # #   # # #     # #   # #   #       # # # # # #     #         #   # # # 
# ######### # # # ### ##### ######### # ### ### ##### ### # ### # # ### # # # # # ######### # # # # # # ### ########### # # # # 
# #         # #   # #     #     #         #     #     #   #   # #   #   # # # # # #       # # # # # # #   #       #     # # # # 
# # ######### # ### ##### ##### # ################### # # ### # ##### ### # ### # # ####### ### # # ##### ####### # ##### ### # 
# #       #   #     #   # #               #   #   #   # #   # # #   # #   #     # # #       #   # #     # #   # # #   # #    G# 
# ####### # ### # ### # # ####### ####### # # # # # ### ### # # # ### ### ####### # # ####### ### ### # # # # # # ### # ####### 
# #   # #   #   #     # #   #   #       # # #   # # #   #   # # #   #   #     #   #           #   #   # #   #   #   #   #     # 
# # # # ##### ######### ### # # # ##### # # ##### ### ### # # # # # ### ##### # ############### ### ### ########### ##### ##### 
#   # #   #           # # #   #   #   # # # #     #   #   # #   # #   #   #   # #     #   #     #   #         #   # #     #     
# ### # # ### ####### # # ######### # # # ### ##### ### ######### ####### ### # # ### # # # # # # ### # ##### # ### # ##### ####
#   # # #     #     # #   # #     # # # #   # #   #   #             #   #   # # #   # # # # # # # #   # #     #   # #   #   #   
##### # ####### ##### # ### # ### # # # # # # # ##### ####### ### # # ##### ### ##### # ### ### # ### ### ####### # # # # ##### 
#   # # #       # #   #         #   # # # #   # #     #     #   # #   #     #   #   # #   #   # #   # #   #   #   # # #   #     
# # # # # ####### # ############# ##### ####### # ### # ### ### # ##### ##### # # # # ### # # # ### # # ### # # ### # ##### ####
# # # #   #   #   # #       #   #   #   #     # #   # #   # # # #   #   # #   # # # #   # # # # # # # #   # # # #   #     #     
# ### # ### ### ### # ##### # # # # # ### ### # ### ##### # # # ### # ### # ##### # ### # ### # # # ##### # # # # ####### # ### 
#   # #     #   # #   #   #   # # # #   #   # # #   #     # #   # # # #   #     # #   # #     #   #     #   #   # # #   # # #   
### # # ### # ### ##### # ##### # ##### ##### # # ### ##### ##### # # # ####### # # ### # ############# # ##### # # # # # # ####
#   # #   #   #   #   # #   #   # #   #   #   # #     #   #   #   # # #   #     # # #   # #             # #   # # # # #   #   # 
# ### # # ####### ### # ### # ### # # # ### ### ####### # ### # ### # ### # ##### # # ### # ############### # ### # # ####### # 
#     # #             #   #   #     # #     #           #     #     #     #       #   #   #                 #                   
################################################################################################################################
