################################################################################################################################
################################################################################################################################
# #                             #   #   #     #   # #         #       #     #   #             #   #                 #           
# # # ### ##### ### ########### # ### ### ### # # # # ##### ### ##### # ##### # # ########### # # # ### ##### # ### # # ####### 
# # # # #     # # # #       #   #           # # # # # #   # #   #   #   #   # #   #         #   # # #   #     # #   # # #       
# # # # ##### # # # # ##### # ############# ### # # # # # ### ### # ##### # # ##### ##### # ##### # # ######### # ### # # ##### 
#   #   #   # # #   # #     #           #   #   # #   # #   #   # #     # # # #     #     # # #   # #     #   # #     # #     # 
####### # # # # ##### # ### ########### # ### ### ### # ### ### # ##### # ### ####### ##### # # ### ##### # # ############### # 
#     #   # # #   #   #   # #   # #   #   #   # # #   #   # #   # # #   #   #       # # #   #   #     #   # # #   #       #   # 
# ### ####### ### # ##### ### # # # # ### # ### # # # ### ### ### # # ##### ####### # # # ############# ### # # # # ##### # ### 
# # #   #   #   # # #   #     # #   # #   #     # # #   #         # #   #   #     #   # # #             # # #   #   #   #   #   
# # ### # # ### # # # # ####### ### ### ######### # ### ### ####### ### # ##### # ##### # ##### # ####### # ######### # ##### ##
# #   #   #     #     #   #   # #   #     #       #   #     #           #     # #   #   #   #   # #     # #       #   #   # # # 
# # # ### ############### # # # # # # ##### ######### ##### # ##### ######### # ### # # ### ##### # ### # ######### ##### # # # 
# # #     #     #       #   # # # #   #     #         #     #   #   #       # #   #   #   #     # #   # #   #       #     #   # 
# ##### ### ### # ##### ####### ##### # ##### ##### ### ####### # ### # ### # ####### # ####### # ### # ### # ####### ####### # 
#     # #   #   # #     #       #     #   #   #     #   #       # #   #   # #       # #       # # #   #     #   #   #       #   
##### # # ####### ### ### ##### # ### ### # # ####### ### # ##### # ##### ######### # ### ##### # # ########### ### ####### ### 
#   # # # #   #     #   #   #   #   #   #   # #       #   # #   #   # #   #     #   # # #     # #   #   #   # # #   #       #   
# # # # # # # ##### ### ### ####### ### ##### # ####### ##### # ### # # ### # ### ### # ##### # # ### # ### # # # # # ####### ##
# # # # # # #       # #     #   #   # # #     #     #   #     #   #   #     #             #   # #     #     # # # #     #   #   
# # # ### # ######### ####### # # ### # ### # ####### # # ####### ### ##################### ### # ### # ##### # ####### ### ### 
# #   #   # #         #     # #   #   #   # #   #   # # #     #   #       #   #   #         #   # # # #       #     # #   #     
# ##### ### # ####### # ### # ##### ##### ### # # # # # ##### ### # ##### # # # # # ######### ### # # ####### ##### # ### # ####
#     #   # #   # #   #   #   #   #     #     # # # # # #   #   #   #   # # #   # # #   #   # #     # #     # #     # #   #     
##### ### # ### # # ##### ##### # ##### ####### # ### # # ##### ### # # ### ##### # # # # ### ####### # ### # # ##### # ### ### 
#       #   # # #   #     #   # # #   # #   #   #   # #   #   #   # # #   # #     #   #   #   #     # # #   # # # #         #   
# ### # ##### # ##### ####### # # # ### ### # # ### # # ### # ##### # ### # # ############# ### ### # # # ### # # # ####### ####
#   # #         #   #   # #   # # # #   #   # # #   # # #   #     # #   #   #         #     #     # # # #   # # #     #   # #   
### ##### ### ### # ### # # # # ### # ### ### # # ### # # ####### # ### ############# # ######### # ### ### # # ### ### # ### # 
#   #   #   #   # #     #   #       # #       # #     # #     #   #   #   #   #   # # # #       # #   # # # # # #   #   # #   # 
# ### # ### # ### # ######### ##### # # ####### ####### ##### # ### # ### # # # # # # # # ##### # ### # # # ### # # # ### # ####
#   # # #   # #   # #       # #     # # #     #   #   # #   # #   # #   #   # # #   #   # #   # # #     #       # # # # # # #   
### ### # ##### ### # ##### # # ### # ### ### # ### # # # # # ### ##### ##### # ### ##### ### # # ##### ######### # # # # # # # 
#   #   #   #   #   #     # # #   #       # #   #   # # # # # # #     #     #   # #       #   # #     # #       # # # # #   # # 
# # # ##### # ############# # ############# ### # ### # # # # # ##### # # # ##### ######### # # # ### ### ##### # # # # ##### # 
# # #   # # #         #     # #         #       # # # #   # # #   #   # # #         #       # # #   #   # #   # # #         # # 
# ##### # # ######### # ##### # ####### ######### # # ####### ### # ##### ##### ### ### # ### # ####### # ### # # ######### # # 
# #     #   #     #   #   # # # #     #         #   #         #   #   #   #   # # #   # #   # #       # # #       #     #     # 
# # ####### # ### # ##### # # # # ### ######### ############### ##### # ### # # # ### # ##### ####### # # # ### ### ### ####### 
# # # #   # # #   # #   # #   # # # # #   #   # #   #                   #   #   #   # # #   #           # #   # #   # #   # #   
# # # # # # # ##### # # # ##### # # # # # ### # # # ############### ##### ######### # # # # # ### ####### ##### # ### ### # # ##
#   #   #   #       # # # #     #   #   #   # # # #   #   #     #   #     #         # # # # #   #   #   #     # # # #   # # #   
# ############### ### # # # ##### ######### # # # ### # # # ### # ### ######### # # # ### # ####### # # ##### # # # ### # # ### 
# # #     #   #   #   #   #   # #         # # #   # # # #   #   # #   #         # #       #         # #   #   # # #   #   #     
# # # ### # # ##### ######### # # ####### # # ##### # ####### ### # ##### ##### # ### ############# # ### # ##### ### ######### 
#   # # #   #       #       # # #   # #   #   # #   #   #     #   # #   # #   # #   # #     #       #   # # #   # # #     #     
##### # ############# ### ### # ### # # ### ### # ##### # ######### # # # # # ##### # # ### ### ####### # # # # # # ##### # ### 
#     #         #     #   #   #   # # # #       #     # #         # # # #   # #   # # # #     # #   #   # # # #   # #     # #   
# ########### # ### ### # # ### ### # # # # ##### ##### ######### ### # ####### # ### # ##### ### # ##### # # ##### # ####### # 
#   #         #   #   # # # #   #     # # #       #   #         #   # #         #   # #     #     # #   #   #   #             # 
### # # ######### ##### # # # ### ##### # # ####### # ##### ####### # ############# # ##### ####### # # ### ### ############### 
#   # # #   #     #     #         #     # #     #   #       #     #   #   #         #     #   #       #   #   #       #       # 
# ##### # ### ##### ### # # ####### ##### # ### # ######### # # # ##### ### ################# # ######### ########### # ##### # 
# #     #   #   #   #   # #   #   # # #   # # # #       # # # # #       #   #     #       #   # #   #   #       #     #   #   # 
# # ##### # ### # ####### # # # ### # # ### # # ####### # # # # ####### # ####### # ##### # ##### # # ######### ### ####### ### 
# #   #   # #   #   #     # # #     # # #     #     #   #   # #     #   #     #   # #   # #       # #   #     #   #       #   # 
# ### # ### # ####### ##### # ####### # ####### # # # ####### ##### # ####### # ### # # ####### ### ### # # # ### ####### ### # 
#     # #   #     #   #     # #       #   #     # # #         #   # # #   #   #   # # #   #   # #   #   # # #   #   # #   #   # 
####### ######### # ######### ### ####### # ##### # ########### ### # # # # ##### # # ### # # ### ### # # # ####### # # ### ### 
#   # # #       # # #         #   #       #     # # #           #   # # #   #   # # # #     #     #   # # # #     # # #       # 
### # # # ##### # # ########### ### ########### # # # # # ####### ##### ##### ### # # ################# # # # ##### # # ##### # 
#   #   #     # # #       #       #     # #   # # #   # # # #   # #     #     #   #   #     # #       #   # # #     #   #   #   
# ##### ##### # # ####### # ########### # # # # # ##### # # # # # # ##### ##### ##### # ### # # ##### # ##### # ##### ### # ####
# #     #   # # #         #   #         #   #   #   # # # # # #   #     # #           # # # # # # #     #     #   # # #   # #   
# # # # # # # # ########### # # ################# # # # # # # ######### # # ### # ##### # # # # # # ##### ####### # # # ### # # 
# # # #   # # #             # #   #       #       #   # #   # #   #     # # #   #   #   #   # #   #   #         #     # #   # # 
# ### # ##### ### ######### # ### # ####### ##### # ### # ### # # # ##### ### # ### # ####### ####### # ######### ##### ##### # 
#     # #   #   # #     #   #   # # #       #     #   #G#   #   #   #   #     # # # # # #       #   # # #   #     #     #   # # 
####### # # ### # # ### ######### # ##### ### ####### # ############### ####### # # # # # # ### # # # # # # # ##### ##### # # # 
#     # # #     # # # #         # # #     #   #       #         #     #       #   # # #   #   #   #   # # # # #   #       # # # 
# ### # # ####### # # ######### # # # ### # ### ##### ##### # ### ### # ### # # ### # ############### # # # # # # ######### # # 
# # # # # #   # # #   #         # #   # # # #   #         # #     #   # #   #     # #         #     #   # #   # #     #     # # 
# # # # # ### # # ##### ######### ##### # # # ### ######### # ##### ### # ####### # ######### # ### # ### ##### ##### # ##### # 
# #   # #   #   #   #   #         #   #   # #   #   #       # # #   #   #     #   #   #     #   #   # #   #     #   #   #   # # 
# # ### ### # ##### # ##### # ####### ### # ### ### # ####### # # ########### # ### # # ### ##### ### # ### ####### ##### # # # 
# #       # # #     #     # # #           # # #   # # #   #     # # #         #   # # # #   #   #   #     # #     #     # # # # 
# ####### # # # ######### # # ####### ##### # ### ### # ### # ### # # ######### ### # # # # # # ### # ##### # ### # ### # # # ##
#   #   # #   # #   #   # # # #     # #     #     #   #   # # #   #   #         #   #   # # # # #   #     # # # #   #   # # #   
# ### # # ### # ### # ### ### # ### # # ########### ##### # # # ########### # ### ####### ### # # ##### # # # # ##### ### ##### 
# #   #   #   #   # #   #     # #   # # # #   #     #   #   # # # #   #   # #   #   #   #     # #     # #   # #     #   # #     
# # ##### # ##### # ### ####### # ##### # # # # ####### ##### # # # # # # ######### # # ####### ##### # ##### # ####### # # ####
# # #   # # #   #   #       #   # #   #   # #   #       #     # #   # # #     #   # # #   #     #     # #     #           #     
### # # # # ### ##### # ##### ### # # ##### ##### ##### # # ### ##### # ##### # # # # ### ####### ##### # ##### ######### ##### 
#   # #   # #       # # #     # #   #   #   #     #   #   #   #     #   #   # # #   #   #         #   #   #     #     #         
# ### ##### # ##### ### # ##### ####### # ####### # ##### ### ##### ##### ### # ####### ############# ##### ##### ### # ####### 
# #   #     #     #     #   #   #         #   #   #         #     #     #       #       #       #               #   #   #     # 
# # # # ############### ### # ### ########### # ######### # # ### ##### ######### ######### ### # ### # # ##### ######### ### # 
# # # #   #       #   # # # #   #     #     # # #       # # #   #     #           #   #     # #   #   # #     #   #     # #   # 
### # ### # ##### # # # # # ### # ### # ### # # # ##### # # ### ##### ############# # ####### # ##### # ### ##### # ### # ##### 
#   #     #   # # # # # # #   # # #   # # # #   # #   #   # # #     #               #       #   #   # # #   #   # # # # #     # 
# # ##### ### # # ### # # ### # ### ### # # ##### # # ##### # ##### # ######### # ######### ##### # ### # ### # ### # # ##### # 
# # #   #     #     #   # #   #     #   # #   #   # #     #   #   # # #   #     #     #   #     # # #   #   # # #   # # #   #   
# ### # ########### # ### # ####### # ### ### # ### ##### # ##### # ### # ####### ### # ##### # # ### # ##### # # ### # # # ### 
#   # #     #   # # #   # #   #     #   #     #   # #     #       #     #   #       # # #   # # #     #   #   #   #   # # #     
### # ##### # # # # ### # ### ########### ##### ### # ####### # ########### ##### ### # # # ### ####### # # ####### ### # ######
#   #     #   # #           # #           #     #   #       # # #     #     #   # #   #   #     #   #   # #   #   #       #     
# ####### ##### # ##### ##### # ########### ##### ######### # ### ### # ##### # # # ############# # ### # ### ### # ####### ### 
# #     # #   # # #   # #   # #     #     #     # #     # # # #   # #   #     #   # #   #   #     #     #   # #   # #     #   # 
### ### # ### # # # # ### # # ##### # ######### # # ### # # # # ### ##### # ##### # ### # # ############### # # ### # ### ### # 
#   # # #   # # # # # #   # #       # #     #   #   #   # # # #   #       #   #   #   #   #       #         #   #   # # #   # # 
# ### # ### # # # # # # ### ######### # ### # # ##### ### # ##### # ######### # ##### ########### ############### ### # ##### # 
#     #   # #     # # #   # #     # #   #   # #     #   #   #   # # #         # #   #           #   #           # # #         # 
######### ### ##### ### ### # ### # ##### ### ### # ### ### # # # ### # ####### ### ######### # ### # ######### # # ########### 
#   #     #   #     #   #   #   # #   #   #     # # # #   #   #   #   # #   #     # #   #   # # #   # #       #           #     
# ### ##### # # ##### ### ##### # ### # ### ### # # # ### ######### ### # # ##### # # # # # # # # ### # ##### # ##### ##### ####
#     #   # # #     #   #     # # # # #   # #   # #     # #       # # # # #     #   # # # # # # # #   #     # #     #     #   # 
# ##### # ### ##### ### ####### # # # ### # # ### ##### # # ##### # # # # ##### ### # # # # # # # # ####### # # ### ##### ### # 
# #     #     #   # # # #       # #   #   # # # #   # # #   #   # # # # #     #   # # # # # # # # # #     # # #   #     #   #   
# # ##### ##### # # # # ##### ### ### # ##### # # # # # ##### ### # # # ##### ### # # # # # # # # # # ##### # ### ##### ####### 
#   #   # #     #   # #       # #   # #       #   # #   #     #   # #   #       # #   # # # # # #   #       #   #     # #       
# ### # ### ######### ######### ### # ############# ### # ##### ### ##### ####### # ##### # ### ############### ##### ### ######
# #   #   #     #         #   #   # # #   #   #     #   # # #   #   #   #     #   # #     #     #             #     #   #   #   
# # ##### ##### # ####### # # ### # # # # # # # ##### # # # # ### # # # ##### # ##### ####### ### ### ##### # ##### ### ### ### 
#       # #     #   #   # # #     # #   # # #   #   # # # # # #   #   #     # #     #   #     #   # #   #   #   #   #     #   # 
####### ### ####### # # # # ##### # ##### # ##### # # # # # # ########### # # ##### ### # ##### ### ### ######### ### ### ### # 
#   #             # # #   # #     # #     # #   # #   #   # #           # # # #   # # # #   #   #   # #     #     #     #     # 
# # ############# # # ####### ##### # ### # # # # ### ##### ########### # # # # # # # # ##### ### ### ##### # ########### ##### 
# #       #         #       # #     # # # # # # #S#       # # #     #   # # # # # # # #       #   #     #   # #         # #     
# ####### ######### ####### # # ##### # # # ### # ######### # # ### # ### # # # # # # ######### ### ### # ### # ####### # # # # 
# #   # # #     #   #     #   #       #   #     #     #         #   # #   # # # #   # #         #     # # #   #   #     # # # # 
# ### # # # ### ### # ### ### ##### ##### ####### ### # ######### ### # ### # ####### # ##### ### ### ### # ##### # ##### # # ##
#   # #     # #   # #   # #       # #   #         #   # # #   #   #   # #   #   #   # # #   #       #   #   #   # #   #     #   
### # ####### ### ### # # # ### # # # # ### ### # # ### # # # ##### ### ####### ### # # # # ######### # ##### # # ### # ####### 
#   #     #   # #   # # # # #   #   # #   #   # # #   #   # # #     #       #   #   # #   # #       # # #     # # #   #     # # 
# ####### # ### ### ### # ### ##### # ### ##### # ### ### # ### ####### ### # ### ### # ##### ##### # # ####### ### ### ### # # 
#         #             #     #     #   #       #   #     #     #         #                   #     # #                 #   #   
################################################################################################################################
