################################################################################################################################
################################################################################################################################
                 #       #       #   #   #         #                   #   #                                                   #
 ##### ##### ### # ##### # ##### # # ### # ####### # ########### # ### ### # ######### # ####### ##### ### ####### ####### #####
 #     #     #   # #     #   # #   #     #   #     # #     #   # #   # #   #   #     # # #     #     #   #       #       #     #
 # ##### ##### ### ##### ### # ############### ##### # ### # # # # # # # ### ### ### # ### ### ##### ### ####### ### ### ##### #
 # #   #     #     #       # #   #             # #   # #     # # # # #         # # # # #   #   #   #   #     #   #   #   # #   #
 # # ####### ####### ##### # ### # ####### # ### # ##### ####### # # ##### # # # # # # # ### ### # ### ##### # ### ### # # # ###
 #   #     #   #   #     # # #   #   #   # #   #   #     #   #   # #   #   # #     # # #   # # # #   # #     # #   #   # # #   #
 ##### ### ##### # ####### # ### ### # # # # # # ### ##### # # ### ### ##### ##### # # ### # # # ### # # ### # ##### # ### #####
 #     #         #       # #   #G#   # # # # #     # #     # # #     #     # #   # # #     # # # # #   # # # #     # #     #S  #
 # ### ################# # ### # # ### # # ####### # # ##### # ########### # # # # # ####### # # # ##### # # ##### ######### # #
 #   # #     #           #   # #     # # #       #   #   # # #     #     # # # # # # #       #   #       #       #         # # #
 ### ### ### ##### ######### # ### ### # ####### # ##### # # ##### # ##### ### # # # ############# ########### # ######### ### #
 # #     # #     #                 #   # #   #   # #     #         #     #     # # #   #     #           #     #     #   #     #
 # ####### ##### ########### ####### ### # ### ##### ################### # ##### ##### # ### # ### ##### # ####### # # # #######
   #   #   #     #   #     #   #     #   #   #     #           #     # # # #     #     #   #   #       # #       # # # # #     #
#### # # ### # ### # # ### ### # ##### ##### ##### ##### ##### ##### # # ### ##### ####### ####### ##### # ##### # # ### # #####
   # # # #   # #   #   #       # #   # #   #     #     # #     #     # #     #     #   # # #     # #   # #   #   # #     #     #
 # # # # # ##### ####### ####### # ### # # ### ##### # ### ### # ##### ######### ### # # # ##### # # # # ##### ### ########### #
 # # # #   #   #   # #     #   # #   # # #     #   # #   # #   #   # #   #       #   #   #       # # #   #     #   #     #     #
 # # # ##### # ### # # ##### # # # # # ####### # # ##### # # ##### # ### ##### ##### ### ######### # ##### ##### # ##### # #####
 #   #       #   # #   #     #   # # #   #     # #       # # #     # #   #   # #   #   #   #       #   #   #   # # #     #     #
 ############### # ### # ######### ##### # ##### ######### ### ##### # ### # # # # ##### # ### # # ### ##### # # # # ##### #####
 #       #       #   # #   #       #   # # #     #   #   #     #     # #   # #   # #   # #   # # #   # #   # # # #   #     #   #
 # ### ### ######### # ### # # ### # # # # # ##### # ### ########### # # ### # ### # # # ### # # ##### # # # # # ##### # ### # #
 #   #     #     #   # # # # # # # # #   # #       #     # #         #   #   #   #   # # #   # #   #   # #   # #   #   #     # #
 ### ####### ### # ### # # ### # # ####### ############### # ### ### ##### ### # ##### # # ### ### # # # ##### # ### # #########
 #   #         #   # # # #     # #   #                   # #   # # # #   #   # #     # # #   # #   # # # #   # #     #     #   #
 # ### ####### ##### # # ####### ### # ### ####### ### ### # # # # # # ##### # ####### # ##### ##### # # # # # ##### ##### # # #
 # #     #   #     #   # #     #     #   #   #   # #   #   # # # # # #   #   #     #   #       #     # # # # #     #     # # # #
 # ####### # # ##### ### # ##### ##### # ### # # # # ### ##### # # # ### # ####### # ######### # ####### # ####### ##### # # # #
 #         # # #   #   # # #   # #   # # #   # # # #   #       # # # #   #       # #   #       #           #     # # #   #   # #
 ########### # # # ### # # # # # # # # # # ### # # ### ####### # # # # # ####### # ### # # # ############### ### # # # # ##### #
 #     #     # # #         # # # # #   # #     # #   #         #   #   # #     # #   # # # #   #   #   #   # #   # # # #   #   #
 # ##### ####### # ######### # # ####### ############### ############### # ##### ##### ### ### ### ### # # # # ### # # ##### # #
   #     #     # #   #       # # #     #     #         # #         #           #       #     # #   #   # # # #     #   #     # #
#### ##### # # ### # # ####### # # ### ##### # ####### # # ####### # # ####### ######### ##### # ### ### # # ########### ##### #
   #   #   # #   # # #   #   #   #   #     # #   #   #   #   # #   # # #     #           # #   #     #   #   #   #     #   #   #
## ### ##### ### # ##### # # ##### # ##### # ### # ######### # # ### # # ### # ####### ### # ####### # ######### # ### ### # ###
   #   #     # # #   # #   #   #   # #     # #   #       # # # # #   # #   # #       #     #     #   #     #     #   # #   #   #
 ### ### ##### # ### # ####### ### # # ##### # ######### # # # # # ### ### # ############# ### ### ####### # ### ### ### ##### #
   # #       #   # # #       #   # # #       # #   #   # # # #   # #   #   #         #   # # #     #       # # # # #   # #     #
## # ### ### # ### # # ######### # # ######### # # # # # # # ### # # ### ########### # # # # ####### ####### # # # ### # # ### #
       # #   # #     # #   #     # #         #   #   #   # #   # # # #   #   #     # # # #   #     #       # # #     #   # #   #
###### # # ### ### ### # # # ##### ####### # ############# ### # # # # ### # ### # # # # ##### ### ####### # # ##### ##### ### #
   # # # # #     # #     # #   #   #     # #               # # # # # # #   #     # #   #       # #       # #   #   #     # #   #
 # # # ### ##### # # ##### ### # ### ### ##### # ########### # # # ### # ######### ####### ##### ####### # ##### # ##### # # ###
 # #     #   #           #   # # # # # #       #             # #   #   #       #   #       #   #   #   # # #     #     #   # # #
 # ##### ### # ########### ### # # # # ######### ##### # ### # ### # ### ####### # ##### # # # ### ### # # ######### # ##### # #
 #     # #   # #     #   # #   #   # #           #   # #   # # #   #   # # #   # #     # # # #   # #   # # #       # #         #
 ##### # ##### # ### # # ### ####### # # ######### # # # # ### ####### # # # # ####### # # # # ### # # # # # ##### # ####### ###
 #   # # #   # # #   # # #   #       # #   #   #   #   # #   #     #   #   # # #   #     # # #   # # # # # # #     #   #   # # #
 ### # # # # # # # ### ### ### ############# # # ########### ##### # ####### # # # ######### ### # ### # ### # ####### # ### # #
     # #   # # # #     #   # #     #   #     #   #   #     # #   # #         #   #   #       # # #   # #   # #   #   # # #   # #
###### ##### # # ####### ### ##### ### # ######### # # ### # # ### ################# # ####### # ### # ### # ### ### # # # ### #
     # #             #   #     #   #   # #         # #   # # #     #       #       # #   #   # # #   #       # #     #   #     #
 ### # ##### ######### ####### # ### ### # ##### # # ### # # ######### ### # ### # # ### # # # # # ####### ### #################
 #   #     #         #       # #     #   # #     # # #   # #     #   # # # # #   # #     # #   #   # #   #       #       #     #
## ####### # ####### ####### # ####### ##### ##### # # ### # ### ### # # # # ############# ######### # # # ### ### ##### # ### #
   #       #   #   #     #   #     #   #     #   # #   # # #   #     #   #   #       #   # #     #   # # #   #     # #   # #   #
 ### ######### # # # ### # ### ### ### # ##### # # # ### # # # ### ### ####### ##### # # # ### # # # # ##### ### ### # ##### ###
     #         # #   #   # #   #       #   #   # # # #   # # #   #     #       #     # # #   # #   # #     #   # #   #     #   #
 ##### ### ############### # # ########### # ### # # # ### # ### # ### # ####### ####### ### # ##### ##### ### # # ####### ### #
 #       #     #           # #     #       # #   # # #   # #   # #   #   #     #         # #   #   #     #     #   #   # #   # #
 # ##### # ##### ########### ##### ##### # # # ### ##### # ##### # # ##### ### # ######### ##### ####### ####### ##### # ### # #
     #   # #   #       #   # #   # #   # # # #     #     #       # # #     #   #           #           #       #       #   # # #
 ### ##### # # ####### # # # # # # # # # ### ##### # ############# # # ##### ######### ##### ######### ####### # # # ### ### # #
   # #   # # #       # # # # # #   # # # #   #   # # #             #       #   #   #   #     # #     #       # # # #   #   #   #
 # ### # # ### ####### # # # # ####### ### ### # # # # ########### ######### # # # # ### ##### # ######### # # # # # # # # #####
 #     # #     #   #   # #   #       # #   #   #   # #   #         #       # #   # # #   #     # #       # # #   # # #   #     #
 ####### ####### # # ### ##### ##### # # ######### # ### # ######### ##### ##### # # # ##### ### # ##### # # ##### # ### ##### #
 #   # #       # #   #   #   # #   #   #   #   #   # # # #   #   #   #   #     # # # #     #   # #     #   #     # #   # #   # #
 ### # ####### # ######### # # # # ####### # # ##### # # ### ### # ### ####### ### # ##### # # # ##### ####### ### ### # # ### #
   #     #   # #           # #   #   #   #   #       #     # #   #   #   #     #   #         #   #   #   # #   #   # # # #     #
## ##### ### # ############# ##### ### # ############### ### # ##### ### # ##### ### ########### # # ### # # # # ### # # #######
   #         #         #   # #   # #   #   # #       #     #   #     #     #     #     #       #   # #   #   # # #     #     # #
 ########### ##### ##### # # # # ### ##### # # ####### ### ##### ######### ######### ### ##### ####### ####### # ######### # # #
 #               #   #   #   # #     #   # #           #   #   #         #     #   #   #   # #         #       # #   #     # # #
 # ######### ####### # ####### ####### # # ######### ### # # # ######### ##### # # # # ### # ##### ######### # # # # ####### # #
   #               # #         #     # # #     #   # #   # # # #   #     #   #   # # #   #   #   # #     #   # # # #   #     # #
###### ##### ##### ################# ### ##### # # # # ### # ### # # # ### # ##### ##### ##### # # # ### # ### # ##### # # ### #
     # #   #   #   #   #       #   # #       #   # # #   # # #   # # # #   # #   #     #   #   # # # # # #   # #       # #     #
 ### ### # # # ##### # ####### # # # # ########### ##### # # # ### # # # ### # # ##### ##### ### ### # # ##### ######### #######
   # #   #   # #     #       #   #     #   #     #   #   # # #   #   # # #   # # #   #       # #     # #     # #       #     # #
## # # ##### ### ######### # # ##### ### # # ### ### # ##### ### ####### # ### # ### ######### ####### ##### ### ##### # # # # #
   # # # #   #   #       # # # #   #   # # # # #     #   #   # #   #     # #   #             #         #   #     #       # # # #
 ### # # # ### ##### ### # # # # # ### # ### # ########### ### ### # ##### # # ######### ### ### # ### # ######### ####### # # #
 #   # #   #   #   # #   # # # # #   # # #   # # #   #     # #   # # #   # # #     #   # #   #   # #               #   #   #   #
## ### # ### ### # # # # # ### # ### # # # ### # # ### ##### # # # # # ### ######### # ### # # # # ##### # # # ##### # # # #####
   #   # # #     # # # # #     # #   # # # #       #   #     # # #   #     #     #   #   # # # # #   #   # # # #     # # # #   #
 ### ### # ####### ### # ####### # ##### # ####### # ####### # ############# ### # ##### # # # ##### # # # ### ####### # ### # #
     #   #       #   # #       # #       # #       #     #   #                 #   #   #   #   #   # # # #   #         #     # #
###### ####### # ### # ### ### # ######### # ##### ##### ### ##### ### ### ### ### # # ######### ### # # ### ################# #
       #       # # # # #   # # #     #   # #   #       #   #       #   # # #   #   # # #   #     #   # # #   #   #       #   # #
 ######### ##### # # ### ### # ##### ### # ### # ##### ### # ####### ### # # ### ### # # # # ##### ### ### ##### ##### # # # # #
 #   #     #   #   #     #   #     #     #   # #   #   # # # #     #     # #   # #   #   # # # #   #   #   #   # #     #   # # #
 # # ######### ### ######### ##### ##### ### ##### # ### # ### ### ####### ### ### ######### # # # # ### ### # # # ######### # #
   #     #                   #         #   # #     #   # #     # #         #   #         #   #   # #   # #   #   #       #   # #
######## # ############# ### # ####### ### # # ####### # ####### ######### # ### ######### ####### ##### # ############# # ### #
 #   #   #     #         #   #   #       # #   #     #     #     #     #   # #   #         #       #   # #             # # #   #
 # # # ######### ######### ##### # ##### # ######### ##### # ### # # # # # # # ### ######### ####### # # ############# ### # ###
 # # #   #       #       #   #   #     #         #       #   #     # # # # #   # #   #   #   #     # # #       #     #     #   #
 # ##### # ############# ### # # ######### # ### ### ### ### ####### # # # ##### ### # # # # # ### # # # # ##### ### ##### ### #
 #     # # #         #     # # #   #       #   #     #       #       #   #     #   # # #   # #   # # #   # #       # #     #   #
 ##### # # ### ##### # ### # # ### # ######### ########### ### # ####### # # # ### # # ##### ##### # ####### ####### # ##### # #
 #   # #   #   # #   # # # # # #   #     #   # #       #   #   # #     # # # #     # #   #   #     #     #   #   #   #   #   # #
 # # # ##### ### # ### # # # # ######### # # # # ##### ##### ##### ### ### ######### ##### ### ######### # ##### # ### ### ### #
   #             #     #   #   #   #     # #   # #   #     #     # # #   #         # #     #           #   #     #     #   #   #
################## ####### ### # # # ##### ##### # # ##### ##### # # ### ######### # # ####### ####### ##### # ######### ### # #
               #   #   #       # #   #   #       # # #   #     # #     #   #     # #   #     # #     # #     #     #     #   # #
 ############# ##### # # # # ### ### # # ######### ### # ##### # ### ##### # ##### ######### # # ### # # # ####### # ##### ### #
     #     #   #     #   # #   # # # # # #       #     #     # #     #   # #   #             # #   # #   #       # # #       # #
 ### # ### # ### ############# # # # # # # # ############### ### ##### # # ### # ######### ### ### # # ######### ### ####### ###
   # #   #   #   #     #     # # #   # #   #       #       #   #   #   #   #   #         #       # # #       #   #   #     #   #
 # # ##### ##### # ##### ### # # ##### ########### ####### ### ##### ######### ######### ### ### ### ### ##### ### # # ### ### #
 # #     #     #   #     # #   #       #   #   # # #     #   #   #   #   #       #     #   #   # #   #   #   #   # # #   #   # #
 ####### ##### ##### ##### ### ########### # # # # # # ##### ### # ### # ##### ### ### ### ### # # ####### # ### # ##### ### ###
       #   # #       #       #             # #   #   #   #   # #   # # # #     #   #     #   # #   #     # # #   #     #   #   #
 ##### ### # ######### ##### ### # # ####### ########### # ### ##### # # # ##### ####### ### # ##### ### ### # # ##### ### ### #
 #   # #   #     #     #   # #   # #           #     #   #   #   #     #   #   #     #       # #   #   #   #   #     # #   # # #
 ### # # ####### # # # ### # # ### # ######### # ### # ##### ### # ######### # ##### ####### ### # ### ### ##### ##### # ### # #
 #   # #     #   # # # #   #   #   # #     #   # #   #       # # # #     #   #     # #     # #   #   # # #     #   #   #     # #
 # ### ##### # ### # # # ####### ##### ### ##### # ########### # # # ### # ####### # # ### # # ### ### # ##### # # # ####### # #
 # #   #     # # # # # #     #   #   #   #       #   #           #   #   # #   # # #   #   # #   #   # # #     # # #     #   # #
 # # ### ##### # # # # ##### # ### # ### ########### # ##### # ####### ### ### # # ##### ####### ### # # # ##### ####### # ### #
   #   #       #   # #       #     #               #   #     #                   #     #           #   #   #           #   #   #
################################################################################################################################
