################################################################################################################################
#               #     #     #         #   #       #     # #     #   #           #       #     #             #   #         #     
# ############# # ### # ##### # ### # ### # # # ### ### # # ### ### # ##### # # ####### # ### # ########### # # # ####### # ### 
#     #       # # # # # #   # #   # #   # # # # #   # # # #   #     # #     # #   #         #   #     # #   # #   #   #   #   # 
####### ##### # # # # # # # # ### ### # # # # ### ### # # ### # ##### # ####### # # ##### # ### # ### # # ### ##### # # ##### # 
#   #   #     #   # # #   # # # #   # #   # #     #   # #     # #   # #   #   # # # #   # #   #     #   #     #     #   #     # 
### # ### ######### # ##### # # ### ##### # ####### # # ####### # # # ##### # ### # # # ##### ########################### ##### 
#   #   #     #     # #     #     #     # #   #   # # #         # #   #   # #   #   # # #   # #         #   #       #     # #   
# ##### ##### # # ### # ####### ####### ##### # # # ############# ##### # # ### ##### ### # # # ####### # # # ##### # ##### # ##
#     # #   #   #     # # #     #   #   #     # #         #     #     # #     #       #   # #         # # #       #     #   # # 
# ### # ### ########### # # ##### # # ### ############# # # ### ##### # ####### ####### ### ### ### # # # ############# # ### # 
# #   # #       #   #     #   # # #   # #     #   #   # # #   #     # # #     #   #   #   #   # #   # # # # #     #   #   #   # 
# # ### # ##### # ### ### ### # # ##### ##### # # # # ### ### ##### # # # ### # ### ##### ### # ####### # # # ### # # # ### ### 
# #   # # # #   #     #     # # # #         #   #   # #     #   #   # # #   # #     #     #   # #     #   # #   #   # #   # #   
# ### # # # # ######### ### # # # # ### ### ######### # # # ### ##### # ##### ####### ##### # ### ### # ### # ####### ### # # ##
# #   #   # #           #   # #   # #   #       #     # # #   #               #       #   # # #   # # #     # #       #   #   # 
# # ####### ### ########### # ####### # # ##### # ####### ### ####### ##### ### ####### ### # # ### # # ##### # ####### # ##### 
# #     #       #       #   #   #     # # #   # # #     # #           #   # # #   #   #     # # #   # # #     #   #     #     # 
# ##### # # # ### ##### # # ### # ##### # # ### # # # # # # ########### # # # ### # ########### # ### # # ####### # ######### # 
#   #   # # #   #   # # # #   # # #   # #   #   # # # # # #   #   #   # # #   #     #               # # #   #   # #     #     # 
### ##### ##### ### # # # ### # ### # ####### # # ### # # ### ### # # ### # ### ##### ############### ##### # # # ##### # ##### 
# #   #     # #   # #   # #   #     #       # # #   # #     #     # #     # #   #   #     # #   #   #     # # # #   # # #     # 
# ### ##### # ### # ####### # ############# ### ### # ### # ####### ####### # ### # ##### # # # # # ### ### ### ### # # # ### # 
#   #     #     # #   #     # #                   #   #   #       #         # #   #       # # #   # # #           # # # #   #   
# ####### ####### ### ### ### ##### ##### ####### ##### ### # ####### ####### # ########### # ##### # # ########### # # ### ####
# #     #     #     #   # #         #     #     #   #   #   #   #   # #       #       #     # #     # # #           # # # #     
# # # ####### # ### ### # ################# ### ### # ### ####### # # # ############# ##### # # ##### # # ########### # # # ### 
# # #         #   #   # # #   #         #   # # #     #   #       # #   #         #         # # #   # # #     #     #   #   #   
# # ########### # # ### ### # # ####### # ### # # ######### ####### ### ######### # ######### # # ### ####### # ############# ##
# # #         # # # #   #   # # #   #   # # # # # #         #   # #   #     #   # #   #       # #   #   #   # # #           # # 
# # # ### ### # # # # ### ### # ### # ### # # # ### ######### # # ### ##### # ### ### # ####### ### ### # # # # ### # ### # # # 
#   #   #   # # # # # #   # # #   # # #   # # #   # #   #   # # # # #   #         #   # # #     # # #   # #   # #   # # # #   # 
# ##### ### # ### # # ### # # ### # # # ### # ### # ### # # ### # # ### # ######### ### # # ##### # # ### ##### # # # # # ##### 
#     # #   # #   # #     # #   # #     #   # #   #   # # #     # #   # #   #   #   # # # #     #       #     #   # #   #       
##### ### ### # ### ####### ### # ######### # # ##### # # ####### ### # # ### # # ### # # ##### ####### ##### ##### ############
#   #   #   #   #         # #   #   #         #   #   # #   #     #   # # #   # #     # #     #     #   #   # #               # 
# ##### ### ##### # # ### # # ##### # ##### ##### # ### ### # ##### ### # # ### ### ### # ### ##### # ### # # # ### # ####### # 
#   # #     #     # #   # # #       #   #   #   #   #       #   #   #   #     #     #   #   # #     #     #   #   # # # #   #   
# # # ######### ### # # # # ######### ### # # # ########### ### ### # ### ######### # ##### # # ################# # # # # # ####
# #       #     #   # # # # #   #     #   # # # #         # # #   # # # # #   #   # # #     # # #         #     # # #   # #     
# ######### ##### ##### # # # # ####### ### # # # ####### # # ### # # # # # # # # # # ### ### # # ######### # # # # ##### ##### 
# #   #   #   #   #     # #   # #   #   #   # # # # #     #         #     # #   # # #   # # # # #     #     # #   #     #   #   
# # ### # ### # ### # ######### # # # ### ### ### # # ##### ######### ##### ##### ##### # # # # ##### # ##### ######### ### # ##
# # #   # #   # #   # #   #     # # # # #   #     # # # #   #         #         # #     #   # # #   #   #     #   # #   #   #   
# # # ### # ### ### # # # # ##### # # # ### ####### # # # ### ######### ######### # ####### # # # # ### # ##### # # # ### ##### 
#   # #   # #   #   #   # # #   # #   # #   #   #     #     #   # #     #         #   #     # #   # #   #   #   #   #   # #   # 
# ### ##### # ### ####### # # # # ##### # ### # # ####### # ### # # ##### ########### # ########### # ##### # ######### ### # # 
#   #     # # #   #     #   # # # #   # #   # #   #     # #       # #     #   #   #   #   #   #   # #   #   #     #   #     #   
# # ##### # # # # # ### ##### # # # # # ### # ######### # ######### # ##### # # # # ##### # # # ### # # # ####### # ############
# # #   # # # # #   #         # #   # #     # #   #     #   #       # #   # #   # # #   # # # # #   # # # #       # #   # #   # 
# # # ### # # ##### # ### ########### # ##### ### # ####### # ######### # # ##### # # # # # # # # ### # # # ####### # # # # # # 
# # # #   # #     # #   #           # # #   #   #           #   #       # # #     # # # # # #   # # # # #   # #   #   # #   # # 
# ### # ### # ### ##### # ######### ### # ##### # ######### # ### ####### # # ##### # # # # ##### # # # ##### # # # ### ##### # 
#     #     #   #     # #     #   # #   # #   # # #   #   # # #   # #     # #   #   # #   #   #   #   #     #   #     #     #   
# ############# ##### # ##### # # # # ### # # # ### # # # # # # ### # ##### ### # ### ####### # ##### ### ### ########### # ### 
#     #   #   #     # #   # # # # #   #     # #     # # #   # # #   #   #   # # # #         # #     #   #           #   # #     
# ##### # # # # ##### # # # # # # ##### ##### ####### # ### # # ### ##### ### # # ######### # ##### # ############### # # ######
#     # #   # #   #   # # # #   #       #   # #     #   #   # #   # # #       # #     #   # #   #   # #   #   #       # # #     
# ### # ##### ### # ##### # ##### # # # # ### # ### ####### # ### # # # ####### ##### # # # ### # ### # # ### # ####### # # # # 
#   # #   #     # # # #   #       # # # #   # # # # #       # #   #   #   #     # #   # # #   #   #     #     #       # #   # # 
### ##### ##### ### # # ########### # ##### # # # # # ##### # # ##### ### # ##### # ### # # # ##### # ################# ##### # 
#   #   #     #     # #   #   #   # #     #   # #   # #       # #       # # #     # #   #   #       # #           #     # #   # 
# ### ### ### ####### ### # # # # # # ### ##### ##### # ##### # # ##### # # # ##### ########### # ### # ##### ##### ##### # ####
# # #   #   # #     #     # # # #   #   # #   #   #   # #   # #   #   # # # # #   # #     #     #   #   #     #     #   # #     
# # ### ### # # ############# # ######### # # ### ##### # # # ### # # ### # # # # # # ### # ############# ##### ####### # ##### 
#   #   #   # #   #   #   #   # #     #   # #   # #   # # # #   # # # #   #   # # # # # # #   #   #   #   #     #   #   #   #   
# ### ####### ### # # # # # ### # ### # ### ### # # # ### # ### # # # # ####### # # # # # ### ### # # # ### ##### # # # ### # ##
#   #         #   # #   # #     #   # #   # #   # # #     #   #   # #   #       # # #   #   #     # #   #   #     #   #   # #   
# # ########### ### ############# # # ### ### ### # ######### # ### ####### # ##### ####### # ##### ##### ### ### ####### # ### 
# #       #     #   #             # #   #   # # #   #       # #     #     # # #   # #   #   # #   # #   # #     #       # # #   
# ######### ##### ##### # ######### ### ### # # ##### ##### # ##### ### # # # # # # ### # ##### # # # # # ##### ######### # # ##
# #         #   #       #         #   # #   # #     #   #   # #   #   # #   #   # #     # #   # #   # # # #   #   #       # #   
# # ######### # ####### ####### # ### # # # # # ### ### # ### # # ### # ####### ### ##### # # # ##### # # # ### # # ##### # ### 
# #       #   # #   #     #   # # #   #   # # # # # #   # # #   # # # # #     # #   #     # # # #   # #   #     # #   #         
# ####### # ### # # ### # # # ### # ### ##### # # # # ### # ##### # # # # ### # # ### ##### # # # # # ############### ##### ####
#     #   # #   # # #   # # #     # #   #     # #   # #   #     # # #   # # # # #   # #   # # #   # #   #         #   #   # #   
# # ### ### ##### # # ### # ##### # ##### ####### ### # ### ### # # # ### # # # ### # # # # # ######### ### ##### # ### # ### # 
# #     #   #     # # #   # #   # #     #   #   #   # #   # # # # #   #   #   # #   # # # # #       # #     # #   #   # #     # 
# ####### # # ##### # # ### # # # ##### ### # # ### # ### # # # # # ### ### ### # ### # # # ####### # ####### # ####### ####### 
# #       # #   # # # # #   # # # #   #     # # #   # #   # #   # # #   # #             # #       # #   #   # #       # #   # # 
# # # ### ##### # # # # # ##### # # # ####### # # ##### ### ##### ### ### ####### # ##### ####### # # # # ### ####### # ### # # 
# # #   # #   # # #   # # #   #   # #   #   # #   # #   # # #   #     # #   #   # # #       #   # #   #             # #     # # 
# ####### # # # # ##### # # # ##### ### # # # ##### # ### # # # ####### ### # # ### # ### ### # # ### ############# # ####### # 
#   #   #   # # # #     #   #     # # #   #   # #   # #       # #         # # #     #   # #   # # #   #           #             
### # # # ### # # # # ########### # # ######### # ### ######### # ### ##### # ########### # ### # # ### ######### ############# 
# #   # # #   # # # #           #   #             #   #   #     #   # #     # #     #     #   # # #   #     #     #   #       # 
# ##### # ##### # # ##### ########### ########### # ### # ### ####### # ##### ##### # ### ### ### ### ##### # ##### # # ##### # 
# #   # #     # # #     #   #       # #         #   #   #   # #       #     #     # #   #   #     #     #   # #     #   #     # 
# # # # ##### # # # # # ### # ##### ### ####### # ##### ### # # ######### ##### # # ### ### ####### ### # ### # ########### ### 
# # # # #     #   # # # # #   #   #     #   #   #   #   # #   #     #   # #     # # # #   #         #   #   #   #   #     #     
# ### # # ### ##### # # # ##### # ####### ### ##### # ### ### ##### ### # # ####### # ##### ### # ### ##### ### # # # ### ##### 
#         #         # #       # #   # #   #   # #   #     #       #       #       #     #   #   # #   #   # #   # #   # #   #   
######### # ####### # ######### ### # # ### ### # ######### ##### # ##### ####### ##### # ####### # ### # # ##### ##### # ### ##
#       # # #       #   #   #   #   # #     #   # #       # #   # # #     #   # #       # # #     # #   # #     # #     #       
# ##### ### # ####### # # # # ####### ####### ### # ##### # # # # # # ### # # # ######### # # ####### ### ##### # # ########### 
# #   #     # #       #   # #     #   #       #   #     #   # # #   #   # # #     #     # # # #       #   #   # # # #       #   
# # # ##### # # ########### ##### # ### ##### # ####### ####### ### ### # ##### # ##### # # # ######### ### ### # # ### ### ### 
# # #       # #   #       # #     # #   # #   # #       #     #   #   # #       # #     #   #   #     #     #   # # #   # #   # 
# # ######### # # # ##### # # ##### # ### # ### # ####### ### # # # ### # ####### # ### ####### # ### ##### # # # # # ### ### # 
# #     #     # # #   #   # #     #   #       #   #       # #   # #   # # #   #     #   # #   #   # #       # # # #   #   #   # 
# ### ### ##### # ### # ### ##### ########### ########### # ##### ### # ### # ####### ### # # ##### ######### # # ##### ### ### 
#   # #   #   # #   # # # # #   # #       #         #     # #   # #   #     # #     # #   # #   #       #     # #         #   # 
### # # ### # # ### ### # # # # # # ##### # ##### # # ##### # ### # ########### ### # # # ##### # ####### ##### ### ### # ### ##
# # # #     # #   #   # # #   #   #     # # #   # #   #   # #   #   #         # #   #   #       #   #     #     # # #   #   #   
# # ######### # # ### # # ######### ##### # # ### ##### ### ### ### # ####### # ### # ##### ##### # # ######### # # ####### ### 
# #       #   # #   #   #           #     #   #   #                 #   #     #   #   #   #     # # #       #   # #       # # # 
# ### ##### ### ### ##### ########### ##### ### ########### # ########### ####### ### # # ##### # # ####### ### # ####### # # # 
#     #     # #   # #     #           #     #   #     #     # #           #     # #   # # #   #   #       #   # #       # #   # 
##### # ##### ### # # ##### ############### # ####### # ####### ############### ### ### ### # # ############# # ####### # ##### 
#     # #   # #   #   #   # #   #       #   #         # #   #   #     #   #   #   #     #   # #       #       # #   #   #     # 
####### # # # # # ####### # # # # ##### # # ########### # # # ### ### # # # # ### # ##### ### # ##### # ####### # # # ####### # 
#       # # #   #     #   #   # # #   #   #     #     #   # #   #   #   # # #     # #   # #   #   #   #     #     # # #   # # # 
# ####### # ##### ### # ### ### # # # ##### ### # ### ##### ### ### ####### ####### # ### ####### # ####### ####### # ### # # # 
# #     # #     #   # #   #   # # # # #     #   # # #     #   #   #     #   #     #   #   #   #   # #       #       #   #   #   
# # ### # ##### ### ##### ### # ### # ########### # ##### ####### # ### # ##### # ### # ### # # ##### ####### # ####### # ######
# # #   #   #   #   #     #   # #   #             # #     #   #     #   #       #   # #     # # # #   #   #   # #     # #   #   
# # # ##### # ### ### ##### ### # ################# # ##### # # ##### ############# # ####### # # # ### # # # ### ### # # # # ##
#   #     # # #     # #     #   # #       #         #   #   # # #   #             # #         #   #   # # # #     # #   # # #   
######### ### # # # # ##### # ### # ##### # ### ### ### # ### # # # ##### ####### # # ############### # # ### ##### ##### # ### 
# #     #     # # # #     # # # #     #   # #   #     # #   # #   # #   # #       # # #       #     #   #   #   #         #S#   
# # ### ####### # # ##### ### # ####### ### # ### ##### ##### # ##### # # ####### # # # ##### # ### ####### # # # ####### ### ##
# # # #   #     # #     #     #   #     # # # #       # #   # #       # #       # # # # # #   # # # #     # # # #     # #     # 
# # # ##### ##### ##### ####### # ####### # # ####### # # # # # ####### ####### # # # # # # ### # # # ### # # # ##### # ####### 
# #         #     #     # #     # #       # #   #   # # # # # #       # #     # # # # # #   #   #   #   #   # # #     # #   #   
# ########### ### # ### # # # ### # ##### # ### # # ### # # # ####### # # ### # ### # # ##### ####### # ####### # ##### # # ### 
#   #   #     # # #   #   # #   #   #   # #   # # #     # #   #       #   #   #       #     #   #   # #       #   #     # #   # 
### # ### # ### # ### ##### ### # ### # # ### # # ####### ##### ########### ############### ### # # ######### # ### ##### ### # 
#         #     #   #       #   #     # #     #                           #                   #G  #           #             #   
