################################################################################################################################
################################################################################################################################
 #       #         # #   #       #       # #   #       #     #           # #   #         #     #   #             #       #     #
 # # ##### ##### # # # # # ##### # ##### # # ### ### # # ### # ####### # # # ### ####### ### # # # # ########### # ##### ##### #
   #   #   #   # #   # # #   # #   #     #   #   #   # #   #   #       # # # #   #     #   # # # # #   #       # # #   #     # #
 ##### # ### # # ##### ##### # ##### ##### ### ########### ##### # ##### # # # ####### ### # # # ##### # ##### # # # # ##### # #
 #   # # #   # #     #   #   #     # #         #   #   #   #   # # #   #   # # #     # #   # # #     # # #   #   # # #     # # #
 # # # # # # ####### ### # ### ### # # # ####### # # # # ### # # ### # ##### # # ### # # ### # ##### # # ### ##### # ### ### # #
   # # # # # #         # # # #   #   # # #       #   #   # # # # #   #     # #   # #   #   # # # #   # #           # # # #   # #
 ### ### # # # ######### # # ### ##### # # ############### # # # # ####### # ##### ####### ### # # ### ############# # # # ### #
   #     # # #       #   # #   #       # #       #       #   #   # #     #   #     #       #         # #           # # #   #   #
## ####### ######### # ### ### ### ##### ####### # ### # ######### ### ####### ### # ####### ######### # ### ####### # ##### # #
 #   #     #       # # # #     #   #     #     # # #   #   #     #     #       # # #           #       # # #         #       # #
 ### # ##### # # ### # # ####### # # ### ##### # ### ##### # ######### # ####### # # ######### # ####### # ########### ####### #
   # #       # # #   #   #     # # #   # #   # #     #     #   #       # #   #   #   #     #   # #     # #     #   #   #     # #
 # # # ####### # # ### ### ### ### ### # # # # ####### ##### ### ####### ### # ####### ### # ##### ### # ### # # # ##### ### # #
 # #         # # #     #   #   #     # # # #             #   #   #     #   # # # #     #   #   #   # #   #   #   #     #   #   #
 # # ####### # ######### ### ### ##### # # ##### ####### # ### ####### ### # # # # ##### ##### # ### ##### ########### ### #####
 #   #   #   #     #     # # #   #     #   #     #     #   #   #       #   # # # #   #   #   #   #   #     #         #   # #   #
 ##### # ######### # ##### # # # # ######### ##### ### ### # ### ##### # ### # # ##### ### # # ### # # ##### ##### ##### # # # #
 #     #     #   # #     #   # # #       #   #     #       #     #     #           #   #   # #     # #     # #   # #     # # # #
 # ######### # # # ####### ### # ######### # # ########### ### ####### ##### ####### ### ### ##### ######### ### # # ##### # ###
 #   #     # # # #   #     #   #   #       # #     #     #     #     #     # #       #   #   #     #   #     #   # # # #   #   #
 ### # ### ### # ##### ##### # ### # # ############# ### ### ### ### ### # # # ####### ### ### ##### # # ##### ### # # # # ### #
   #   # #     # #   #   #   # #   # # #   #       # #       #   #   #   #       #       # # #       # # #   #   # # # # # # # #
## ##### ####### # # ### ##### # ### ### # # ##### # ######### ### ### ######### # ####### # # ####### # # # # # # # # # # # # #
     #         # # #   #       # # # #   # # #     #     #   #   # #   #       #     #     #         #   # #   # #   #   #   # #
 ### ##### ### # # ### ######### # # # ### # ####### ### # # ### ### # # ##### ##### ############# ####### ##### ##### ####### #
 # #     # #   # # # #   # #       # #   # #       #   #   #   #     # #   #     #   #           # #       #               #   #
 # ##### ### ### # # ### # # # # ### ### ######### # ##### # ############# ##### ### # ######### # # ##### # ######### ##### ###
   #   #   # #   #   #   #   # # # #   #   #   #   # #   # #       #     #   # #     # #         # # #     #         # #     # #
#### # ### # # ####### ####### # # ### ### ### # ##### # ##### # ### ### # # # ##### # ########### # # ##### ####### ### ##### #
     #   #   # #   # #   #   # #   # #     #   #   #   # #   # #   # # # # #   #   # # #     #   #   # #   #   #   #   #       #
 # # ### ### # # # # ### # # # ##### ####### ##### # ### # # # # # # # # ####### # # # # ### # # ##### # # ### ### ### ####### #
 # #   #       # #   #   # #     #     #   #     #   #     # # # # #   #       # #     #   # # #       # #   #   #   #       # #
 ##### ####### # ##### ### ### # ##### # ### ############### # # # ### ####### ### ####### # ######### # ### ### ### ### ##### #
     #   #   #   #     #   # # # #     #     #             #   # #   # #     #   # #       #     #     #   #   #     # # #     #
 ######### # # ### ##### # # # # # ##### ##### ########### ### ##### # # ### ### # # ########### # # ##### ### # ##### # # #####
   #       # #   #   #   # #   #   #       #   #         #   # #   # # #   #   # # #       #   # # #     # # # # #     #   #   #
 ### ####### # # ### ##### ### ##### ##### # ##### ##### ### # # # # # ####### # # ####### ### # # ####### # # # # ### ##### ###
   #   #   # # #   #     # #             # #     # #     #   # # # # # #       # #       #     # # #   #     # # # #   # #     #
## ### # # # # ######### # ######### ##### ##### # # ### # # ### # ### # ####### ### ########### # # # # ##### # ### ### # ### #
     #   # # #     #     #   #     #     #   #   # # #   # # #   # #   #     #   #   #           #   # #   #   #     #       # #
######## # # ##### # ####### # ### # ### # # # ##### ### # ### ### # ####### ### # ### ########### ##### ### ####### # ####### #
   #   # # #     # #         # # # #   # # # #       #   #   # #   #     # #     #   #   #           #   #   #     #   #     # #
 # # # ### ##### # ########### # # # ### # ########### ##### ### ####### # ####### # ### ####### # # # ### ####### # ### ### # #
 #   #   #     #     #   #   #   # # #   # #   #   #     #   #   # #     #   #   # #   #   #     # # #   #         # # # #     #
 ####### ##### ##### # # ### ##### ### ##### # # # ##### # ### ### # ####### # # # ### ### # ##### # ### ########### # # #######
   # #   #     #   #   #     #   #   #   #   #   #   #   # #   #     #       # # #   #     # # #   #   #   #   #   #   # #     #
## # # ### ####### ##### ##### # ### ### # ######### # # # # ### ##### ######### # # ####### # # ##### ### ### # # # ### # ### #
 #   # #   #         #   #     #   #     # #     # #   # #   #   #   # #         # #       #   # #   #   #   # # # #   #   #   #
 ##### # ########### # ### ####### ##### # # ### # ##### ##### ### # # # # ### ### ####### ##### # # ####### # # # ##### ### ###
 #     #         #   #   # #   # #   #   # #   #         #   # # # #   # #   # #         # #   # # #       # # # # #   #   #   #
 # ##### ####### # ##### # # # # ### # ### # # ##### # # # # # # # ##### ### # # ####### # # # ### ####### # # # # # # ### ### #
 #     # #   #   #     # # # # # #   # #   # #     # # #   #             #   #       #   #   #     #     #   # # #   #   # #   #
 ##### ### # # ### ##### # # # # # ### # ### ####### # ##### ##### # ##### ### ####### ##### ####### ### ##### # ####### ### # #
     # #   # # #   #     # # # # #     #   #   #     # #   # #   # #     # #   # #   #     # #       # # #   # # #     # #   # #
 ### # # ### # # ### ##### # # # ### ##### # ### ##### # # ### # # ### ### # ### # # ##### ### ####### # # # # # ##### # # ### #
   # #   # #   #   #     #   #   #   #     # #   #     # #     # #   # #   #     # #       #   #       #   # #   #   # # # # # #
## ####### ####### ##### ######### # # ####### ####### # ####### ### # # ##### ### ######### ####### ####### ##### # # # # # # #
 #                                 # # #       #     # # #     #   # # #     # #   #       #       #     #   # #   # # #   #   #
 ####### # ########### ##### ####### # # ####### ### # # ##### ### # ####### # # ### ##### ####### # ##### ### # ### # ####### #
 #       # #       #   #   #   #   # # # #       #   # # #   #     # #     # # #   # #   #       # # #     #   #   # #   #     #
 # # # ### # ##### # ### # ### # # # # ### ####### ### # # # ####### # ### # # ### # ### # # # # # # # ####### ##### # # # # # #
   # # #   # #     # #   # # # # #   #     # #   # #   #   # #       #   #   #   #   #   # # # # #   # #   #     #   # # # # # #
 ##### # ### # ##### # ### # # ############# # # # ######### # ############### # ##### ### ### ##### # # ### ### # ##### # # # #
 #     #     # #     #   #   #               # # #   #       #   #       # #   #     #   #   #   #   # #   #   # #     #   # # #
 # # ######### # # # ### ########### ####### # # ### # ######### # ##### # # # ### # # # ### # # # ### ### ### # ##### ##### # #
 # # #         # # #   #           #     #   # #   #   #       # #     # #   # #   #   # #   # # #   #   #     # #   # #   # # #
 # ### ########### ### ########### ##### # ### ### ##### ##### # ### ### ### # # ####### # ##### ### ### ####### # ### # # ### #
 #   # #   #       # #     #   # # #     #     #   #   #     #   #   #   # # # #   #     #     #   #   #   # #   #   #   # #   #
#### # # ### # # ### ### ### # # # ##### ####### ### # ##### ##### ### ### # # # # # ### ##### ### ### ### # # ### # ##### # # #
   # # #     # #   #   # #   #   #     # #       #   #     # #     #   #     # # # # #       #   # #   # # #     # #     #   # #
 # ### ####### ### ### # # ########### ### ####### # ##### # # ##### ####### # # # # ### ####### ### ### # ##### # ##### ##### #
 #     #       # # #   #   #     #   #     #   #   # #   # #   #   #     #   # # # #   #       #     #   #     # #   # # #     #
 ######### ### # # # ####### ### ### ####### # # ### # # # ####### ##### ##### # # ### ############### ####### # ### # # ### # #
         #   # # # #G# #     # #   #   #   # #   #   # # # #   #   #   # #     # #   # #             #     #   # #     # #   # #
######## ### # # # # # # # # # ### ### # # ####### ##### # ### # ### # # # ##### ### ### ########### # ##### ### ##### ### ### #
       #   # #   #   #   # # #   # # # # #   #     #     #   #       # # # #       #     # #   #   #   #     # #     #     #   #
 # ### ### # ######### ### # ### # # # # ### # ##### ####### ### ####### # ##### # ####### # # # ####### ##### ##### ####### # #
 #   # #   #     #     #   #   #   #   # # #   #           # #   #     # #     # #           #   #     #   # #     #         # #
###### # # ##### # # ### ##### ##### ### # ##### # ######### # # # ### # ### # ####### ########### ### ### # # ### ########### #
     # # # #   # # #   #     #     # #   #   #   # #   #     # # #   # #   # #   #   #           # # # #   # # # #             #
 ### # # ### # # # ### # ### # ##### # ### # # ### # # # ####### ##### ### # ### # # ########### # # # # ### # # ### # # #######
 #   # # #   # # # # # #   # # #   #   #   #   # # # # #       #       #   # #   # #   #   #     # # # # # # # # # # # #   #   #
## ### # # ### # # # # # ### # # # ##### ####### # # # ####### ##### ### ### # ### ### # # # ##### # # # # # # # # # # ### ### #
   #   #   #   #     # # #   #   #       #   #   #   #       # #   # #   #   # #     # # # #   #   # #   # # #   #   #   #     #
 ##### ##### ### ##### # # ######### ####### ### ######### ### # # # # # ##### # ##### # # ### # ### ##### # ####### ### #######
 #   # #   # #   #     # #     #   #       #   #         #     # #   # # #   #   #   # # # # # # # # #                 #       #
 # # # ### # ### # ####### ### # # ### ### ### # ### ### ########### # ### # ##### # # ### # # # # # ### ##### ##### ### # # ###
 # #       #   # # #     # # #   #   #   #     #   #   #             #   # # #     # #   # # # # # #   # #     #     #   # #   #
 # ##### ##### # # # ### # # ####### ### # ##### ##### # ### ### ####### # # # ##### ### # # # # # ### # # ######### # ####### #
 # #   #   #   # # # # # #         # # # #       #   # #   #   # #   # #   # #   # #   #   #   # #   # # # #   #   # #   #     #
 # # # ##### ### # # # # ##### # ### # # ######### # # ####### # # # # ##### ### # ### ######### # # # # # # # # # # ### # #####
   # # #   # #   #     #   #   # #   # #         # # # #       # # #   #   # # # #   # #         # # # # #   # # # #   # # #   #
 ### # # # # # ########### # ##### ### ######### # # # # ### ##### ##### ### # # # # # # ########### # # ##### # # ### # # # # #
 #   # # # # #       #     #   #   #         #   # # # # #   #   # #       # #   # # # # #     #             #   # #   # #   # #
 # ### # # # # ####### ######### ########### # ##### # # # ### # # # ### # # ##### # # # # ### ########### ##### # ##### ##### #
 # #   # #   # #       #         #   #       # #   #   # #   # #   #   # # #       # # # # # #       #   # #   # #     # #     #
 # ##### ##### # ####### # ######### # ####### # # ##### ##### ####### # ##### ####### # # # ####### # # # # # ####### # #######
     #   #   # #   #     #   #   #   #       # # #   #   #     #       # #     #       # # # #       # #   # # #   #   #       #
 ### # ### # ##### # # ##### # # # ######### # # ### # ### ##### ####### # ##### ####### # # # ############# # # # # ######### #
 #   #   # # #     # #     # # #   # #   #   #   # # #     #     #   #   #   #   #     # #   # #   #         #   # #   #   #   #
 # # ### ### # ######### # # ### ### # # # ####### # # ##### # ### # # # ### # ####### # ### # ### # # ########### ### # # #####
 # #   #   # # #   #     # #   #   # # # # #     #   # #     #     # # #   #   #       #   # #   #   #         #       # # #   #
 # ### ### # # ### # ##### ### ### # # # # # ######### # # ### ##### # ### ##### ##### ### # ### ########### # ### ##### # # # #
 #   #   #   #     # #       # # # #   #   #       # #   #   # #     #   #     #     # #   #   #       #   # # #   #   # #   # #
 ### ### ########### # ####### # # ### ########### # # ##### # # ####### # # ### ### # # ##### ####### # # # # # ### # ####### #
   # #           #   #   #     # #     #           #   #   # # #   #   # # #     #   # #   #   #     # # # # # # #   #         #
## # ########### # ##### # ##### ##### # ########### ### # # ##### # ### # ##### # # ##### # ### ### ### # # # # # #############
   #   #       #   #     #   # #       #         #   #   # #   #   #   #S# #   # # # #     #     #       # # # # # #           #
 ##### ####### ### ######### # # ############### ##### ### ### # ### # # # # # ### ### ################### ### # # # ### # ### #
 #   #     #       #         # #               # #     #   #   #   # # # # # #   # #   #       #         #     # # # #   #   # #
 # # ##### # # # ### ######### ### ##### ##### # # ##### ### ##### # ### ### ### # # ### ##### # ####### ######### # # ### ### #
 # # #   # # # #   #         #     #   # #     # # #   # #   #     #   #   #   # # #   #   # #   #   #   #         # #   # #   #
 ### ### # # # ### ######### ####### # # ####### # ### # # # # ####### ### ##### # ### ### # ####### # ### ######### ### # # ###
 #       # # # # # # #     # #       # #   #   #   #   # # # # #         #       #   #     #   # #   #   # #   #     # # # # # #
 # ####### # # # # # # ### # # ####### ### # # ##### ### ### # ####### # ######### # ######### # # # ### # # # # ##### # ### # #
   #       # #   #   # #   # #       # #   # #     # #   #   # #     # #     #     #   #       #   # # #   # #   #     #   #   #
 ### ####### ######### # ### ####### ### # # ### # # # ### ### # ### # ### # ### # ### # ########### # ##### ##### ### ### #####
   #   # #   #         # # #       #   # # #   # #   # #   #     #   #   # #     #   #   #         # # #     #   # #   # # #   #
 # ### # # # # ######### # ####### ### # # ### # ##### # ######### ####### ######### ##### ####### # # # ##### # # # ### # # # #
 #   # #   # # #     # #     #   #   #   #   # # #     # #   #   # #       # #       #   # #   #   # # #   # # # # #     # # # #
 # ### ####### # ### # ####### ##### ####### # ### ##### # # # # # # ####### # ### ##### ### # # ### # ### # # # # ####### # # #
 #   #   #     #   #   #   #   #   # # #     #   # #     # #   # # # #     #   #   #   #     # # #     #   #   # # #     # # # #
 ### ### # ####### ##### # # ### # # # # ####### # # ##### ####### # ##### ### # ### # ####### # # ##### ####### # # ### # ### #
   #   #                 # #     #   #               #             #       #   #     #                               #   #     #
################################################################################################################################
