################################################################################################################################
################################################################################################################################
                 #       # #           #   #   #         # #       #   #         # #               #   #       #     # #       #
###### ######### # # ### # # ######### # ### ### ####### # # ####### ### ####### # # ##### ######### # # ##### # ### # # ##### #
     #   #     #   #   # # # #       #   #   #   #     # #   #     #   #   #     #   #   #         # # #   #   # #   #   #   # #
 ### ### # ### ### ### # # # # ##### ### # ### ####### # ### # # # ### ### # ##### ### ########### # # ### # ##### ####### ### #
   # #   # # #     #   #   # # #   # #   #     #   #   #   # # # #   #   # #   # #   #           #   # #   #                   #
## # ##### # ##### ##### ### ### # # # ########### # # ### # ### ### ### # ### # ### ######### # ##### # ######### ##### #######
   #     # #       #   # #   #   #   #     # #     # # #   #     #         #   #   #     #     # #     #   #       #   # #     #
 ####### # # ####### # ### ### ##### ##### # # ####### # ####### ##### ##### ##### ##### # ##### # ######### # ##### # # # ### #
 #         # #   #   # #   #   #   #     # # #         # #   #   #     #   # #   # #   #   #   # # #     #   # #     # #   #   #
 ########### # # # ### # ### ### ####### # # ### ####### # # ### # ##### # # # # # ### ##### ### # ##### # ### # ##### ### #####
   #     #   # # # # #   #   # # #     # # #   # #     #   #   # # #     # # # # #         #   # #       # #   #     #   # #   #
## # ### # ### ### # ####### # # # # ### # # ### # ### ####### ### # ##### # # # ####### ### # # ########### ########### ### # #
 #     # #   #     #   #     #   # # #   #   #   # # #   #   #     #   #   #   #   #   # #   #   #     #     #     #   #     # #
 ####### ### ######### # ##### ### # # ##### # ### # ### ### ### ##### ### ####### # # # # ####### ##### ##### # ### # ####### #
         # # #       #   #       # # # #     #   #   # #         #   #   #   #   #   # #   # #   #       #   # #     #       # #
########## # ##### # ### ##### ### # # # ####### ##### ##### ##### # ### ### ### ##### # ### # # ### ##### # # ######### ##### #
     #   # #       #     #   #     # #                       #     # #   #   #     #   #       #   #       # #   #     #     # #
 ### # # # ### ####### ### # # ######### ##### # ####### # # # ##### # ### ### ##### ### ### ##### ######### ### # ### ##### # #
 #   # #       #   #   #   # #       #   #   # # #       # # # # #   #   #   #             #     #     #   #   # #   # #   #   #
 # ### ### ##### # # ### ### ####### # # # # ### # ####### ### # # ##### ### # ########### # # ####### # # ### # ##### # # #####
 #   # #   #   # # #   #   # #   #   # # # # #   #     #   #   # #     # #     #     #     # #     #   # #   #     #   # #     #
 ### # # ### # # # ### ### ### # # ### # # # # ######### ### ### ##### # # ##### ### ####### ### # # ### ### ##### # ### ##### #
 #     # #   #   #   #   #     # #     # # # #     #     #   #   #     # #   #   # #   #       # # # #   # #     # #     #   # #
 ##### # # ######### ### ####### # ####### # ### ### ##### ### ### ##### ### # ### ### # ### # # ### # ### # ### # ### ##### # #
     # # #         #       #   # # #       #     #   #     # #     #   # #   #   #     # #   # # #   # #   # #   #     #   #   #
#### # # ######### ### ##### # # # # ############# ### ### # # ##### # ### ##### # ##### # # # ### ### # ##### ##### ### # #####
     # #         #   # #   # # # # #   #   #     # # #   # # # #     # #   #     # # #   # # # #   #   # #   # # #   #   #     #
 ##### ######### ### ### # # # # ##### # ### ### # # ### ### # # ##### # # # ##### # # ##### # # ### ### # # # # # ### ####### #
 # #     #     #   #     # # # # #   # #     #   #     #     #   #   # # # # # #   # #   #   # #     # #   # # #     # #     # #
 # # # ### ####### ######### # # # # # ######### ################# ### ### # # # ### ### # ### ####### ##### # # ##### # ### # #
 #   #   #   #   #   #   #   # # # #   #         #   #     #     # #       #   # #       #   #   #   #   #   # # #     #   # # #
 ####### ### # ##### # ### ### # # ##### ####### # # # ### # ### # # ##### ##### # ########### # # # # # # ### # # ####### ### #
   #   #     #       #   #   #   # #   #   #   # # # # #   # # # # # #   #     # # #         # # # #   # # #   # #     # # #   #
 # # # ################# ### ##### # # ### # # # # ### # ### # # # # # # # ##### # # ####### # # ####### # ### # ##### # # # ###
 #   #     #     #         #     # # #   # # #   # #   #     # # #   # # #     # # #       # # #       # #   # # #   # # # #   #
 ######### # ### ##### ### ##### # # ### # # ##### # ######### # ##### # ##### # ########### ####### # # ### # # # # # # # ### #
     #   #   # #     # #       #   #   #   # #   # #   #   #   #       # #     #   # #   #   #     # #   # #   # # # # # # #   #
 ### ### ##### ##### # # ################### # ### ### ### # ########### ##### ### # # # # ### ### ### ### ##### # # # # # # ###
   #   #     #       # # #       #                   #   #             # #   #   #     # # #   # #   #         #   # # # # #   #
 # ### ##### ########### # ##### ####### ############### ##### ####### # # # ### # ####### # ### ### ##### ### # ### # # # ### #
 #   # #   #         #   #   # #   #   # #             # #   #   #   # #   #       #       # # #     #   #   # # #   # # #     #
 # ### # # ##### # # # ##### # ### # ### # ############# # # # # # # ############# # ####### # ####### # ### # # ##### # #######
 #   #   #     # # # #   #   #     #     # #           # # # # #   # #             # # #   #     #     # #   #   #     #       #
 ### ######### ### # ### # ######### ##### ### ####### # ### # ##### # ########### # # # ####### # ##### ##### ### ########### #
 # # #   #   #   # #             #       # #   #     # #   # #     # #     #   #   # #   #   #   # # #   #   #   #       #   # #
 # # # # # # ### # ############# ### ##### # ####### # ### # ##### # ####### # # ### ### # # # ### # # ### # ########### # # # #
   # # # # #   # #   #   #     #     #     #     #   #   # #   #   # #       # #   #   # # #     # # #     #       #     # # # #
 ### # ### ### # ##### # ##### ##### # ######### # ##### # ### # # ### # ##### ### ### # # ####### # ############# # ##### # # #
   # # #   #   #     # # #       #   #           # #   #   #   # # #   # #   #   #   #   # #   #     #   # #       #   #   #   #
#### # # ### ####### # # # ####### ############### # # ##### ##### # ### # ##### # # ### # # ### ##### # # # ### ##### # #######
     #   #   #     # # # #     #   #       #       # #           # #   # #     # # #   # #   #   # #   # # # #   #     #     # #
 ######### ####### # # # # ##### ### # ### ### # ### # ####### # # ### ####### # ### # # ### # ### # ### # # # ### ######### # #
 #       # #       # # # # #     #   # # #   # # #   #   #   # #     #   #     #     #         #   # #   #   # #   # #     #   #
 # ##### # # ####### ### # # ##### # # # ### # # # ##### # # ####### ### # ################### # ### # ### ##### ### # ### ### #
   #   #   # #   # #     # #       # # #   #   #     #   # #       #   #   #     # #         # #   # #   # #   # # # # #   # # #
 ##### ##### ### # ####### ######### # ### # ####### ##### ####### # ########### # # ####### # ### # ### ### # # # # # ##### # #
             #   #     #           # #   # # #   #       # # #     # #   # #   #   #       #       # # #   # #   #   #       # #
 # ##### # ### ####### ##### ##### # ### # ### # ### ### # # # # ##### # # # # ### ######### ####### # ### # ##### ####### ### #
 #     # #     #   #   #   #     #     #   #   #   #   #   #   # #   # # #   #   #     #   # #     # # # # #   #         # #   #
###### # ### ### ### ### # ### # # ######### ##### # ############# # # # ####### # ##### # # # ### # # # # ### ####### # # # ###
       #   #         #   #   # # # #       #     # #         #     #   # #     #   #     #   #   # # #   # # #   #   # #   #   #
 ######### # ############### # # # # ### # ##### # # ####### # ######### # ### # ### ##### ####### # # ### # ### # # ### ##### #
 #   #     #     #   #       # # # #   # # #   # # #   #     # #   #   #     #   #   #   # #       # #   #   # # # #   # #     #
 ### # # ### ### # # # ####### # ##### # # # ### # ### ####### # ### ############# ### # # # ####### # # ### # # ##### # # #####
   #   # # #   # # # #   #     # #     # # #     #   #         # #   #         #   #   # # #         # #   #   #   # # #   #   #
## ##### # # # # ### ### # ### # # ##### # ######### # ######### # ### ####### # ####### # ########### ### # ##### # # # ### ###
 #   #   # # # #   # # # # # # #   #     # #         # #       # # # # #     #   # #   # #         # #   # # #             #   #
 ### # ### # # ### # # # # # # ########### # ######### # ##### # # # # # ### # ### # # # ######### # ### # # # ########### # # #
   # #   #   # #   # #   #   # #       #   #   # #     # #     #     # # #   # #   #S# #           #   # # # #   # #     #   # #
## # ### ### ### ### # ### ### # ##### ####### # # ##### ##### ##### # # # ##### ### # # ############# # # # ### # # ### ##### #
   # # #   # #   #   #   # #   #   # # #   #   #   #     #   # #     #   #       #   # # #     #       # # #   # # # #   #   # #
 ### # ### # # ### ##### ### ##### # # # # # ##### # ##### # # # ### ######### ### ### # ### # ##### # # # # ### # # ##### ### #
     #     # #   # #   #   # #   #   # # #   #   #   #     # #   #   #       # #   #   #     #       # # #   #   # #   #       #
############ ### # ### ### # # # ##### # ##### # ##### ##### ##### ### ##### # # ### ################# # ##### ### ### #########
 #           #   #   #   # # # # #     #   #   #     #   # #     #   # #     # #   #     #     #       #   # # #   #   #       #
 # # ####### # ##### ### # ### # # ### ### # ####### ### # ##### ### # # ######### ##### # ### ####### ### # # # ### ### ##### #
   # # #     #     # #   #   # # #   #             #   #   #   # #   # #     #   #   # #   # #               # #   #   #     # #
#### # # # ####### # # ##### # # # # ############# # ####### # # # ### ####### # ### # ##### ########### ##### ### ### ##### # #
   # #   #       #   # #   #   # # # #   #       # #       # #   # #   #       #     #           #     # #     #             # #
 # # ### ####### ##### # # ##### # ### # # ##### # ##### ### ##### # ####### ################### # ### # # ##### ### # ##### ###
 #   #         # #   #   #     # #     #   #     #   #   #   #     # #       # #           #     #   # #       # #   # #   #   #
 ####### ### # # # # ####### ### # ######### ####### # ### ### ##### # ####### # # # # ### # ####### # ####### # # ##### # ### #
 #       #   # #   #       #     #   # #     #   #   # #   #   #   #   # #       # # #   #   #       #       # # # #     #     #
 ##### ################### # ####### # # ### # # ### # # ##### # # ##### # # # ### # ### ##### ############# # ### # ######### #
 #   #       #       #   # # #   #     #   # # #   # #   #   # # #   #     # #   # #   # # #   #       #     # #   # #       # #
 # # # ##### # ####### # # # ### # ##### # ### ### # ##### # # # ##### ##### ### # # # # # # ### # ### ####### # ### # ##### # #
 # # #   #   #   #     #   # #   # #   # #     #   #   # # # # #     #   #   #   # # # #   #   # #   #     #   # #   #     #   #
 ### ##### ##### # ######### # ### # # ######### ### # # # # # ##### ### # ### ### # # ####### ### # ##### ### # # # ######### #
     #     #     # #     # #       # # #     #   #   #   # # #     #   # # #   #   # #     # #   # # #   #   #   # # #     #   #
###### ### # ##### # ### # # ####### # # ##### ### ####### # # ##### ### # # ### ### ##### # ### ### # ##### ##### ### ### # # #
   #   #   # #     # # # #   #       # #       #   #     # # # #   # #   # # # # #       # # # # #   # #   #     #   # # # # # #
 # # ####### ### ### # # # ### ####### ######### ### ### # # # # # # # ### # # # ### ##### # # # # ### # # ##### ### # # # ### #
 # # # #   #     # # #   # #   # #     #           #   # # # # # # # # # # #   #   #     #     # #   # # # #   # #   # # # #   #
 # # # # # ####### # ##### # ### # # ########### # ### # # # # # # # # # # ####### ##### ####### # # # # # # # # # ### # # # ###
 # # # # #   #   #   #   #       # # #       # # # #   #   # #   #   # # # #   #   # #     #     # # # # #   # # # #   #   #   #
 # # # # ### # # ### ### # ####### # # ##### # # # # ####### ### ##### # # # # ##### # ### # ##### # # # ####### # # ######### #
 # # # # # # # #   #       #       # # #   # # # #   #     #   #       #   # #   #   # #   #   #   # # # #     #   # #   #     #
 # # # # # # # ### # ####### # ####### # ### # # ##### ####### # ### ####### ### ### # # ##### ##### # # ### # ### # # # # #####
 #   #   # # # #   #   #   # # #       #   # # #       #     # #   #       # #     # # #   # #   #   #   #   #     # # #   #   #
 ######### # ### ### # # # # ### ######### # # ### # ### ### # # # ####### # ##### # # # # # ### # ### ### ######### # ####### #
   #       #   #     # # # # #   # #     #   #     #   # #     # #     #   #     # #   # #   #   # #       #     #   #   #   # #
 # # ### ##### ### ##### # # # ### # ### ############# # ####### ##### ########### ##### ##### ### # # ##### ### # ##### # # # #
 #   # #   #   #         # #   #     #   #       #     # #     #     #         #   #   #     #     # # #     # # #     #   #   #
 ##### ### # ##### ####### ######### ##### ##### # # ### # ### ### # ######### # ### # ### # ######### # ##### # ##### ####### #
 #       # # #   # #   #   #       #     #   #   # # #   #   #   # #         # # #   #     # #       # # #   #   #   #     # # #
 # # ##### # ### # ### # ### # ### ### ##### ##### # # ##### ### # ######### # # # # ####### # ##### # # # # ##### ####### # # #
   #     #   #         # #   # # # #   #     #     # # #   # #   # # #       #   # # #       # # #   # # # # #   #         #   #
 ####### ##### ##### ### ##### # # # # # ##### ##### # # # ### ### # # ############# ##### ### # # ### # # # # # # ######### ###
 #     #           #   # #   #   # # # #     #   #   # # #     #   #   #             #   # #   #   #   #   #   #   #   #   #   #
 ##### ##### # ### ##### # # ##### # # ##### ### # ### # ####### # ### ########### ### # ### ### ########### ####### # # # # # #
 #     #     #   #     #   #     #   #     #   # #   # # #   #   #   # #       #   #   # #   # # #           #       #   #   # #
 # ##### ####### ##### # ####### ######### ### # ### # # # ### ##### ### ##### # ### ### # # # # # ######### # ### ##### ##### #
   #   # #       #   # #   #   #       #         #   #   #   #   # #   # #   # #   #   #   # # #   #     #   # # #     #     # #
 ### # # ####### # ### # ### # ### ### ########### ######### ### # ### # # # # ### ### ####### ##### ### # # # # ##### ### ### #
     # #   #     #   # #   # #   #   #       #                 #   #   #   # #   # #   #       # #     #   #   # #   #   # #   #
#### # ### ##### ### # ### # ### # ######### ####### # # ######### # ####### ### ### ### ####### # ### # ####### # ##### # # ###
   # # #   #     #   #   # # # # #     #   #       # # #     #     #       #   #     #   #   #   # #   # #         #   # # #   #
 ### # # ### ##### ### # ### # # ### ### # ####### ### ####### ########### ### # ##### ##### # ### # ### # # # ##### # # ##### #
 #   # #   #     # #   #   # #   #   #   #       #   #       # #       #   #   # #     # #   #     # #   # # #   #   # # #     #
 # ### ### ##### # ####### # ##### ### ######### ### # ##### # ####### # ### ##### ##### # ####### # ##### # ##### ##### # #####
   #     #   #   #   #     #   #     #   #         # #     #           # #   #     # #   #     #   #       # #       #   #     #
######## ### ####### # ####### # # # ### # ######### ##### ############# # # # ##### # # ##### # # ######### # ####### #########
   #   #   # #     #   #       # # #   # # # #     #     #   #     #   # # # #   #   # # #   #   # #   #   # # #     #         #
 # # # ### # # ### ##### ####### # ### # # # # ### ##### ### # ### # # # # ##### # ### # # # ##### ### # # # # # ### ######### #
 #   #     #     #       #       #   #   #   #   #       #   #G  #   #   #       #     #   #             # #   #   #           #
################################################################################################################################
