################################################################################################################################
#   #   # #   #   #   #           #         #                   #       #         #     #             #       #         # #     
# # ### # # ### # # # ####### ### # ####### ##### ### ##### ### # ####### # # ### # ### ####### # ### ### # # # ####### # # # ##
# #     # # #   #   #       # # #   #     #     # #   #     #   #   #     # #   # #   # #     # # #   #   # # #   #   #   # #   
# ####### # # ############# # # ##### ######### # # ### ####### ### # ##### ### # ### ### ### # # # ### ### # ### # ####### ### 
#     #   #   #   #   #   #   #     # #   #   # # # #   #     # # #   #   #   # #   #     #     # # #   #   #   #       #   # # 
##### # # ##### # # # # # ####### # # # # # # # # # # # # ### # # ##### # ### # ### ### ##### ### # ##### ##### # ####### ### # 
#     # #       #   #   #         # # # # # # #   # # # # #   #         #     # #       #   # #   #   #   #   #   #     #   # # 
# ##### # # # ####### ####### # ### # # # # ####### # ### ######### # ######### ##### ### # ### ##### # ##### ### # ### ### # # 
# #     # # #   #   # #   # # #   #   # # #     #   #     #   #     # #     #   #     #   # #   #   #   #     #   #   # #   # # 
# # # ### # ### # ### # # # # ##### ### ####### # ##### ### # # ##### # ### # ### # ### ### # ### # ##### # ### ##### # # ### # 
# # #   # #   # #     # # #   #   # #   #   #     #   # #   # #   #   #   #   #   # #   #   #     # #     #       #   #     # # 
# # ### ### # # ### ### # ##### # # # ### # ### ### # ### ### ##### ########### ### # ############# # ############# ######### # 
# #   #   # # # #   #   #   #   # # # #   #     #   #     # # #   #   #     #   #   #               #     #   #     #   # #   # 
# ####### # # # # # # ##### # ### # # # ##### ### ######### # # # ##### ### # ######################### ### # # ##### # # # ### 
#       # # # # # # #     # # #         #     #   #         # # #     #   #   #       #   #       #   # #   #   #     #   # #   
####### ### # # # ######### # ############# # # ### ##### ### # ##### ######### ##### # # # ##### # # # # ########### ##### ### 
#     #     # # #     #     #       #     # # #   #   #   #   # #   #   #       #     # # # #   #   # # # #           #   #     
### # ##### ### # ##### ########### # ### # # ### # ### ### ### # # ### # ####### ##### # # ### ##### # # # # ####### # # ######
#   #   #   #   #   #   #       #   # # # # # #   # #   #   # #   # # #   #   #   #   # # #     #   #   # # #     #   # #       
# ##### # ### ##### # ### ##### # ### # # ### # ##### # # ### ##### # ##### # # ##### # ####### ### ##### ####### # ### ####### 
#   # #   #   #     #   #     # #   #   #   # #     # # #   #     # # #   # # #   #   #                       # # #   #   #     
# # # ##### ### # ##### # ### # ### ####### ####### # # ### ##### # # ### # # ### # ####### ####### ### ##### # # ### ### # ####
# # # #   # #   # #     #   # #   #       #         # #   #     # # # #   # #   # #         #     # #   #   # #   #   #   #     
# # # # # # # ##### ####### # ### ####### ########### # ####### # # # # ### # ### ####### ### ### ### # # # # ##### ### ####### 
# #   # #   # #     #   # # # #           #     #   # # #       #   # # # # #   #   # #   #   # #   # # # # #   #   #   #   #   
# ##### ##### # ##### # # # # ####### ##### ### # # ### # ########### # # # ### ### # # ### ### ### # ### # ### # ### ##### # ##
#     #   #   # #     # #   #     #   #   #   #   #   # #   #   # #   #     # #   # # # #   #     # # #   # #       #     # #   
# ### ### ##### # ##### ### ##### ##### # ########### # ### # # # # ####### # # ### # # # ##### ### # # ### # ########### # ### 
#   #   # #   # # #     #       # #     #       #   # #   # # #       #   #   # #   #   #     # #   # # #   # #       #   #   # 
####### # # # # # # ########### # # ##### ##### ### # ### # ######### # # ### ### ########### # # ### # # ### # ### # # ### # ##
#   #   # # # #   #       #     #   #   #     #   #   #   #       #     #   # #   #     #   # # #   # # # #   #   # # #     #   
# # # ### # # ########### # ### ##### # ### ##### ### # ######### ######### # # ##### # # ### # ### ### # # ##### # ########### 
# #   #   # #             # #   #     #   # #   #   # #       #   #   #   #       #   # #   # #         # # #     #           # 
# ##### ### ############### ##### ####### ### # ### # # # ##### ### # # # ####### # ### ### # ########### # # ######### ####### 
#     #   #             # #     # #     #     #     #   #     #     # # #     #   # #   #   #         #   #   #       #         
######### ############# # ##### # # ################# ####### ####### # ##### # ### # ##### ######### # ### ### ##### ##########
#   #   #             # #       # #                         # #   # #   #   # #   # # #   #     #   # #       # #       #       
# # # # # ##### # ### # ######### # ### ########### ####### ### # # ##### ### ### # # ### ##### # # ### ##### ### ##### # # ### 
# #   #   #     #   # #   #   #   #   #           # # #     #   # #         # # #   #   #     # # # #   #   #   #     #   # # # 
# ################### ### # # # ##### ########### # # # ### # ### ######### # # ####### ##### # # # # ### # ### ##### ### # # # 
# #                 #   #   # # #     # #         # #   #   #   #   #       # #         #         #   #   #   # #   # #   # # # 
# ################# ######### # # ### # # ######### ##### # ### ### # ### ### # ######### ########### # ##### # # # # ##### # # 
#   #         #   # #   #   #   #   # #   #     #     #   #   #   # # #   #                 #       # # # #   # # # #     #   # 
# # # # ##### # ### # # ### ##### # ##### # ### ##### # ### ##### # # # ### ####### ####### # ##### ### # # ### ### ##### ##### 
# #   #   #   #   #   #   #       #   #   #   # #     # #       # # # #     #     # #   #   # #   #     # #   #     #     #     
# ####### # ##### ####### ##### ##### ######### # ##### # ##### # # # ##### # ### ### # # # # # # ####### ### ############# ### 
#     #   #           #   #   # #   # #     #   # #     #     # # # # #   # #   #   # # # # #   # #       # # #       #   #   # 
# ### # ##### ######### ### # # # # ### # ### ### # ########### # # ### # # ### ### # # # ####### # ####### # ####### # # ### # 
#   # #     #   #       #   # # # # #   #   # #   #   #   #   # # # #   # #   #   # # # # #     # #         #     # # # #     # 
# # ####### # ### ########### # # ### ##### # # ##### # # # # # # # # ### # ##### # # # # # # ### # ############# # # # ####### 
# #   #     # #   #   #     # # #   #     #   #     # # # # # # # #   # # # #     #   # #   # #               # # # # #   #   # 
# ### # ### ### ### ### ### # # ### ##### ##### ### # # # # # # # ##### # # # ######### # ##### ########### # # # # # ##### # # 
# # # # #   #   #     #   # # #   #   #   #   #   # #   #   # # #     #     #     #     #   #   #     #     #   # # #       # # 
# # # # ##### ### ### ##### # # # ### # ### # ##### ######### ######### ######### # ####### # ### ### ########### # ######### # 
# # # # #     #     #       #   #   # #     # #   #   #   #   #       # #       # # #       # # # #   #         # #     #   # # 
# # # # # ####### ####### ### ####### ####### # # # # # # ##### ##### # # ##### # # ##### ### # # # ### ####### # # ##### # # # 
#   # # # #     # #     #     #     # # #   # # # # #   #     # #   # # # # #   # #     # #   # # #   #   #   #   # #     #  G# 
##### # # # ### # # ### # # ### ### # # # # # # # # ######### # ### # # # # # ### ##### ### ### # ### ### # ####### # ######### 
#     # # #   # # # #   # # #   # #   #   # #   # #   #   #   #   #   # # # #     # #   #   # #   #   #   #   #     #     # #   
# ##### # ### # # # # ### # # ### ##### ### ##### ### # # # ##### ##### # # ####### # ### ### ##### ### ##### # ######### # # ##
# #   #   #   #   # # #   # # #       # # # #   #   # # #   #   # #   # #   #   #   # # # #   #   #   # # #   #     #     # #   
# # # ##### ####### # # ##### ####### # # # # # ### # # ##### # # # ### ####### # ### # # # ##### ### # # # ### ### # ##### ### 
#   # #   #   #   # # #       #         #   # #     # # #     #   #   #     #   # # #   # #     #   #   # # # # # # # #       # 
# ### # # # ### # ### ####### # ##### ####### ######### # ########### ##### # ### # ### # ##### ### ##### # # # # # # ### ### # 
#   #   # # #   #     #     #   #   #   #     #         #     #       #     #       #   #   # #   # #   #   #   #   #   #   # # 
# ####### # # ######### ### ##### # ### # ##### ####### ##### ### ### # ##### ####### ##### # ### # # ### ### ######### ### # # 
# #   # # #   # #         #     # #   # #     #       # #   #   # # # #     #   #     #   # #           #   #     #   #   # # # 
# # # # # # ### # ############# # ### ####### # ##### # # # ### # # # ##### ### # ####### # ########### ### # ##### # ### # # # 
# # #   # #         #     #   # # # #         #   #   #   #   # #   #     #     #         # #     #   #       #     #     # #   
# # ### # ######### # ### # # # # # ############### ####### ### ######### # ##### ####### # # ### # # ### ##### ########### ####
# #   # #         #   # # # #   # #       # #     #   #   #   # #       #   #     #     # # #   # # #     #     #   #   #       
# ##### ######### ### # # # ##### ####### # # ### ### # # ### # # ##### ### # ##### ### # # ### ### ##### # ####### # # # ##### 
# #     #   #   #   #   # #     # #         # #   #   # # #   #   #   #       #   # #   # # #       # #   # #         # # #   # 
# # ##### # # ##### ### # # ##### ######### # ##### ### ### # ##### # ##### ### # # ####### # ####### # ### # ########### ### # 
# # #     #   #     # # # # #     #     #   #       #   #   #   #   # #   #     # #       # # #   #   # # # #     #           # 
# # # ######### ##### # # ### ##### ### # # ######### ### ####### ### # # ### ########### # ### # # ### # # # ### # ####### ### 
#   # #         #       #     #     #   # # #       # #         #   # #S#   # #     # #   #   # # #       # #   #   # #   #   # 
# ### # ######### # ########### # ### ### # # ##### # # ####### ##### ##### # # ### # # ##### # # ##### ### # # ##### # # ##### 
# # #   #     # # # #   #   #   # # #     # # # #   # #     #   #   # #     #     #   #   #   # #     # #   # #     #   # #     
# # ##### ### # # # # # ### ##### # ####### # # # ### ####### ### # # # ##### ### ####### # ######### # # ### ##### ##### # ### 
#   #   # #   #   #   #   #       #   #   #   #   # #         #   # #           # #       #       # # #       #     #   #   #   
# ### # ### ##### ####### ######### # # # ##### ### ######### # ### # ##### # # ### ############# # # # ############### ####### 
#   # #   #     #       #         # #   # #   #               #   #     #   # #           #       # # #   #       #     #       
# # # ### ##### # ### # ######### ####### ### ####### # ##### ####### # # ################# ####### # # ### ##### # ####### ####
# # # #   #         # # #   #   #       # #           # #   #   #   # # #   #               #     #     #   #   # #         #   
# # # # ### # ##### ### ### # # ####### # # # # ####### # # ### # # # # ##### ############### ### ### ### ##### # ########### # 
# # # # #   # #   #   #       #   #   # # # # #     #   # #   # # #   #       #       #         #   # #   #     #             # 
# # ### ##### # # ### ####### ### # # # # # # ####### # # ### ### ############# ##### # ########### # # ### ################### 
# #     #   # # #   # #   # #   #   # # #   #   #     # #   #     #   #     # #   #   # #     #     #     #   #     #     #     
# # ##### # # # ### # # # # ### ##### # ### ##### ##### ### ######### # ### # ### # ### # ##### ######### ### # # # # ### # ####
# #       # # # # # # # # #     #   # #   # #   #   #     # #   #   # # # # #     # #   #     #     #   #   #   # #   #   #     
# ##### # # # # # # ### # ####### # ##### # # # ### ####### ### # # # # # # # ##### # ####### ##### # # ### # ### ####### ##### 
# #   # # #   #   # #   #   #     # #     # # #   #       #     # #   #   # # #   # # #   # #     # # #   # #   #       # #     
# # # # # ####### # # ##### # ##### # ### ### ### ####### ####### ######### ### # # # # # # ##### # ##### # ### ##### # ### ####
# # # # # #     # # # #   #   #   # # #   #   # #     #         #   #       #   # # # # #       #   #     # #   #   # #   #     
# # # # # # ### # # # # # ##### # # # ### # ### ##### # ##### ### # # ####### ### # # ### ##### ##### ##### # ##### ##### ##### 
# # # # # # # #   #   # # #     # # #   # #     #     # #   # #   #   #   #     #       #     #       #       #   #           # 
# # # ### # # ########### ### ##### ### ####### # ##### # # ### ######### ############# # ### # ##### # # ##### # ####### ##### 
#   #   #   #     #           #   #   # #       # #   #   #     #       # #   #       # # #   #     #   #       # #     #   #   
####### ##### ### # ########### # ### # # ####### # # # ############### # # # # ##### # # # ### ### ############# # ### # # # # 
#     # #   #   #   #           #     #   #     #   # #         #   # # #   #   #   # # # #   #   #   #         # # #   # # # # 
# ### # # # ### ##### ##################### ### ##### ### ##### # # # # ######### # # # # ### ### ### ######### # # # ### ### # 
#   #   # #         #   #     #               # #   #   # #     # # # # #         #   #     #   #   #         #   # #   # #   # 
### ####### ####### ### ##### # ##### ####### # # # ### # # ####### # # # ############# ##### # ############# ##### ### # # ### 
# # # #   # #     # #   #     # #   #       # #   #   # # # #       # # #     #         #   # #     #     # #   #   #     # #   
# # # # # # # ### # # ### ##### # ######### # ##### # # # # # ####### # ##### # ##### # # # # ##### # ### # ### # # ### ### # ##
#   # # # # # # #   #     #           #     # #   # # # # #   #   #     #   # #   # # #   # # #     # #   #     # # #   #   #   
##### # ### # # ### ####### ########### ####### # ### # # ##### ### ##### # # ### # # ##### # # ### # # ######### # # ### ######
# #   #     # #             #   #     #   #   # #   # # #         # #   # #   #   # # #   # # # #   # #   #       # #   #       
# # ##### ### ########### ### # # ### ##### # # ### # # ####### # # # ### ##### ### # # # # # # ##### ### ######### # # ####### 
#         #   #   #     #     # # # # #     #   # # # # #     # #   #       #       # # # # # #       #   #       # # #     #   
# ####### # ### # # ### ##### ### # # # ######### # ### # ### # # ### ##### # # # ### # ### ########### ### ##### # ##### # # # 
#   #     # # # # # #   # #   #   #   #   #   #   # #   #   # # #       # #   # # #   #     #     #   #     #   # #   # # # # # 
##### ### # # # ### # ### # ### ######### # # ### # # ##### # # ### ### # ##### ### ######### ### # # # ##### # # # # # # # # ##
#   # #   # # # #   # #   #   # #   #   # # #     #   #   # # # # # # # #     #   #   #       # # # # # #     # # # # # # # #   
# # # # # # # # # ### # ##### # # # # # # # ########### # # ### # # # # ##### ### ### # ####### # # # ### ##### # # # # # # ### 
# #   # # #   #   #   # #     # # #   #   #       #   # #   #   # # #   #   #   # #   # #       #   #     #   #   # # #   # #   
# ####### ######### ### # ##### # ############### # # # ##### ### # ##### # ### # # ### # ################# # ##### # ##### # ##
# #       #     #   #     #   # #   #     #     # # #   #     #   #   #   #   #   # #   # #     #       #   # #   # #   #   # # 
# ######### ### # ####### # # # ### # ##### ### # # ##### ##### ##### # ##### ##### # # # # ### # ##### ### # # # # ### ##### # 
#   #     #   #   #     # # # #     # #   #   #   # #     #     #     # #     #   # # # # #   #   #     #   #   #     #     #   
# # # ### ### ##### ### # # # ####### # # ### ### # ### ### ##### ##### # ##### # # # ### ### ########### ##### ####### ### ####
# #   #     #   #   #     # # #     # # # #   #   #   # #       # #     # #     # # #   #   #   #       # #   # #     #   #     
####### ####### ##### # ### # # ### # # # # ### ##### # ####### # # ####### ####### ### ### ### # ##### ### # # # ### ######### 
#       #   # # #   # # #   # # #   # # # #   #     # #   #   #   #       # #       # #     # #   #   #   # # # #   #           
# ######### # # # # ### # ##### # ### # # ### ##### # ### # ############# # # ####### ####### ##### # ### # # ##### ########### 
#             #   #             #       #     #           #                   #                     #       #       #           
