################################################################################################################################
################################################################################################################################
#         #     #       #                     #       #         #               #   #                     #                     
# # ### # ### # # # ### # ####### # ### ##### ### ### ####### # ####### ### # ### # # ### # ####### ### # # ### ############### 
# #   # #     #   #   #   #     # # #   #         #           #   #   #   # # #   #   #   #       # # # # #   # #   #   #       
# ##### ######### ### ##### ### ### # ############# # ########### # # ### # # # ####### ########### # # # ### ### # # ### ######
# # #   #           # #   #   # #   # #       #     # #         # # #     # #         #   #   #   # #   #   #   # # #   #     # 
# # # ### ########### # ##### # # ### # ##### ####### # ######### # ##### # ### ##### ##### # # # # ##### # ### # # ### ##### # 
#   #   # #         # # #   # #   # #   #   #     #   # # #     # # #     # #   #   # #   # #   # # #   # #   #   #   # #   # # 
# ##### # # ##### # # # # ### ##### ####### ##### ##### # # ### # # # ##### # ### # # # # # ##### # # # ############# # # ### # 
# #   # # # #   # # #   # #   #   #   #     #   #   #   # #   # # # # #   # #   # # #   # #   #   #   #   #         # # #     # 
# ### # ### # # ### ##### # ##### # # # ##### # ### # ### ### # # # # # # ####### # ##### ### ##### ##### # ##### # # # # ##### 
# #   #     # #   #     #   #       # #   #   #   #   # # #   #   # # # #       # # #     # #   #   #   # # #   # # #   # #   # 
# # ######### ### ##### ##### ########### # ##### ##### # # ####### # # ####### # # # ### # ### # ### ### # # # # ####### # # # 
# # #   #   #   #       #   #       #     # #   #   # #   # #       # # #     # # # #   #   #   #   #   #   # # #       #   #   
# # # # # ##### ######### # # ##### # ##### # # ### # # ### # # ##### # # # ### ### # # ##### ### # ### ##### # ### ### ####### 
# #   # #     # #   #   # # # #   #   # #   # # #   #       # #   #   # # # #   #     #       #   #           # #   #   #   #   
# ##### ##### # ### # # # # # ### ##### # ### ### ##### ####### # # # # ### # ### ####### ########### ########### ####### # # ##
#     # #   # #     # #   # #     #   # #   #         #       # # # # #   # # #   #     # #   #     #   #       # #       # #   
# ##### # # # ####### ##### ##### ### # ### ######### ####### ### # ##### # # # ### ### ### # # ### ##### ##### ### ########### 
#     # # #   #       #   #     #   #     # #     # #   #   #     # #     #   # #   # #     #   # #       #   #   #     #       
# ### # # ### # ####### # # ####### ##### # # ### # ### # # ### ##### ##### ### # ### ########### ######### ##### ##### # ##### 
#   #   # #     #       # #               #   # # #     # #     #   # # #   #   # #   #                 #                 #     
# ####### # ##### ####### ####### ####### ##### # ### ##### # ### # # # # ### # # # ### ### ### # # ### # ### ############# ### 
#   #     # #   #   #   #   #     #   #         #   # #   # # #   #   #   #   # #   # #   # # # # #   #   #   #         #   # # 
# # # ##### # # ### # # ### ####### # # ####### ### # # # ### # ####### ##### # ##### ### # # # # ######### ### ####### # ### # 
# # # #   # # #   # # # # #       # # #   #     #   #   # #   # # #   #       #   # #     #   # # # #   #   #   # #   # # #   # 
# # ### # # # ### # ### # ####### # # ##### ##### ####### # ### # # ######### # # # ##### ##### # # # # # ### ### # # # # # ### 
# #   # # # # # #   #   #       # # #   #   #   # #   # # # #   #             # #     #   #   # #   # # #   #   # # # # # #   # 
# ### ### # # # ##### ### ####### # ### # ##### # # # # # ### ########### # ### ##### # # # # # ##### # ##### # # # # # ### # # 
# # # #   # # #   # #   #   #     #   # # #     #   #   #   #     #   #   #   # #   #   # # # #     # #     # # # # #   #   #   
# # # # ##### ### # ### ### # ####### # # # ############### # ### # # ### ##### # # ####### # ### # # ##### ### # # ##### ######
#   #   #     #         #   #       # # #   #       #       #   #   #   #   #   # # #       # # # # #   # #     # # #   #     # 
# ####### ############# # # ####### ### # ### ### ### ######### ####### ### # ### # # ####### # # # ### # ####### # # # ##### # 
#       # #   #   #   #   # #     #   # # #   #   #   #       #       # #   # #   # # # #     #   # #   #   #         #     #   
# # # ### # # # # # # ##### # ### ### # # # ### ### ### ### # # # ##### # ### # ### # # # ##### ##### ##### # ############# ### 
# # #   # # #   #   # #   #   # # # #   # #   #   # #   #   #   #   #   # #   # #   #   #     # #   # #       #     #     # #   
### # # # # ######### # ####### # # ##### ### ### # # ### ########### ### # ##### ##### ##### ### # # # ####### ### ### ### # ##
#   # #   #   #     # # #         #   #     # # #   #   # # #   #   # #   #       #   #   # #     # # #   #     #     # #   #   
# ####### ### ##### # # # ######### ### ##### # ####### # # # # # # # # # ######### ##### # ######### ### # ######### # # ##### 
# #     #   # #     # # #     #   # #   #   # #         #   # #   #   # #   #   #   #     #       #   #   #         # #         
# # ### # ### # ##### # ##### ### # # ### # # # ####### ##### ########### # # # # ### ####### ### # ##### ########### ######### 
#   # # #   # #       #   # # #   #     # # # #       #     #     #     # #   #   # # #       # #   #   #         #   #   #     
# ### # ### # ######### # # # # ### ##### # # # ##### ########### ##### # ### ##### # ### ##### ##### # ########### ### # # ####
# #   #   # #       #   #   # # #       # # # #   # #           # #     #   #       #     #     #   # # #         # #   # # #   
# # # ### # ####### # ####### # # ##### # # # ### # ####### ### # # ####### # # ############# ### # # # # ####### # ##### # # # 
# # # #   #         #   #     # # #   #   # #   # # #     #   # # #         # #               #   #   # # #       #   #   # # # 
# # # # ### ######### # # ##### # # # ##### ### # # # ### # # # # ########### ####### # # ##### ####### ### ######### # ### # # 
#   # # #             # # #   #   # #     # #   #   # #   # # # # #         #   #   # # # #   # #     #     #         # #   # # 
# ##### ##### ######### # # # # ### ##### # # ### ### # ##### # # ##### # # ### # # # # ### # # ### ######### ##### ### # ### # 
# #     #   # #         #   # #     #     # # # # #   # #   # # #     # # #     # #   #   # # #   #               #       # # # 
# # ##### # # # ### ######### # ############# # # # ##### # ### ##### ### ####### ####### # # ### ##### ### ##### ##### ### # # 
# #     # # # #   # #     #   # #   #   #     #   #     # #     #   #   #   #   # #     # # # #   #   # #   #   # #   #     # # 
# ##### # # # ### ### ### # ### # ### # # ####### ##### # ####### # ### ### # # # # ### # ### # ### # # ##### ### # # # ### ### 
#     # # # # # # #     #         #   # #   #         #   # #     #   # #   # #   # # # #   # #     # #   #   #   # # # # #     
# # ### # # # # # # ######### ### # ### ### # # ########### # ####### # # ### ### # # # ### # ####### # # # ### ### # # # ######
# #   # # # #   #   #       #   # # #     # # #   #         #   #     # # #   #   #   #   #   #   #   # # #     #   # #   #   # 
##### # ### ######### ##### # # # # # ##### # ### # ########### ##### # ### ### ######### ##### # # ### # ### ### ### # ### # # 
#   # #   # #         #     # # # # #   #   #   # #         #   #   # # #   #   #   #     #   # # #   # # #   #     # #     # # 
# ### ### # # ##### ### ##### # ### ##### ### # # ######### # ### # # # # ####### # # ##### # # # ### # # ##### ##### # ##### # 
#       #   # #   #   #   #   #   # #   # # # # #     #     #     # #   # #     # # # #     # # #       #     #   #   # #   # # 
### ######### # # ####### # ##### # # # # # # ##### ### ########### ##### # ### # # # # ##### # ##### ####### ### # ### # # # # 
#   #     #   # # #   #   #     #   # #   #   #   #       # #       #     #   #   # #   #   #   #   #     #   #   #   #   # # # 
##### ### # ##### # # # ####### ##### ######### # ####### # # ####### # # ### ##### ##### ####### # # ### ##### ##### # ### # # 
#     #   # #     # #   # #         # #   #   # #       #   # #       # #         #       #       # # #   #   # #     #   # #   
# ##### ### # ##### ##### # ##### # # # # # # # # ##### ##### # ### ################### ### ####### # # ### # # # ####### # ####
#     #     # #     #       #   # # #   #   # # # #   #       #   # #     #     #     # #   #       # # #   #   #       # #     
##### ####### # ############# # ### ######### # ### # ######### # # # # ### ### # ### ### ### ####### # # ########### # ### ### 
#   # #   #   #         #     #     #     #   #   # # #       # # # # # #   # # #   #   # #   #     # # # #         # #   # #   
# ### # ### ########### ### # ########### # ### # ### # ### # ### # ### # ### # ### ### # # ##### # # # # # ####### ##### # ### 
# #   #   #       #   #   # #   #         #   # #   # #   # #     #     # #   #     # # # #       # # #   #     #   #     #   # 
# # ##### ####### # # ### # ### # ####### ### ##### # ### # ##### ####### # ######### # # ######### # ######### # ### ####### # 
#   #           #   #     #   # #   #   # #   #   #   # # # #   #       # #       #   #   #         #     #   # # #   #       # 
# ####### ##### ########### ### # ### # # # ### # ##### # # ### # ### # # ####### # ####### ############# # ### # # ### ### ####
# #     # # #   #     #   # #   # #   # # # #   #     #   # #   # # # # #       #   #     # #     #   #   #   # # # #   # #     
# ### # # # # ### ### # ### # ### # ### # # # ####### ### # # ### # # # ####### # ##### ### # ##### # # ##### # # # # ### ##### 
#     # # # #   #   # #     #     # #   # #   # #     #   # # #   # # # #   #   # #     #   #       #   #   # # #   #     #     
####### # # ### ### # ##### ####### # ### ##### # ######### # # ### # ### # # ### # ### # ######### ##### ### # ####### ### ####
#       # # #   # # #         # #   # #   #       # #       #   #     #   # # #   #   #       #               #       # # # #   
# ####### # # ### # ######### # # ### ##### ####### # ########### # ### ### # ### ### ####### # ### ######### ####### # # # ### 
#   #   # # #     #   #     #   # #   #     #     # # #       #   # #   # # #   #     #     #   #   #       #     #   #   #   # 
### # # # # ######### # ### # ### # ### ######### # # ####### # ### # ### # ### ##### # ### ####### # ##### ##### # # ##### # # 
#   # #         #     #   # #   # #   # # #     #   #   #   #   #   #     #     #     # #   #       #   # # #     # # #   # #   
# ############# # ### ### # ##### ### # # # ### # ##### ### ##### # ################### # ### ##### ### # # ##### # ### # ######
#         #   #   #     # #   #   # # # #   # #   #   #   #       #   #               # # #   #   # #   # #   # # #     # #     
######### ### ##### ##### ### # ### # # # ### ##### ##### ##### # ### # ############# # # ##### # # # ### ### # # ####### # ### 
#       #   #   #   #     #   # #   # # # #   #         #     # # #   #   #         # # #       # # # #   #   #         #     # 
# # ####### ### # # # ##### ### # # # # # # # # ##### ####### # # ####### ##### ### # ########### # # ### # ##### ############# 
# #       # #     # #   #   # # # # # # #   #   #   # #   #   # #   #   #     #   # #     #   #     #   # #   #   #       #   # 
# ####### # ####### ### # ### # # # # # ####### # # # # # # ### ### # ####### # ### ##### # # # ####### # ### # ### ##### ### # 
# #       #   #     #   #   # # # # #   #       # #   # # # #   # # #         #   #   #   # # # #     # #   # #   #     #   # # 
# ########### # # ### ##### # # ### ############# ### # ### # ### # ########### # ##### ### # # # # ### ### # ######### ### # # 
# #       #   # # #   #   # # #   #     #         #   #     #     #     #     # #       #   # #   #         #         # #   #   
# # ##### # ##### # ### ### # ### ### # # ######### ######### ########### ### # ######### ### ### ######### ########### # ##### 
#   #   # #     # # #   #   #   #   # #   #                       #     #   # # #   #   #   #   # #   #   # #     #     # #   # 
# # # # ####### ### # # # ##### ### ######### # # ####### ### ### # ### ### # # # # # # ### ### # # # # # ### ### # ##### # # ##
# #   #         #   # # # #   # # #         # # # #     # # # #   # #     # # #   # # #     #   # # #   #     # #   #   #   #   
# ############### ### # # # # # # ######### # # # # ### # # # # ### # ##### # ##### # ####### ### # ########### ####### ####### 
# #   #               # # # # #   #   #   # # # # #   # # # # #   # #       # #   #   #             #   #     #   #           # 
# # # # ################# ### ### # # # # # # # ##### # # # # ##### ######### # # ##### ########### ### ##### ### # ########### 
# # #   #   #       #   # #   # # # # # # # # #   #   # #   # #     #   #     # #   #         #   #         #   #   #           
# # ####### # ##### # # # # ### # # # # # # ##### # ### ### # # ####### # ##### ### ##### ### # # ####### # ### # ### ######### 
#   # #     #     #   # # # #     # # # # #   # # # # #   # # # #     # #       #   #   #   #   #       # # #   # #   #       # 
# ### # ######### ####### # ##### # ### ##### # # # # ### # # # # ### # ######### ### # ### ####### ### # # # ### # ### ##### ##
#               # #       # #   #       #     # # #   # # # # #G#   # #       #   #   #     #     #   # # # # #   # #       #   
# ######### ### # # ####### # # ####### # ##### # ### # # ### # ##### ####### # ########### # ### ##### # # # # ### # ######### 
#     #     #   # #   #   #   #       # # #         #   #   # # #     #     # #       #     #   #   #   # # # #   #   # #     # 
# ### ####### ### ### ### ########### # # # ##### ##### ### ### ### ### ### # ####### # ####### ### # ### # # ### ##### # ### # 
# # #       #   #     #               # # # #   # #     # #   #   # #   # # # #   #   # #     # # # # #   # #   # # #   # #   # 
# # ####### ########### ##### ######### # ### # ### ##### ### ### # ##### # # # ### ### # ##### # # # ### ##### # # # ### # ### 
#   #     #     #     # #   #         # #     # #   #   # # # #   # #       #   #   #         #   # #   #     # # #   #   #     
# ### ### # ### ##### # # # ### # # ### ####### # ### # # # # # ### # ######### # ########### # ### # # ##### # # # ### ########
#   #   # # #   #     # # #   # # #     #     # # # # # # # #   # # #   #     # #       #   # # #   # #     #     # #   #       
# # ### # ### ### ##### # ### # # ####### ### # # # # # # # ##### # ### ##### # ####### # # # # # ####### # ##### # # ### ######
# # #   # #   #   #     # #   # # #       # #   # #   # #     #     # # #     #       # # # #   # #     # # #   #   #   # #     
# # # ### # ### ####### # ##### ### ####### ##### ##### ##### # ##### # # ########### # ### # ### # ### ### # # ##### # # # ### 
# # #   # # #   #       #     #             #     #   #     # #   #     # #           #   # #   #     #   #   # #   # #   #   # 
### ### ### # ######### ##### ####### # ##### # # # # ##### # ### # ##### ########### ### # # ##### # ### ##### # # ##### # ### 
#   # #     #         #     #       # #       # #   #       # #   # #   #   #       #   #   #     # # # # #   # # #     # # #   
# ### ############### ### # ####### # ##### ### ### ##### ### # ### ### ### # ##### # ####### ### ### # # # # # # ##### # # # ##
#     #       #     #   # #     #   # #   # # #   # #   #               # #   #   # #   # #   #   #   # # # # # #     # # # #   
# ########### # # ##### # ####### ### # # # # ### ### # ##### ##### ##### ##### ### ### # # ### ### ### # # # ##### ### # # ### 
# #         #   #     # #       # #     # # #   #     #     # #   #                 # # #   #   #       #   #   #   #   # # #   
# # ####### # ##### ### # ##### # ####### # ### ########### ### # ##### ############# # # ### ### # ########### # ### ##### # ##
# #   #     # #     #   #   #   #   #   # #   #   #   #   #   # #     # #     #   #   # # # # #   #     #   #   # #   #     #   
# ##### ##### # ##### ##### # ##### # # # # ##### # # # # ### ####### # # ### # # # # # # # # # ##### ### # # ### # ### ####### 
#             #             #       # #   #         #   #   #         #     #   #   #     #   #     #S    # #     #     #       
################################################################################################################################
