################################################################################################################################
################################################################################################################################
 #   #         # #     #   #           #         #                                 #               #           #     #       # #
 # # # ### ### # # ### # ### ####### # # ### # # # # ########### # ######### ### # # ### ### # ### # ######### # ### # ##### # #
   # # # #   # # # #   #       #     #   #   # #   #           # #       #   #   # #   #   # #   # # #         #   #   # #   # #
#### # # ### # # # # ######### # ##### ### ### ############### # ####### ######### ### ### ### # ### # ################# # ### #
     # #     #   # #         # # #       #   #           #   # #       # #       #   #   #   # #   # #         #     # #   #   #
 ##### ########### ######### ### # ##### ### # # ######### # # ####### ### ##### # # ### ### # ### ########### # ### # # ### # #
   #   #   #     #   #     #     #     # # # # # #   #     # # #     #     #   # # #     # # #   #     #       #   # # #     # #
## # ##### # ### ### ##### ############# # # # ### # # ##### # # ### ### ##### # ### ##### # # ##### # # ####### # # # ####### #
 # #       # # #   #     #   #   #     #   # #     # # #   #   # # #   # #   # #   # #   #   #     # # # #       # # #         #
 # # ####### # ######### ### # # # ### ##### ######### # ####### # ### # ### # ### ### # ##### ### # ### # ####### # # #########
 # #       # #   #     #   #   #   # # #   #       #   #     #   #     #     #   #     # #     # # #     #   #   # # #   #     #
 # # ##### # ### # ### # # ######### # # # ####### # ####### # ######### ####### ####### ### ### # ######### # # # # ### # ### #
 # #     # # # # # # # # #   #     # #   #         # #     #           #               #   # #   # #   #   # # # # #   # # #   #
 # ##### ### # # # # # ##### ### # # ############### # ### ########### # ##### ##### ##### # # ### ### # # ### # # ### # # ### #
   #     #       # # #       #   #                 #   # #   #   #   # # #   # #   #     # #   # #     # #   # # # # # #   #   #
 ##### ### ####### # ######### ##### # ##### ########### ### # ### ### # ### # # # ##### # # ### ########### ### # # # ##### # #
 #   #     #     # # #         #     # #     #       #     # #         #     #   #     # # #                 #   #   #   #   # #
 # # ### ### ### # # # # # ### # ##### # ##### ##### # ##### # ####### ############### ### # ######### ### ### ######### # ### #
 # #   #   # # #   #   # #   # #   #   #   # # #     # #     # #     #             #   #   #         #   #   # # #     # # #   #
 # ### ### # # ##### ####### # ##### ##### # # ##### # # ####### ### ############# # ### ############### # # # # # ### # # # ###
 # # #     # # #     #       #   #   #     # #     #   #     #   # #   #           #   #       #       # # #       #   #   #   #
 # # ##### # # ##### # ########### ### ##### ##### ### ##### # ### ### # ##################### # ##### # # ##### ### ######### #
 # #   # # #   #   # #   #       #   #   #       # #       # # # # #   #         #             #     #   #     #   #     #   # #
 # ### # # ##### # # ### # ##### ### ### # ### # # ####### # # # # # ########### ### ############# # ######### # ####### # # # #
 #   # # # #   # # #   # # #   # #   # # # #   # # #   #   #   # # #     #     #     #     #     # # # #   #   #       #   # # #
 ### # # # # ### # ##### # ### # # ### # ### ### # # # # ####### # ##### # ### # ##### ### # ### # # # # # # ####### # ##### # #
     # # # #     #       #   # #   # # #     # # # # # #       #       #     # # #   # #   # #   # # #   # #       # #     # # #
###### # # ####### ######### # ##### # ####### # # # # ####### ####### ####### ### # # ##### # ### # ### ######### # # ### # # #
         # #     # #         #       #     #     # # # #       #   #     # #   #   #   #  G# # #   #   #           # #   # #   #
 # ####### # ### ### ############### ##### # ##### # ### ####### # # ### # # ### ####### # # # ### ### ############# ### # #####
 # #     # #   #     #     #           #   #   # # #   # #   #   # #   #   #   #         # # #   # #   #             #   # #   #
## # ### # # # ####### ### # ######### # ##### # # ### # # # # ### # # ### ### ########### # ### ### ##### # ### ##### ### ### #
   # #   # # # #       # # #   #     # #     # # #     #   # # #   # #   # #       #       #   #   #     # #   # #   #   #   # #
 ### # ### ### # ####### # # ### ### # ##### # # ########### ### ### ##### # ####### ######### ### ##### # ### ### # ### ### # #
     #   #     # #     # # # #   # #       # #           #   #   #     #   #         #       #   #   #   # #   #   #     #   # #
 ############### # ### # # ### ### ####### # ########### # ### ####### # # ################# ### ### # ### # ### ######### ### #
 #     #     #   # #   # #     # # #       #     # #   # # # #   #     # # #                   # #   # #   # #   #             #
 ### ### ### # ##### ### ####### # # ########### # # # # # # ### # ##### # # ### # ########### # # ### # # # # ####### # # #####
   # #   #   #       #   #     #   #           #   # # # # #   # # #     # #   # # #           # #     # # # # #   #   # #     #
## # # ### ########### # # ### # ############# ### # ### # # # # ### ##### ##### # # ######### # ####### ### # # # # ### #######
 #   #   # #           # #   # # #           # #         # # # # #   #   #       # # #     # # # #   #   #   #   # #   #   #   #
 # ####### # ########### ### ### ### ####### # ### ##### # # ### # # # # ### ##### # ##### # # # ### # ### # ##### ### ### # # #
 # #       #   #     # #   #   #     #     #       #     # #       # # # #   #     #     #   # #     # #   #     #   #   # # # #
 # # ######### ##### # ### ### ##### # ### # ####### ### # ### ##### # # ##### ######### # ### ######### ### ####### ### # # # #
 # #       # #     #   #     # #     #   # # #     #   # #   # #   # # #       #         #   # #   #   # #   #     # #   #   # #
 # ####### # ##### ### # ##### # # # ### # ### ### ##### ### ### # # # ####### # ######### # # # ### # # # ### ### # ######### #
         #     #   #   #   #   # # # # # # #   # # # #   # # #   # # # # #   # # #       # # # # #   # # # #   #     #       # #
 ####### ##### # ##### ### # ### # # # # ### ### # # # ### # # ### ### # # # # # # ####### ### # # ### # ### # ##### # ##### # #
 #     #     # #       #   #     # #   #     #   # # #     #   # # #   #   #   # # #     #   # # # # #   #   # #   # #     # # #
 # ### # ### # ####### ######### # # ######### # # # ##### ##### # # # ######### # ### # ### # # # # ### # # ### # ####### # # #
 # #   # #   #       #           # #   #   #   #   #             #   # #       # #     # #       #   #   # # #   # #       # # #
## ####### # ####### ### ##### # # ### ### # ####### # ######### ##### # ##### # ####### # ##### ##### # # ### ### # ####### # #
   #   #   # # #     #   #     # #   #     #     #   #   #             #     # # # #       #   #   #   # # #   #   #   # #   # #
 ### # # ### # # ####### # ### # ### ##### ##### # ##### # # ##### # # ####### # # # ####### # # ### ### # # ### ##### # # #####
     #   #   # #   #     # #   #   # #   #     # # #     # # #     # #   #   # # #   #     # # # #   #   #   # #     #   # #   #
########## ### ### ### ### # ### # # # # ####### # # ##### ### ##### ##### # # # ##### ### ### # # ### ####### ##### ### # ### #
         #     # #     #   # #   # #   # #   #   # # # #   #   #       #   # #   #   #   #   # # # #               #     # #   #
 ####### ##### # ### ### ##### # ####### # # # ##### # # # # ########### ### ##### # ### ### # # # ######### # ########### # ###
   #   # #     #     #   #     # #   #   # # #     #   # # #   #       # #     #   #   # # # #   #   #   #   #         #   # # #
 # # # # # ####### # # ### ##### # # # ### # ##### ### # ##### # ##### # ##### # ##### # # # # ##### # ### ####### ### # ### # #
 #   # # # #       # #   #   #   # #   #   #     #   # #     # # #   # #   # # # #   #   # # #     # #     #     #   # #   #   #
###### # # ### ##### ### ### ##### ### # ##### # ### ##### ### # # ### ### # # ### # ##### # # ### # ######### # ### # ### ### #
   #   #       #       #   #     #   # #   # # # # # #     #   # #       #   #     #   # #   #   # # #       # # #   #   #   # #
 ### # ######### ##### # # ##### ### ##### # # # # # # ##### ### ####### ############# # # ##### # # # ##### # # # ##### # # # #
 #   # #       # #     # #     #   #     # # # # # # #   #   # #     # # #   #         #   # #   # # # #   # # # # #   # # # # #
 # ### # ##### ### ##### ### # ### ### ### # # # # # ### # ### ##### # # # # # ##### ### ### # ##### # # # ### # # # ### # ### #
   #   #   # #   #     #   # #   # # #       # #   #     #       #   #     # # #   # #   #   # #     # # # #   #   #     #     #
#### # ### # ### ##### ### ### ### # ######### # ################# ######### # # # # ### # ### # ##### # # # ########### #######
     #   # #   #   # # #   #   #   #     #     # #   #   #   #   # #       # # # # #   # #   # # #   #   #   #   #         #   #
 ### ##### # ##### # # # ### ### ##### # # ##### ### # ### # # # # # ##### # ### # ### # # # # # # # ######### ### # ### # # # #
 #   # #   # #     #   # #   # # #   # # #     #     #     # # # # # #   # # #   # # #     #   # # # #       #     # #   #   # #
 # # # # ### # ######### # # # # # # # ####### # ##### ####### # # # # ### # # ### # # ######### ### # ######### ### # ### #####
 # #   #   # #   #   #   # # # #   # #   #   # #   #   #       #   # # #   #   #   #   #         #   # # #       #   #   # #   #
 # ####### # ### # # # ### # # ##### ### ### # ### # # # # ######### # # ####### ##### # ######### ### # # # ### # # ### ### # #
 #       # #       # # # # #   # #   # #     #   #   # # # #     #   # # #     #     # # #   #   # #   #   # #   # #   #   # # #
 ####### # ######### # # # ##### # ### # ####### ##### # ### ##### ### # # ### ##### # # ### # ### # ####### ##### # ##### # # #
   #   # #       # #   #   #     # # #   #     #   #   #     # #   # #   # # # #   #   #   # #   # #       # #     #     #   # #
 ### # # ####### # ####### # ### # # # ### ### ### ########### # ### ##### # # # # ### ### # ### # ####### # # ####### # ##### #
 #   # #       #   #         #   # #         # #   #     #     #       #   #   # #   #   #   #         # # # #   #   # # # #   #
 # ##### # # ############# ####### ######### # # # # ### # # ######### ### # ### ### # # ##### ##### # # # # ### # ### # # # ###
 # #     # # #     #     # #       #       # # # # # #   # #       # #   # #   # #     #   #   #     #   #     # #     #   # # #
## # ##### ### ### # ### # # ####### ##### # # # ### ##### ####### # ### # ### # # ##### ### ### ####### ### ### ####### ### # #
   # # #   #     # # #   # # #     # # #   # # #   #   #   # #   # #   #   # # # # #   #   # #   # #         #   #         # # #
 ### # # ### ##### # # ##### ##### # # # ### ##### ### # ### # # # ### ##### # # # # # ### # # ### # ##### ### ######### # # # #
 #   # #     #     # #     #     # #   #   # #   #     #   #   # #   # #     #   # # #   #   #   # #     #   #     #     # #   #
 # ### ####### ##### ##### ##### # ####### # # # ######### ##### ### # # ### ####### ### ####### # ##### ### ##### ##### # #####
 #   #         #     #   #     # #           # # #               #   # # # # #       # #         #     #   #     #     # #     #
 ### # ####### # ##### ####### # ### ######### # ##### ##### ##### ### # # # # ####### ############### ############### # # ### #
   # # #     # # #     #     # #   # #   #   # #   #   #   # #   #     # #   #   #   #   #   #   #     # #     #       # #   # #
## # # # ### ### # ### # ##### ### # # # # # ##### ### # # ### # ### ### ####### # # # ### # ### # ##### # ### # ########### # #
 #   # # # #     #   #   # #   #   # # # # #     #     # #     #   # #         # # #       #   # #   #   #   #   # #       # # #
 ##### # # ######### ##### # ### ### # # # ##### ##### # ######### # # ######### ##### ####### # ### # # ### ##### # ##### # # #
     # #   #     #   #     #     #   # #   #   #   #   #   #   # # #   #       #     #       # #   # # #   # #   #   #   #   # #
 ### # ######### # ### ########### # # ####### ### # ##### ### # # ##### ##### ##### # ##### # # ### ##### # ### ##### ####### #
 # #             # #   #       #   #   #         # # #   # #   # # #     #   #     # #   #   #   #   #     #   #     #         #
 # # ####### # ### # ##### ##### # # ### ######### # # # # # ### # # ####### ##### # # ### ### ### ### ####### ##### ###########
 #   #   #   #     # #     #     # #         #     # # # #   # #   # # #     #   #   # #   #     #     #     #     #           #
 ##### # ######### # # ##### ##### ########### ##### # ####### # ### # # ##### # ##### # ########### ### ### # ############### #
 #     #   #     # # #     # #   # #   #     #                 #     #     #   # #   # #   #         #   #   #       #     #   #
 # ####### # ### # # # ### # # # # # # # ### ########### # ########### ##### ### # # # ##### ######### ### ####### # # ##### ###
 # #     # #   # #     #   #   # #   #   # #           # # # #       #       # #   # #   #   #   #   #   # #   #   # # #     # #
 # # ### # ### # ##### # ####### ######### ########### # # # # # ### # ####### ##### ### # ### # # # ### # # # # ### # # ##### #
   # #     #   #   #   #       # #   #   # #   #       # #   # # #   # #   #   #   #   # #     # # #   # #   #   #     #   #   #
#### ############# # ### ##### # # # ### # # # # ####### ##### # ##### # # ### # ##### # ####### ##### # ################# ### #
   #       #       #   #     # #   #   #     # # #     # #     #       # #     #   #   #   #   #   #   #                 #   # #
 ######### # ####### # ####### ####### ####### # # ### ### ############# ### ##### # ### # # # ### # ################### ### # #
       # #   #   #   # #             #     #   # #   #     #               #     # # #   #   #                         #     # #
 ##### # ##### # # ### # ##### # ######### ### # ### ####### ####### # ### ####### # # ####################### # # ########### #
     #   #   # # #   # # #     # #   #   #   # #   #     #   #   #   #   #         # # # #     #   #   #   #   # #           # #
 ######### # # # ### # # ##### ### # # ##### # ### ##### # ##### # ### # ########### # # # ### # # # # # # # ####### # ### ### #
 #         # # # #   # # #   #     #   #   # # #     #   #       #   # #       #     #   # # #   #   # # #   #     # #   #     #
 # ######### # # ##### # # # # ######### # # # # ##### ######### ### ########### ####### # # ######### # ##### ### ### # ##### #
 #     #   #   #   #   #   # # #         #   # #       # #   #   #   #   #       #     #             # #     #   #   # #     # #
 ##### # ######### # ####### ### ############# ######### # # # ####### # # ####### ### ### ######### # ######### ### # ##### # #
 #   # #     #   #   #       #   #   #       # #   #   # # # #     #   # # #   #   # #   # #       # #         # #   #     # # #
 # ### # ### # # ##### ####### ### # ####### # # # ### # # ####### # ##### ### ### # ### # # ##### # ######### # # ######### # #
 #     #   # # #       #     #   # # #           # #   #       #   # #     #   #   #   # # #     # #         # # #     #     # #
 ######### ### # ### # # ### ### ### # ####### ### # ####### ### ### # ##### ### ### # # # # ##### ### ####### # ##### # #######
       #       #   #S# # # #     #     #     #   # #       #   #   #   #   # #   #   #   # # #     #   #     # #     # #   #   #
#### # ######### # # ### # ####### ##### ### ### # ####### # # ### ##### ### # ### ####### # # # ####### ### ##### ### # # ### #
   # # #       # # #     # #           #   # #   #       # # # #   #     #   # #   #       # # # #       # #     # #   # # #   #
 # # # # ##### ### ####### ### ####### ##### # ### ####### # # # ### # # # ##### ### ####### # ### ####### ### ### # ### # # ###
 # # # # #   #   #       #   # #   #   #   # # # # #       # #   #   # # # # #   #           #     #     #   #     #   # #   # #
 ### # # # ##### ### # # ### # # # ##### # # # # # # ####### ##### ### # # # # ### ################# # ##### ######### # ##### #
     #   #           # #         #       #   #   #                 #   #                             #     #           #       #
################################################################################################################################
