################################################################################################################################
################################################################################################################################
#         #     #   #         # #     #   #   #     #   #             # #         #   #     #       # #     #         #     #   
# ####### # ### ### # ### ### # # ### # ### # # ##### ### ########### # # # # ### # ### ### # ##### # # ### ######### # ### # # 
# #     #   # #     #   # #   #   # # #   # #   # #   #   # #         #   # #   #       # # # #   #   #   #       # # # #   # # 
# ##### ##### ########### # ####### # ### # ##### # ### ### # ############# ############# # # # # ####### ##### # # # ### ### ##
# #     #     #       #   # #     #     # # #     #     #   # #               #   #   #     # # # #       #   # #   #   #   #   
# # ### ##### # # # # # ### # ### # ### # # # ############# # # ############### # # ### ##### # ### ####### # # ####### ### ### 
# # #       #   # # #   #     # # #   #   # #             # # # #     #         # # #   #     #   # #     # # #     #   #     # 
# # ####### ##### # ########### # # # ##### ####### ##### # # # # ##### ######### # # ### ####### # ##### # # ##### # ### ### # 
# #   # #   #     #             # # #     #         #   # # # #   #     #   # #   #   # # #       #     # # # #   #   #   #   # 
# # # # # ######### ############# # ##### ########### # # # # ##### ##### # # # ### ### # # ########### # # # ### ##### ### ### 
# # # #   #       #   # #       #   #   #         #   # # # #       #     # # # #     #   #           # #   # #           #     
# # # # ### ##### # # # # ##### ### # # ########### ### # # ############### # # ##### ### ########### # ### ### ####### ####### 
# # # # #       # # #   #   # #     # #   #         # #   #           #   # # #   #             #     #   #     #       #       
# ### # ######### ######### # # ##### ### # ######### ######### ### # # # # # ### ### ######### # ####### ####### ####### ##### 
#     #         #   #       #   #   #   # #     #       #       #   # # #       #   # #   #   # # #     #     #         # # #   
############### ### # ####### ### # ##### ##### ####### # # ##### ### # ####### ### # # # # ### # # ### ##### ### ####### # # ##
#           #   #   # #           # # #   #   #       #   #     #   #   #     # #   # # # #       #   #     #   #   #     # #   
# ######### # ##### # ####### ##### # # ### # ####### ### ############# # ### ### ##### # ##### ##### ### ##### ##### ##### ### 
# #         #     #   #     #     #   #     # #     #   #   #         # # # #     #     #     #         # #   #     # #   #   # 
# ############### ### # ### ##### ########### # ### ### ##### ####### # # # ####### ######### ######### # # # ##### ### # # ### 
# #   #         #   # #   #     # # #   #     # # # # #       # #     # #   #     #   # #     #       # # # # #   # #   # #     
# # # # ####### ### # ### ##### # # # # # ##### # # # ######### # ##### ### # ### ### # # ##### ##### # ### # # # # # ### # ####
#   # #   #   # #   # #   #   #     # # #     # # #   #         # #     #   #   # #   # # #   # #   # # #   #   #   #   # #     
# ### ### # ### # ### # ### # ### ### # ##### # # ### ### ####### ##### # ##### # # ### # ### # ### # # # ############# # ##### 
#   #   # # #   #   # #   # #     #   #   # # # #   #   # #       #     #S#     # # #     #   #   # # # # #             # #   # 
### ##### # # ##### ##### # ####### ##### # # # ### ### # # ####### ##### # ##### # # ##### # ### # # # # # ############# # # # 
# # #   #   # # #   #   # #   #   # #   # # #   #     #   # #   # # #     # #   #   #   #   # # # #   # # #   #     #     # # # 
# # # # ##### # # ### # # ### ### # ### # # ####### ##### # # # # # # ##### # ######### # ### # # ##### # ### # ##### ##### # # 
# # # #     # # #     # #   #     #     # #         #   # #   # #   # #     #   #   #   # #   # #       #     # # #   #   # #   
# # # # ### # # ####### ######### ##### ### ##### # # ### ##### ### # ### ##### # # # ### # ### ####### ####### # # ### # ##### 
# #   # #             #   #   # #   #   #   #     #     #   #   #   #   # #   # # # # #   #                   # # #     #   #   
# ### ### ######### ##### # # # ### # ### ### ### ##### ### # ### # ### # # # # # # # # ########### ##### ### # # ######### ### 
# #   #   # #       #   #   # #     # #   #   #   #   #   # #   # # # #   # # # # #   #     #     #     #   # # #         #     
# ### # ### # ##### # ####### ### ### # # # ####### # ### # ### ### # ##### # # # ##### ##### ### # ### ##### # # ### ######### 
#     #     # #             #   #   # # # #   #     #         #   #       # # # # #   # #     # # #   #     #   #   #   #   #   
##### ####### # # ####### # ### ### # # # ### # ############# ### ####### # ### # # # ### ##### # # # ##### # ##### ### # # # ##
#     #       # #   #   # #   #   # #   # #   #   #       #     #   #   #   #   # # #   #     # # # #   #   #     #   # # # #   
# ### # ########### # # # ### ### # ##### # ##### # ##### ##### ### # ### ### ### # ### ##### # # # ### ####### # ### # ### ### 
#   # # #         # # # #   #   # #       #     # #   #   #         #     #   # #   # # #   # #   # # #   #     #     #     #   
### ### ### ##### # # ##### ### # ### ######### # ### ##### ##### ### ##### ### ##### # # # ### ### # ### # ################# ##
#   #   #   #       #     # # # #   # #       # # # #       #   #   #   #   # #       # # #   # #     # # #     #   #       #   
# # # ### ############### # # # ### # # ##### # # # ######### # ### ### # ### # ####### # ### # # ### # # ####### # # ##### ### 
# # #   #   #       #   # # # #       #   #     #   #   #   # #   #   # # #     #       #   #       #   #         #   #   #     
# ##### ##### ##### ### # # # ### ####### ####### ### ### # # ### ### # # # ##### ####### ####### # ####### ############# ######
# #   # #   # # #   #   # # #   # #   #   #     # #   #   # #   #   #       #     #             # #       #     #       #       
# # ### # # # # # ### ### # ### # # # ##### ### # # ### ### ####### # ####### ####### ######### # ####### ### # # ### # ####### 
# #     # # #   #   #     #   # # # #       #   #   #   #   # #   # #                 #   #     #       #   # #   #   #         
# ####### # ### ### ### ##### # # # ######### ##### # ##### # # # # # ####### ######### # ############### # ############# ######
# #       #   # # #   # #     #   # #   #     #   # # #   # #   #     #     #       #   #   #           # #             #       
# # ######### # # # # # # ####### # ### # ##### # ### # # # # ######### ### ####### # ##### # ### ##### ### ########### ####### 
# # #   #     # # # # # #   #     #   # # #     #   # # # #           #   #       #   #   # # #   #   #   # #     #     # #     
# # # # # ### # # ### # ### # # ##### # # # ####### # ### # ######### ### ####### ####### # # # ### # ### # # ### # ##### # ### 
# #   # # #   # #   # #     # #   #   # #   #     # #     # #   #     #   #     #       #   # #     #   # # #   # #     # #   # 
# ##### # ### # ### # ####### ##### ### ##### ##### # ##### # # ##### # ####### ####### ####### ####### # ##### # ##### # ### # 
#     # #   # # # #   #     # #     # # #     #     # #     # #   #   #   #     #   # # #     #   #     # #     # #     #   # # 
### # # ### ### # ##### ### # # ##### # # ### # ####### ### # ### # ##### # ##### # # # # ### # ### ##### # ##### # ####### # # 
#   # # # #     #       # # # #   # # # # #   #   #     #   #   # #     # #   #   #   #   #   # #   #   #   #   #   #   # #   # 
# ##### # ####### ####### # # ### # # # ### ##### # ##### ##### # ####### ### # ########### ##### ### ######### ##### # # ##### 
#     # #         #       # #   # #     #   #     # #     #     # #       #   #     #     #     #   #   # #           #   #     
##### # ### ####### ##### # ##### ##### # ### ##### # ##### ####### ####### ####### # # ####### # # ### # # # ##### # ### ### ##
#     #   #     #   #     #       #   #   #   #   # #     # #   #   #   #   # #   # # # #       # # #   # # # #   # # # #     # 
# ### ### ##### # ### ### ######### # ### # ### # ####### # # # # ### # ### # # # # # ### ######### # ### # ### # ### # ### ### 
#   #   # #     # #   #           # # #   # #   # #     # #   # # #   #   # #   # #   #   #     #   # #   # #   #     #     #   
### # # # # ##### # ### ####### # # # # # # ### # # ### # ##### # # ##### # # ### # ### ### ### # ### # ### # ### ########### ##
#   # # #   #   # #   # #     # # # #   # #     # #   # #       #   #     # #   #   #   #   # # #     # #   #   # #           # 
# ##### ##### # ##### # ##### # # # ##### ####### ### # # ##### ##### ##### ### ##### ### # # # ####### # ##### # # ########### 
#   #       # # #   # #       # # #   #   #   # #     #   #     #   # #   #   #   #   #   #   # #     # #     # # # #     #     
### # ####### # # # ########### # ##### ### # # ########### ### ### # # # ### # ### ### ####### # ##### ##### # ### # ### # ### 
# # # #     # # # #             # #   # #   #     #   #   #   #   # # # #       #   #   #     #               #     #   # #   # 
# # # # ### # # # ####### ####### # # # # ######### # # # # ##### # # ##### ##### ### ### ### ######### ##### ######### # ### # 
#   # #   # # # # #   #   #     #   #     #   #   # #   # # #   #   #   #   #   # #   #   #             #   #   #       # #   # 
##### ### # ### ### # # ### ### # ######### # # # # ##### ### # ### ### ### # # # # ### ### ############# # ### # # ##### # ### 
#       # #     #   # # #   #   # #   # #   #   # #   # #     # # #   #   # # #   #   # #   #       #     # # #   # # #   #   # 
##### # # ####### ### ### ### ### ### # # ####### ### # ####### # ### ### # # ####### # ##### ####### ##### # ##### # # # # ### 
#   # # # #   #   # # #   # # #         # #       # # # #   # # #       #   #   #     #       # #     #     # #     # # # # #   
# # # # # # # # ### # # ### # # # ####### ##### ### # # # # # # ##### # ### ### # # ########### # ##### ##### # ##### # ### # # 
# #   # # # #   # # # #   #   # #       #     #     #   # #   #     # #     # # # # #           #     #   # #   #   # #     # # 
# ####### # ##### # # ### ##### ####### ##### ##### ######### ##### # ####### # # # # ### ####### ####### # ####### # ####### ##
#     #   #       #   #   #     #     #     #     #       #     #   #   #     # # #   # # #       #     # #   # #   #       #   
# ### # ######### ##### ##### ### ############# # ####### # ### # ##### # ##### # ##### # # ####### ### # ### # # ######### # # 
#   #   #       #     #             #   #     # # # #   #   # # # #     #       #       # # #     # #   #   # # #       # # # # 
# # ####### ######### ####### ##### # # # ### # # # # # ##### # # # ##################### # ##### # # ##### # # ####### # # ### 
# #   #     #     #   #   #   #   # # # # #   # # #   #     #   #   #     #   #       #   #     # # # #     #   #   #   # #     
### # # ##### ### # ### # # ### # ### ### # ### # # ##### ### ##### # ### # # # ##### # ####### # # # # ####### # ### ### ##### 
#   #     # #   # #   # #   # # #     #   # #   # # #   #       #   # # #   # #     # #   #   #   # #   #   #         #         
# ####### # ### # ### # ##### # ####### ### ##### # ### ######### # # # ########### # # ### # # ### ##### # ### ##### ####### ##
#   #   #     # #     #     # # # #     #   #     #     #         # # # #       #   # # #   #   #   #     #     #   #   #   #   
# # # # ####### ########### # # # # ######### ######### # ######### # # # ##### # ### ### ####### ############### # ### # # # # 
# # # #       # #         #   # # #           #     #   # #       # #   # #     #   #   # #     #   #       #   # #   # # # # # 
# # # ####### # # ####### ### # # ############# ### # ### # # ### # ### # ############# # # ### ### # ##### # # # ### # # # ### 
# #   #   # #   #       #   # #   #       #   #   # # # # # # # # # #   #     #   #     # #   #   #   #   # # # # #   #   #   # 
# ##### # # ########### ### # ### # ##### # # ### ### # # # # # # # # ####### # # # ##### ### ### ####### # # # ### ######### # 
#       #   #   # #     #   #   #   #   #   #     #   # # # #   #         #   # #   #   #   # #     #     #   #   # #       #   
### # # # ### # # # ##### ##### ### # # ######### # ### # ####### ####### # ### ####### ### # ####### ########### # # ##### ### 
#   # # # #   # # # #   #         # # #         #       #   #     #             #         # #   #   # #         #   #   # # #   
# ### # ### ### # # # ########### # # ######### # ######### ####### ########### ##### ##### # # # # # # ### ########### # # ### 
# #   #   #   # #   #           # # # # #     # # #       #   #   #     #     # #   # #     # # # #   #   # #     # #     # #   
# # ##### ##### ######### ##### # # # # # # ### # # ######### # # ##### # ### # # # # # ##### ### ######### # ### # # ##### # # 
# #   #     #   #   #   #   #   # # # #   #     # # # #     #   #     # # #   #   #   # #   #   #         # #   # # # #     # # 
# ### # ##### ### ### # ### # # # # # ##### ##### # # # ########### ### # ### # ####### # # ### ######### # ##### # # ####### # 
#   # #   #   #   #   #   # # # #   # #   #     # # # #             #   #   # #       # # #   # #       #     #   # #   #     # 
# # ####### ### ### ##### ### # ### # # # ##### # # # ############### ##### # # ##### # # ### # # # ### ##### # ### ### # ##### 
# #       # #       #   # #   #     #   #     # # #   # #   # #       #     # # #     #   #   # # #   #               #   #     
# ####### # ######### # # # ##### ############# # ### # # # # # ### ### ##### # ########### ### ##### ##### # ####### ##### ### 
#   #   # #     #     #   #   #   #   # #       #   #   # #   # #   #   # #   #     #     # # # #   # #   # # #             #   
# # # # # ##### # ##### ##### # ##### # # ######### ### # ##### ### # ### # ####### # ##### # # # # # # # # ### ############# ##
# # # # #   #   # #   # #     # #   #   # #       #   #G#     #   # # #       #       #     #     #   # # #   #   #   #         
# # # # ### # ##### # # # ### # # # ### # ####### ### # ### ##### # # # ##### ####### # ############### # ### ### # # ### ### # 
# #   # # #   # #   # #   # # #   #   # # #   #             #   # # # # #   #       #     #             #   # #   # # #   #   # 
# ##### # ##### # ### ##### # ##### ### # # # ############# # ### # # ### ######### ##### # ############### # # # # # # ####### 
#   #   #   # #   # #   #         #     #   #             # #     # # #   #   #   #     # #           # #   # # # # # # #     # 
# # # # ### # # ### ### ##### ########################### # ######### # ### # # # ##### # ########### # # ##### ### # # # ### # 
# # # # #   # #   #   #     # #       #               #   #   #       #     # # #   # # #   #   #     #   #   #     # # #   # # 
# # # ### ### ### # # ##### ### ##### # ########### ### ### # # ############# # ### # # ### # ### ######### # ####### # ### # # 
# # #   # # #   # # # #   #       #   # #     #   #     #   # #     #       # # # # # # #   # #       #   # # #   #   #   # # # 
# # ### # # # # # # # ### ######### ### # ### ### ####### # ####### # # # # # # # # # # # # # # ##### # # # # # # # ### ### # # 
# #   #   # # # #   #   #     #     #     #   #     #     # #     #   # # # # #   #   #   # #   #   #   # # # # #   #       # # 
# ### ##### # # ####### ##### # ########### ### ##### # ##### ### ##### ### # ####### ##### ### # # # ### ### # ####### ##### # 
#   #   #   # #       #   # #   #   #     #   # #   # #   #   # #     #   # #   #     #   #     # # # #   #   # #     #   #   # 
### ### # # # ####### ### # ##### # # ### ### # # # # ### # ### ### ##### ##### # ##### # ##### # # # # ### ##### ### ##### ### 
#   # #   # #     #     # #       # #   # #   # # # # # # #       #     #     # #     # # #   # # #   #   #     # # #     # # # 
# ### ##### ##### # ### # # ##### # ### # # ### # # # # # # ######### ####### # ##### ### # ### # ####### ##### # # ##### # # # 
# #   #   # #   # # #   # #   # # #   # # # #   # #   # # # #       #       # # #   # #   #   # # #   #   #   #   #   #   #   # 
# # ##### # # # # # ##### ### # # # # ### # # ### ##### # # # ########### # # # # ### # # ### # # ### # ### # ##### # # ####### 
#         #   #   #           #   # #                   #   #             # #   #       #       #     #     #       #   #       
################################################################################################################################
