################################################################################################################################
################################################################################################################################
#       #       # #                                                         #           #   #       #     #   #   # #   #   #   
# ##### # ##### # # ### ##### # ### # ### ####### ### ### # ### ########### # ##### ### # # # ### ### ### ### # # # # # # ### # 
# # #   # #   #   # #   #   # #   # #   # #   #   #   #   # #   #   #       # #     # # # # # # #   #   # #   # #   # #   #   # 
# # # ### # # ##### # ### # # ### # ### # ### # # # ### ### # ##### # ####### # ##### # # # # # ### ### # # ### ##### ### # ### 
# # #   # # #   #   #   # #     # # #   #   #   # #   #   # # #     #   #   # #     #     # # #   #     # #           #   # #   
# # ### # # ### # # ### ######### # # # ### ##### ####### # # ##### ### ### # ##### # ####### # # ####### ############# ### # # 
#   # # # # #     #   #     #   # # # # # #     # #     # # # #   # # #   #   #   # # #   #   # #   # #   #   #     #   #   # # 
##### # # # # ####### ##### # # # ### # # ##### ### ### # # # # # # # ### ##### # ### # # # ### ### # # # # # # ### # ### ### # 
#     # # # # #   #       #   # #   # #       # #   # # # # # # #   #   #       #   # # #   # #   # # # # # # #   # #   # # # # 
# ### # # # ### # # ##### ##### ### # ######### # ### # # ### # ##### # ########### # # ##### # # # # # ### # ##### # ### # # ##
#   #   # # #   # # #   # #   #   # # #         # #       #   #   #   #           # # # #   # # # #   #     #     #   #   # #   
### ##### # # ### ### # ### # ### # # # ######### # ####### ##### # ##### ##### # # # # ### # ### # ########### # # ### ### ### 
# # #   #   # #       #     #     # # #   #   #   # #     #   # #   #     #   # # #   # #         # #         # # #   #   #   # 
# # ### ### # ############### ##### # ### # # # ##### ### ### # # ####### # # ### # ### # ######### # ####### # # ### ### ### # 
# # #   #   #   #     #       #   # #   # # # # #     # #   # #   #   #   # #   # # #   #   #       # # #     # # #   # # # #   
# # # # # # ### # ### # ##### # # ### # # # ### # ##### ### # ##### # # ### ### # # # ####### # ##### # # ##### # # # # # # ####
#   # #   #   # #   #   #     # # #   # # #     # #   #     # #     # #   # #   #   #         # #   #   # #     # # #   # #     
# ########### # ####### # ##### # # ### # ####### # # ######### ##### ##### ####### ########### # # ##### # ##### ##### # # ####
#   #         #       # #   #   #   # # #       #   # #   #     #   #     #     #     #     #   # #       #   # # #     #   #   
### # ####### ####### # ##### ####### # ### ### ##### # # # ##### # ##### ##### # ### # ### # ### ######### # # # # ##### ### # 
# #   #             # #   #   #   #   #   #   #   # # # #   #   # #   # # #     #   #   #   # # #   #   #   #   # #     # #   # 
# ##### # ####### # # ### # ### # # ### # ### ### # # ##### # # ##### # # # ######### ####### # ### # # # # ##### ##### # # ### 
# #     #   #   # # #   # # #   #       #   #   # # # #   # # #   #     #   #     #   #       #   # # #   #   # #   #       #   
# ### # ##### # # ##### # # ############# ##### # # # # # # # ### ##### ##### ##### ### ####### # # ####### # # ### # ##### ####
#     #   #   #   #     # # #       # #   #   # #   # # # #   # #   #   #     #   # #   #       # #   #     #   # # # #   #     
######### # # ##### ####### # ##### # # # # # # # ### # # ##### ### # ### # # # # # # ##### # # ##### # # ####### # ### # ##### 
#   #   # # # #   #   #     # #   # #   # # # # #   #   #   #   #   #     # # # #   # #   # # # #   # # #   #     # #   # #     
# # # # # # # # # ##### # ### # # # ####### # # ########### # # # ### ##### ### ##### ### # # # # ### # ### # # ### # ### ### ##
# # # #   # # # # #     # #   # # # #       #   #   #   #   # #   #       # #   #     #   # # # #   # #   #   # #   #   #   #   
# ### ### # # # ### ####### ### # # # ########### # # # # ### ##### ##### # # ### ##### ##### # ### # ######### # ### # ### ### 
#     #   # # #   #         #   # # #             # # # #   # #   # #   # #   #   #     #     # #   # #     #   #   # #   #     
####### # # ##### ### ##### # ### # ############### # ##### # ### # # # # ##### ### ########### # ### # ### # ##### # ### ##### 
#   # # # #     #   # #   #   # # #     #       # # # #     # #     # # #     # #   #   #   # # # # #   # # #   # # #   #   #   
# # # # # ### ##### # # # ### # # ##### # ##### # # # # ##### # ##### # ##### # # ### # # # # # # # ##### # # # # # ### ##### # 
# # # # # # # #     # # #   # #   #     # #   #   #   # #     # #   # #       # # #   # # # #   # #     #   # #   # #   #   # # 
# # # # # # # # ##### # ### ####### ##### # # # ####### ##### # # # ########### # # ### # # ### # ##### # ####### # ##### # # # 
# #   # #   # #   #   # #   #       #   # # #   #   #   #   #   # # #     #     #   #   # #   #         # #     # #     # # # # 
# ##### ##### ### ##### # ### ######### # # ##### # # ### # ### # ### ### # ######### ### ### ######### # ### # ####### # # # # 
# #   #     #   #     # #     #         # # #     # #     #         # # #   #       # # #   #     #     #     # #       # #   # 
# # # # # ### ####### # ####### ########### # ##### ############# # # # ##### ### ### # ######### # ### ####### # ############# 
#   # # #   #   #   #   #     #     #   #   # #   #   #   #     # #   # #       #     #         # # #   #     #   #   #   #     
##### # ### ### # # ######### ##### ### # ### ### # # # # # ### # ##### # ##### ##### # ##### ### ### ### ########### # # # ####
#   # #   #   #   # #     #   #     #   #   #     # # # # # #   #         #     #   #   #   #     #   #               # #       
# # # ##### # ##### # ### # ### ##### ##### ##### # # # ### # ######### ######### # # ##### ####### ### ########### ### ####### 
# # #       #     # # # # #                 #     # #   #   # #       # #       # # # #   # # #     #         #   #   # #   #   
# # ######### # # # # # # ### ############# # ##### ##### ### # ##### # # ##### # # # # # # # # ##### ######### # ### # # # ### 
# #   #     # # # #   # #   #   #         # #   #   #   # #   #   #   #   #   #   # #   #                       #   # # # #   # 
# ### # ##### # ####### # # # ### ####### ##### # ### # ### ##### # ### ### # ### # ############### ############### # # # ### ##
# # # #       #       # # # #   # #     #       # #   #   # # #   #   # #   #   # #   #           #               # #   #   #   
# # # ########### ### # ### # # # # ############### ##### # # # ##### # # ##### # ### # ####### # ####### ### ### # ########### 
# #   #   #     #   # #     # #               #     #   #   #   # #   #       # # # # # #     # #   #     #   #   #     #     # 
# ### # # # ### ### # ####### ######### ##### # ##### ########### # ######### # # # # # # ### ##### # ######### ####### # # ### 
#   # # #   #   # # #                 #     # #   # #     #   #   # #   #     # #   #   #   #   #   #   #     #       # # #   # 
### # # ##### ### # ##### ########### # ##### ### # ### ### # # ### # # # ##### ########### ### # ##### # ### # ####### # ### # 
#   # #     #     # #   #   #         # #   #   # #   # #   # #   # # # #     # #   #     # #   # #     #   # #   #   # # # #   
##### ##### ####### ### ### # ########### # # # # # ### # ####### # # # ##### ### # # ### # # ### ######### # ##### # # # # ####
#     #   #       #   #   # # #   #   #   # # # # #     #     #   #   # #     #   # #   #   # #       #   # #     # #   # # #   
# ##### ######### ### ### # # # # # ### ##### # # # ######### # ####### # ##### ####### ##### ####### # # # ##### # ##### # # # 
#             #   #   # #   # # # #   # #   # # # #             #       #   # #     #   #   #       #   # #     # # #   # # # # 
# ############# ### ### ##### # ##### # # # # # # ############# # ######### # ##### # ### # ####### ##### ####### # # # # # ### 
#       #     # #   #     #   #   # # #   #   # # #         #   # #           #   #   # # # #     # #   #       # #   #   #   # 
# ##### # ### # # ### ### # ##### # # ######### # # ####### # # # ########### # ####### # # # ### # # ######### # ### ####### # 
#   # # #   # #   # #   #   # #             #   #   #   #   # #               #   #   # # #   # #   #         # #   #       # # 
### # # ### # ##### ### ##### # ######### # # ######### # ### # ####### ##### ### # # # # ##### ##### ######### ### ### ### # # 
#   # #     # #       #   # #   #         #   #     #   # #   # #   #   #   #   # # # # # #   # #     # #         # # #   #     
# ### ######### ##### ### # ### # ######### ####### # # # ####### # ##### # # # # # # # # ### # # ##### # ######### # ### ### ##
# # #   #   #   #       # #     #     #S    #       # # # #       #     # # # # #   #   #   #     #     #           #   #   #   
# # ### # # # ### ##### # ##### ##### ####### ####### # # # ########### # # # # ####### ### ##### ### ################# # # ### 
# #     # # #   #     # #   #     # #       #   #     # #   #   #       # # # # #     # # #     #   #           #     # # #   # 
# # ##### # # ##### # ##### ### # # ####### ### ####### ##### # # ######### # # ### # # # ##### ### # ##### ##### ### # ##### ##
#         # # #   # # #   # #   #   #         #   #     #     # #         # # #     #       # #   # # #   # #       # # #   #   
# ####### ### # # ### # ### # ####### ##### ##### # ##### # ############# # # # ##### ##### # ### # # # # # # ####### # # # ### 
#       # #   # #     #     #   #     #   # #     # #   # #       #   # # #   # #     #   #     # # # # # #   #     # # # # #   
# ##### # # ################### # ##### # # # ##### ### # ####### # # # # ####### ### # # ####### # ### # # ### ### # # # # # # 
# #     # #       #   #       # # #   # #   #   # #   #       # #   #   #     #   # # # # #       #     # # #   # # # #   # # # 
# ############### # # # ####### # # # ######### # ### ####### # ############# # ### # # # # ############# # # # # # ####### # # 
#             #   # #   #       # # #           #   #     # # # #         #   #   #   # #   # #             # # # #   #   #   # 
# ####### ### # ### ##### ##### # # ############# # ##### # # # # ### ##### ####### ### ##### # # ######### # ### ### ### ##### 
#     #   #   #   #       # #   # #   #         # #         # #   #   #     #     #   #     #   # #     #   #     # #   #       
# ### # ######### ######### # # # ### # ### ##### ####### ### ### ##### ##### ### ### ##### ### ### ### # ######### ### ####### 
#   # # #     # #     #       # #         # #     #     #     #   #   #       # #         #   # #   # # #   #     #   # #     # 
### # ### ### # ##### # # # ### ######### ### ##### ### # ##### ### # ######### ######### ### ### ### # ### # ### # # # # ### # 
#   #   #   # #   #   # # # #       #   #     #     #   #     #     #   #         #     #   # #   #   #   #   #   # #   # # #   
# ##### ### # # # # ### # ### ##### # # # ##### ##### ### # # # ##### ### # ##### # ### # # # # ### ##### ##### ### ##### # ### 
# # #   #   # # # #     # #   #   # # # # #     #     #   # # #     #     # #     #   # # #   #   #     #     #   #     # # #   
# # # ### ##### # # ##### # ##### # # # ### ##### ##### ##### ##### ####### ##### ##### # ####### ##### ##### ### ##### # # # # 
#   # #         #   #     #       # # #   #     # #   # #   #       #   #   #   # #     #       #   #   #   # # #   # #   #   # 
### # # # ########### ############### ### ####### ### # ### ######### # ##### # ### ##### ### ##### # ### # # # ### # ######### 
#   # # # #       #   #       #   #   #   #       #   #     #     #   #     # # #   #   #   #       #   # # # #   #   #         
# ### # # # ##### # ### ### # ### # ### ### ####### ######### ### # ####### ### # ### # # # ##### ##### # ### ### ### # ### ####
#   # # # #   #   #       # #     # # # # #     #         #   #   #   #   #     #     #   # #   #       #   #   #     #   #     
### ### # ### ######### ### ### ### # # # ##### # ####### # ##### ### # # ####### ######### # # ##### ##### ### # ######### ### 
# # #   #   #         #   #   #   # # #       # # #   # #   #   # #     #     #   #       # # # #   # #     #   #         #   # 
# # # ##### ######### ### ### ### # # ### ##### ### # # # ### # # ### ####### ### # ##### # # ### # ### ##### ########### ##### 
#     #   # #   #   #   #   #   # # #           #   # #   #   # #   # #   #       #   # # # #   # #   #       #     #   #       
####### # # # # ### ### # ##### ### # ### ####### ### ##### ### ### ### # ####### ### # # ##### # ### ######### ##### # ####### 
#       #   # #   #   # #     #   # # #   #     #   #     # #   # #   # # #     # # # # #     #   #   #     # #       #   #     
# ############### ### # ######### # # # ### ### ######### # # ### ### ### # ### # # # # ##### ##### ##### # # ########### # ### 
#     #         # #   #           # # #   #   #         #   #   #     #   #   # #   #   #   # #   #     # #     #     #     #   
# ### # ##### ### # ############### # ### ### ######### ####### # ##### ##### # ### ### # # ### # ##### # ##### # ### # ##### ##
# # #   #   #   #       #   #     # #   # #   #       #       # # #   #   #   #         # # #   #     # # #   #   #   # #   #   
# # ##### ##### # ####### # # ### # ### # # ### # ########### # # ### ### ############# # # # ### ##### # # # ##### ### # # ### 
# # #         # # #       #   # #   #   #   #   #           #   # #   # # #           #   # # # #       #   # #     #   # #   # 
# # # # ####### # # # ######### ##### ####### # # ######### ##### # ### # # ######### ##### # # ############# ##### # # # ### # 
#     # #   #   # # # #   #                 # # #         #         #     #   #     #   # # # #     #   #   #     #   # # # #   
# ####### # # # # # ### # ############### # # # ### ##### ##### # ### ####### ##### ### # # # # ### ### # ####### ##### # # ####
# # #   # # # # # #     #       #         # # #   # #     #   # #           #       #   #   #   #   #   # #     # #   # #   #   
# # # # # # # ### ############# # ######### # ### # ##### # # # # # ### ### ######### ### ####### ### # # # ### # ### # ##### # 
#   # #   # #     #     #     # #     #     # # # #   #   # #   # #   #   # #   #     # #   # #   #   #     #   #     #       # 
# ### ##### # ######### # ### # # ### # ##### # # ### ### # ##### # # ##### # # # ##### ### # # ### ########### ########### ### 
# #   # #   #     #   # # # #   # #   # #   # # #   #   # # #     # #   #   # #   #           # #   #   #                   #   
### ### # ##### # # # # # # ##### # ### ### # # ### ### # # ####### ### # ### ##### ########### # ### # # ########### ######### 
#   #     # #   #   # # # # #     #   #     # #   # #   # #     #     # #   # # #           #   #   # #G#     #     #     #   # 
# ### ##### # ### ### # # # # # # ### ####### ### # # ######### ####### ### # # # # ####### # ### ### # ####### ### ##### # # ##
#   # #   #   #   # #   # # # # #   #         #   # #         #       #   # # # # # #     #   #   #   # #     #   #     #   #   
### # # # ##### ### ##### # # ##### ########### ### ##### # # ####### ### # # # # # # ### ##### ### ### # ### ### ##### # ##### 
# # # # # #   #     #     #   #   #             # #   #   # #   #     #   #     # # # # #     # #   # #     #         # # #   # 
# # # # # # # ####### ##### ### # ########### ### ### # ### ### # ##### ##### # # # # # ##### ### ### ### ######### ### # # # # 
#   #   #   # #   #   #     #   # #         #     #   # # # #   # #         # #   # #   #   #     # #   # #       # #   # # # # 
############# # # # ### ##### ### # ####### ####### ### # # # ### ######### # ##### ### # ######### ### ### ##### # # ### # # # 
#     #     #   #   #   #     #   #   #   #     #   #   #   #   #   #       #   # #     #     # #   # #     #   # # #   # # # # 
# ### ##### ######### # # ##### ##### ### ##### # ### ############# # ####### # # ########### # # # # ####### ### ##### ### # ##
# # # #   #           # #     #       #   #   #   # #     #     #   # #       #   #         # #   # #       #   # #   #     #   
# # # # # ########### # ##### ######### ### # ##### ##### # ### # ### # ########### ##### ### ##### # ######### # # # ######### 
#   #   #             #     #           #   #             #   #   #   #                 #                       #   #           
################################################################################################################################
