################################################################################################################################
#                     #       #   #   #   # #     #         #       #           #     #       #         # #   #     # #     #   
########### ### ### # # ##### # # # # # # # # # # # ####### # ####### ### # # ### ### # ####### ####### # # ### ### # # ### # ##
#     #   # #   #   #   #     # # # # # # #   # # # # #     #   #       # # #     #   #   #   # #       #       #     #   # #   
# ### # # # # ### ####### ##### # # # # # ##### # # # # ####### # ##### # ####### # ##### # # # ##### ### ######### ##### # ### 
# # # # # # # #   #     #   #   # # #   #   #   #   # # #           #   #   #   # # #   #   # # #   #   # #       # #     # #   
# # # # # # # # ### ### ### # ### ######### # ####### # ######### # ####### # # ### # # ##### # # # ### # # ##### # # ##### # ##
# # # # #   # #   # # #     # # #         #   #       #     #   # # #   # # # #     # #       #   # # #   #     #         #S#   
# # # ########### # # ####### # ### ########### ### ####### # # # ### # # # # ####### ########### # # ### ##### # ######### ### 
# #   #     #     # #   #     #   #       #   # # #       #   # #     # #   # #       #         # # #       # # # #       # #   
# ##### ### # ##### ### # ##### ######### # # # # ####### ##### ### ### ####### ####### ####### ### ##### # # # # # ##### # # ##
#     # # # # #     #   # # #   #   # #   # # # #       # #   #   # # #   #     # #     #     #     #     #   # # # #     # #   
##### # # # ### ##### ### # # # # # # # ### # # # ##### # # # ### # # ### # ##### # ######### ####### # ####### ### # ##### ### 
#   # # #   #   #       # # # #   #   #   # #   # #     #   #   # # # #   # #     # #     #           # #     #     # #   #   # 
# # # # # ### ### ##### # # # ########### # ####### ########### # # # # ### ##### # # ### # ##### # ### # ### ####### # # # # # 
# # #   #G#       #     # # # #       #   # #               # #   #   #         # #   #   # # #   #   # #   # #   #   # #   # # 
# # ##### # # ########### # # # ##### # # # # ############# # ##### ######### # # ##### ### # # # ### # ##### # ### ######### # 
# #       # # #     #   # # # #   # # # # # #       #     #       #       #   #   #   # #   # # # # # #   #   # #   #   #   # # 
# ########### # ### # # # # # ### # # # ### ####### # ### ### ### # ##### # ####### # # # # # # # # # ### # ### # ### # # # ### 
#   #     #   # # #   #   # # #   # # #   # #       # # #   #   #   #     # #     # #   # #   # #   #   # #   # #     #   #   # 
### ##### # ### # ######### # # ### # ### # # ####### # ### ############### # ### # ########### # ##### # ### # ############# # 
#   #   # #   # #           # #   # #   #   # #   # # #   #   #   #     #   # # # # #           #     # #   # #       #     #   
# ### # # # # # ### ##### # # ### # ### # ### # # # # # # ### # # # ### ##### # # # # ### ####### ##### ### # # ##### ### ######
#   # # # # # #   # #   # # #   # #     #       #   # # #   # # #   # #       # #   # #   #   #   #   #   #   #     #   #       
### # # # # # ### # # # # # ### # ######### ######### # ##### # ##### ######### ####### ### # # ### # # # ############# ####### 
#   # #     #     # # # # #     #   #   #   #       #   #     #   #           #     #   #   # # #   # # # #             #       
# ### ######### ### # # ##### ##### # # # ### ##### ### # ####### # ##### ### ##### # ##### # # # ### # ### ############# ######
#   #         #       # #   # #   #   # # #   #   # # # # #     # # #   # #       #   #     #   # #   #   # #   #     #         
### # ####### ### ####### # ### # ##### ### ### # # # # ### ### # ### # # # ##### ##### ####### # ####### # # # ##### ### ##### 
# # #   #   #   #   #   # #     #   #   #   # # # # # #   #   #   #   #   # #             #   # #   #   # #   # #   #   # #   # 
# # ### ### ### ##### # # ########### ### ### # ### # ### ### ##### ##### # ########### # # # # ### # ### ##### # # ### # # # ##
#   # #     # #   #   # #     # #     #   #       #     #     #     #     # #   #     # # # #     #   #       # # # #   #   #   
# ### ##### # ### # ######### # # ####### # ##### ##### ########### # ### # # # # ### # # ########### # ####### # # ### ### ### 
#   #     #     #   # #     # # # #     # #   #       # #           # # # #   # # # # # # #           # #       # #   #   #   # 
### ### ####### ##### # # ### # # # ### # ### # ### # # # # ######### # # ##### # # # # # # ########### # ########### ### ### # 
# #   #         #     # # #   # # # # #   #   #   # # # # #   #     #   #     # #   #   #   #       # #   #   #               # 
# ### ######### ### ### ### ### # # # ##### # ##### # # # ### # ### # ######### ############# ##### # ##### ### ##### ######### 
#   #         # #   #   #       #   #       #   #   # # #   # #   # #   #       #   #   #     #   #   # #       #   #   # #   # 
### ######### # # # # ### ##### ##### # # # ##### ### # ##### ### # ### # ######### # # ####### # ### # # ####### # # # # # # ##
#       #   # #   #       #   #     # # # # #     # # #   #   #   #     #     #     # # #     # # #     #   #   # # # #   # #   
# # ### ### # ######### ### # ##### # # # # # ##### # ### # ### ############# # ####### # ### # # ##### ### # # # # # ##### ### 
# #   #     #   #       #   # #   # # # # # #     # #   #   #       #       # # #       #   #   #             #   # # #     # # 
# ######### ### # ##### # ##### # ### # # ####### # ### ##### ##### # ### # # # # ######### ################### ### ### ##### # 
#   #     #   # # #     #       #     # #     # # #   #           #   #   # #   # # #       #                 #   # #         # 
##### ### ### # ### ### ############### ##### # # ### ####### ### ##### ### ##### # # ##### # ############### ### ### ######### 
#     #       #     #   #     #   #         # # #   #         #   #   #   #     # # # #     #       # #     # #   #   #     #   
# ########### ####### ##### # # ### ### ### # # ### ### ####### ### ##### ####### # # # ########### # # ##### # ### ### ### # # 
#           #             # # #     #     # #   #   #   #   #   #       # #     # #   #     #     # #     #     #     #   #   # 
# ######### ############# # # ####### ### # ##### ### ##### # ### ####### # ### # ######### # ##### ##### # ##### ############# 
# #     # # #     #   #     #   #       # #   # # #   #     # # #       # # # #   #     #   #     # #   #           #       #   
# ##### # # # ### # # ####### # # ### # ### # # # # # # ##### # ####### # # # ##### ##### # ##### # # # ### ######### ##### # ##
# #       # #   #   # #     # # # #   # #   #   # # #     #   #   #   # #   #       #     #     #   # #   # #     #   # #   # # 
# # ##### # ### ##### # ### # # ### ### # ####### # ##### # ### # ### # ##### ####### ####### # ##### ### # # ### # ### # ### # 
# # #   # #   # #     # #   # # #   #   # # #     # #   # # #   #     #     #   #     #     # #     # #   # #   # #     # #     
# # # # ##### # # ##### # ### # # # # # # # # ####### # ### # ####### ##### ### # ##### ### # # ##### # ### # ### ####### # # ##
#   # # #     # #   #   # #   # # # # # # # # #   #   #   # #       #     # #   #   #   #   # # #     # #     #   #       # # # 
# ### # # ### # ### # ### # # # # # # ### # # # # # ##### # ############# # # ##### ##### ### ### ##### # ##### ### ####### # # 
#   # #   #   # #     #   # # # # # #   #   #   # # #     # #     #     #         #   # #   # #   #   # #   # #     #   # # #   
# # # ####### # ####### ### # # # # ### ######### # ### ### # ### # ### ######### ### # ### # # ##### # ### # ####### # # # ####
# # #   # #   #   #   # # # # #   #   # #       # #   #   # # # #   # #       #       #       #   #   #   # #   #     # #     # 
# ##### # # # ### # ### # # # ##### ### # ####### ### ### # # # ##### ####### ####### ####### ### # ##### # # # # ##### ### # # 
# #   # # # #   # #     #   # #     #   # #         # # # # # # #           #     #   #     # # # #     # #   # # #   # #   #   
# # # # # # ### # ##### ##### ##### # ### ### ####### # # # # # ########### ##### # # # ### # # # ### ### ##### # # ### # ######
# # # # # #   # #     #       #   # # # #   #       # # #   # #       #     #     # # # #   #   #   #   #     # # #   # # #     
# # # # # ### # ##### ####### # # ### # ### ####### # # ##### ####### # ### # ##### # # ### ####### # # ##### # # ### # # # ####
# # # # #     # # #   #       # #   # # # #   #     # #   #   #   #   #   # #   #   # #   # #       # #     #   # #   # #   #   
# ### # ####### # # ####### ### ### # # # ### # ##### ### # ### # # ####### ### # # # ### # # ####### ### # ### # # ### ##### # 
# #   #     #   # # #   #   #   # # # #     # #   # #     # #   # #   # #   #   # # # #   # # #   #     # # #   # #   #     # # 
# # ####### # ### # ### ##### ### # # ##### # ### # ####### # ### ### # # ### ##### # # ### # ### ##### # ### ### ### ##### ### 
# #   #   # #     #     #     #   #   # #   #     #         #   #   # # # #   #     # #   # #     #   # # #   # #     #   #   # 
# ### # # # ############# ##### ####### # ######### ### ### ####### # # # # ##### ### ### # # ##### # # ### ### ##### # # ### # 
#     # # #   #   #     # #     #             #   #   #   #   #     # # # #     # #   #   # # # #   # #         #     # #   # # 
# ####### ### # # # ### # # ################# # # ### ### # # # ##### # # ##### # # ### ### # # # ### ##### ##### ######### # # 
#       #   #   #   #   # #               #     #     #   # #   #     #     #   # #   # # # #   #   #     # #   # # #       #   
# ##### ### ######### ### ############### ### ######### ##### ### ####### # # ####### # # # ####### ##### # # # # # # ##### ####
# #   # #   #         #   #             #   #         #     #   #       # # # #       # # #       # #   #   # # # # #   #   #   
# # # # # ### ######### ######### ######### # ####### ##### # ######### # # # ######### # ####### # # ##### # # # # ### # ### # 
# # # #   #   #     #   #   #   #           # #       #   # #   #     #   # #   #     #   # #     # #       # #   #   # #     # 
# ### ##### ####### # ### # # # # ########### ######### # # # # # ### ##### ### # ### ##### # ##### ####### # ####### # ####### 
#   #     # #   #   #   # #   # #   #     #       # #   #   # #     #   #   # #   # #   #   #     # #     # #   #   #   #     # 
# # ### ### # # # ##### # ##### ### # # # # ##### # # # ##### ####### # # ### ##### ### # ####### # # ### # ### ### ##### ### # 
# #   # #   # #       # # #   # # # # # #   # #   #   # #       #     # #   #         # # #   # #   # #       #   #     # # # # 
##### # # ##### ####### # # # # # # # # ##### # ####### ### ### # ##### ### # ####### # # # # # ### # ### ####### ### ### # # # 
#     # # #   # #     # #   # # #   # # #   #   #     #   # #   # #   #   # #     #   # #   # #     #   # #     #   #     # # # 
# ### # # ### # # ### # ####### # ### ### # ##### ### ### # ##### # ### ### ##### ##### ##### ### ##### # # ### ### ##### # # # 
# #   # #     # #   # #     #   #   #   # #     #   #     # #     #     #   #     #   # #         #   # # #   #     #   # # # # 
# ##### ####### ### # ##### # ##### ### # ##### ### ####### # ####### ### ### ##### # # ########### # ### ### ####### # # # # # 
#       #           #     #   #   # #   #     #   # #   #   #       # #   #     #   # # #         # #   #   #     #   # #   #   
# ####### ############### ####### # ### ##### ### ### # ### ####### ### ### ### # ### # # ####### # ### ### ##### # ### # ######
#       #   #         #   #     # #   #     #   # #   #   #     #   #   #     # #   # #   #       #   # #   #   #   # # # #     
##### # ### # # ##### # ####### # ### # ### ### ### ##### ### # # ### ### ### # ### ####### ### ####### # # ### ##### # # # ### 
#   # #     # #     # # #       #     # # # #   #   #   #   # # #   # #   #   #   # #   # #   # #     #   #   #   #   #   # #   
# # # # ##### ##### # # # ####### ##### # # # ### ##### ### # # ### # # ### ### # # # # # ### ### ### ####### ### # ##### # # ##
# #   # #     # #   # # # #               #     # #       # # #   #     #   #   # #   # # # #   # #   #     #     # #   # # #   
# ##### # ##### # ##### # # ##### ##### ### ##### ### ##### ############# ##### # ##### # # ### # # ### ### ##### # ### # # ####
#   #   # #   #   #     # #     #     #   # #   #   # #     #   #     #   #   # #       #     #   #   # #     #           #     
# # # # # ### ##### ##### # ### ##### ### # # # ### # # ##### # # ### # ##### # ######### ########### # ##### ########### ##### 
# # # #   #   #   #       # # #   #     # # # #     # # # #   #   #   #       #     #     #     # #   #     # #     #   #       
# # ### ### ### ########### # ### ####### ### ####### # # # ####### ############# # # # ### ### # # ######### # ### # # ####### 
# #   #   #   #   #     #       #   #     #   # #     # #   #   #   #             #   #     # # # #       #   #   # # #         
# ### # # ### # # ##### # ######### # ### # ### # ### # ##### # # ### ##### # ####### ####### # # ####### # ##### # # ######### 
# #   # #     # # #     # #     #   # # # # #     #   # #     #   #   #     #       # #     # #   #     # # # #   #   #     #   
# # ### ### ### # # ##### # ### ##### # # # # ##### ### # ############# ########### # ##### # ##### ### # # # # ####### ### # ##
# # #     #     #         # # #   #   #   # #     # #   #   #   #       #         # #       #   #   #   # # # #     #     #     
### ##### # ############### # ### # ####### ##### # # ##### # ### # ############# # ##### ##### # ####### # # ##### # ######### 
#   #     #     #   #       # # # #   #     #   # # #       #   # # #             #     # #     #       #   #   #   # #     #   
# ### ##### ### # # # ####### # # ### # ##### # # # ########### # # # ################# # # # ######### ####### # # ### ### # ##
# #   #     # # # #   #     #   #   #   #   # #   # #         # # #   #         #   #   #   #         #   #     # # #   #   #   
# ### # # ### # # ##### # ##### ### ##### # # ####### ####### # # ####### ####### # # ### ######### ##### # ##### # # ### ### # 
#   # # #     # #   # # #       #   #     #   #       #       # #       # #     # # # #           #       #       # #   # #   # 
# # # ######### ### # # ######### ### ######### ########### ### ### # # # # ### # # # # ### # ### ############### ####### # # ##
# # #         #   # # #     # #   #   #     #   #     #   #   #     # # # #   #   #   # #   #   # #   #   #   #   #       # #   
# # ### ##### ##### # ##### # # ### ### ### # # # ### # # ### ####### # # ### ######### # ##### # # # # # # # ##### ####### ### 
# #   #   # #                 #   #   #   # # # # # #   #             #     # #   #     #   #   # # # # #   #       #         # 
# ### # # # ##################### ### ### # ### # # ####### ### ##### ####### # ### ####### # ##### # # ############# ######### 
#   # # #   #   #                 # #     #     # # #   #   #   #   #   #     # #   # #   # #   #   #   #               #     # 
##### # ##### # # ################# ####### ##### # # # # # # ### # ### # ##### # # # # # # ### # ####### ### # ##### # ##### # 
#     # #     #   #   #                     #     # # #   # # # # #     #   #   # # #   # # #   #     #     # #     # #     #   
# ##### # ########### ### # ##### ####### # # ### # # ##### # # # ##### ### ### # ####### # # ####### # ### # ##### ####### ####
# # #   #   #   #   #   # # #     #     # # # #   # #   #   #   #   # #   # #   #         # #           # # # #   #   #   #     
# # # ##### ### # # ### ### # ##### ### # # # # ### # # ########### # ### # # ############# ######### ### # ### ##### ### ##### 
# #   #   # #   # #   #     #     # # #   # # # #   # #   #       # #     # #       #   # #         #   # #   #     #   #       
# ##### # # # ### ### ########### # # ### ### # # ### ### # ##### # # ##### ####### # # # ####### # ### # ### ##### # # ########
#     # # #   # #   #       #     # #     #   # #   #   # # # #   # # #   #       #   #   #     # # # # #   # #     # #     #   
# ### ### ##### ### ####### ####### ### # # ####### # ### # # # ### ### # ####### # ####### ### # # # # ### # ##### ####### # # 
#   # #   #   #     #       #   #   #   # #     #   # #   # # # # # #   # #     # #   #     # # # # #   #   #     #       #   # 
### # # ### # # ############# # # ### ### ##### # ### # ### # # # # # ### # ##### ### # ##### # ### ### # ####### ####### ##### 
#   #   #   #                 #   #   #       #   #   #       #   #   #   #       #     #           #   #         #             
