################################################################################################################################
#     #       #               #   #               #           #     #             #                   #   #   #     # #         
# ### # ####### ############# # # ### ### ######### ### ####### # ### ### ##### # # ### ####### # ### # # # # ##### # # ### ### 
# #   #       #       #       # #   # #   #       # # #   #     # #     #   #   #   #   #     # # #   # # # #       # # #   #   
# ### ####### ####### # ####### ### # ##### ##### # # ### # ##### # ####### # ########### ### # # ##### # # ######### # # ### ##
#   #       # #   # # #   #     #   #     #   # # #     #       #     #     # #     #     #   # #       #   # #         # #   # 
# # ##### ### # # # # ### # ##### ##### ##### # # # ################# # ##### # ### # ##### ### ############# # # ##### # # # # 
# #     #   #   # # # # # #   #   #     #   #   #   #             # # # #   #     #   # #   #                 # #     # # # # # 
# ##### # # ##### # # # # ##### ### ##### # ### ##### ########### # # # ### ########### # ### # ##### ### # ### ##### # # # # # 
# #   # # #   #     # # # # #   #         #     #   # #     #     #   #   # #   #       # #   # #   #   # # #     #   # # # # # 
# # ### # ##### ##### # # # # ##### ############# # # # ##### ########### # # # # ####### ### # # ##### # ### ##### ### # ### # 
# # #   #   #   #     # #   # #   #   #   #   #   # # #     #   # #   #   #   # # #         # # #     # #     #     #   #   #   
# # # ####### ### ##### ##### # # ### # # # # # ### # ##### ### # # # # ####### # ### ##### # ####### # ####### ##### ##### ####
# # #         #   #       #   # # #   # #   #   #   #     # # # #   # # #       #   # #   # #     #   #     #   #     #   #     
# # ########### ##### ### # ### # # ### ######### ####### # # # # ### # # # ### ### ### # # # # ### ####### ##### # ### # ### # 
# #   #       # #   # #   #   # # # # # #   #   #       #   #   # #   # # #   # #   #   #   # #     #     # #   # #   # #   # # 
# # # # ####### # # # ####### ### # # # # ### # ####### ##### ### ##### # ### # # ### ####### ########### # # # ####### ### ### 
# # # # #     # # # #     # # #   #   # # #   #       #   #   #         # #   # #     #         #   #     #   #           #   # 
# # # # # ### # # # ##### # # # ##### # # # ############# # ############# # ### ############# # ### # ################### ### # 
# # #   #   # #   #   #     # #   #   # #           #   #   #         # # #   #         #   # #     #   #     #   #     # #   # 
# # ### ### ######### # ##### ### # ### ########### # # ##### ####### # # ############# # # # # ####### # ### ### # ### # # ####
#   #         # #       #     #   #   #   #       # # #       #   # # # # #       #     # #   #     #   #   #     # # # # #     
########### # # # ####### ##### ##### ### # ##### # # ######### # # # # # # ##### ### ### ##### ### # ##### ####### # # ####### 
#         # #   #     #   #   #       #   # #   #   #   #     # #   # #   #   # #   #     #   #   #   # #   #     #   #   #     
# ####### # ######### # ### # ### ##### ##### # ### ### # ##### ##### # ##### # ### ####### # ##### ### # ### ### ####### # ####
# #   #   #       #   #     #     #   # #     #   # #   #       #   # # #     #   # #     # #     # #   # # #   #     #   #     
# # # # ### ##### # ####### ##### # # # # # ### # # # ######### # # # ### ##### ### # ### # ##### # # # # # ### ##### # ####### 
# # # #   # #     # #       #   #   #     #   # #   #         #   # #     #       #   # #     #   #   #   #   #   #   #         
# # ##### # ####### # ##### # # ### ######### # ############# # ### ####### # # # ##### ####### ### ####### # ### ##############
# #     # # #   #   #     # # #   #       #   #         #     # #   #       # # #     #   # #   #     #     # # #           #   
# ##### # # # # # ####### # # ### # ##### # ######### # # ####### # # # ##### ######### # # # ### # # ####### # ########### # # 
#   # # # #   # # #       # # # # # #     # #   #   # # #       # # # # #   #     #   # # # # #   # # #     #   #         #   # 
### # # # ##### # ### ##### # # # # ### ##### # # # ### ####### # # # ### # ##### # # ### # # # # # # # ### ### # ##### ####### 
#   #     #     # #   #   # # #   #   # #     # # #   #   #   #   # # #   #     # # #       # # # # #   #   #   #   #   #       
# ##### ### ##### # ### ### # ##### # # # ##### # ### # # # ####### # # ####### # # ##### ### ### # ##### # # ##### # ### ######
#     #   #     #   # #   # # #   # # # #     # # # # # #   #     # # #   #   # #   #   # #   #   # #   # # #   #   #   #   #   
##### ### ##### ##### ### # # # # # # ####### # # # # ####### # ### # ### ### # ##### # ### ### ### # # # ##### # ######### # # 
#     #   #     #   #       #   # # #       # # # # #         #     #   #   # #       # #   #   #   # # #       # #     #   # # 
# ##### ##### ### ### ########### # ##### ### # # # ################# ##### # ######### # ########### # # ####### # ### # ##### 
# #   #     #   #     #     #   # # #   #   # #   #     #             #   # # #     # # #     #       # #         # #   # #     
# # # ##### ### ### ### ### # # # # # # ### # ##### ### # ######### ### ### # # ### # # ##### # ####### # # ##### # # ### ### ##
# # # # #   #       #   # # # # #   # #   # # #     #   #   # #     #   #   # # # #   # #   # # #   #   # #     # # #   #   # # 
# # # # # ### ##### # ### # # # # ### ### ### ### ### ##### # # ##### ### ### # # ##### # # # # # ### ######### ### ### ### # # 
#   # # #     #     #     #   # # #   # #     #   #   #     # #       # #     #     #   # # #   #   #       #   #   # #   # #   
# ### # ####### ### ########### # # ### ####### ### ### ##### ######### ########### # ##### ####### ####### ##### ### ### # ### 
# #   # #       #   #     #   # # #           # # # # #             #   #   #   # # #   #   #     #   #   #       # #   # #   # 
### # # ##### ####### ### # # # # # ##### ### # # # # ############# # # # ### # # # ### # # ### # # ### ########### # ### ### # 
#   # #     #     #   # # # #       #   #   # #   #     #     #   # # # #   # # # #   #   #     # # #   #     #     # #   #   # 
# ### ##### ##### # ### # ### ####### # # # # ######### # # # ### # # ##### # # # ### ########### # # ### ##### ##### # ### ### 
#   #     #   #   #     #     #     # # # # # #   #   #   # #     # # #   #   #               #   # # # #             # #   #   
### ######### # ########### ### ### ### # # # # # # # ##### ##### # # # # ### ####### ##### # # ### # # ### ##### ##### # ### ##
# #           # #       #   #   # #   # # # #   #   #     #     # # #   #     #       #     # # #         # #   #     #   #     
# ############# # ##### # ### ### ### # # # ############# ####### # ########### ####### ##### # ### ##### # # # ##### ######### 
#     #         #   # # # #   #     #   # #     #       #     #   #             #       #           #   #   # #     #     #     
##### # ##### # ### # # # # ### ### ##### ####### ##### ##### # ############### # ####### # ######### # ##### ##### ##### # ### 
#   #   #     #   #   # # # #     #               #   #     # #         #     # #   #     # #       # # #   # #   # #     # # # 
# # ##### # ##### ##### # # # ##### # ### ######### # ####### ##### ### # ##### ### ######### ##### # # # # # # # # ##### # # # 
# #   #   # #   #   #   #   # #   # #   #   #   #   #     #   #   # #   # #       #       #   #       #   # # # # #     #   #   
# ### # ### # # ##### ### ##### # ##### ### # # # ####### # ### # # # # # # ### # ####### # ############### # # ####### ####### 
# # #   #   # # #     #         # #   #   # # # # #   #   #   # # # # # #   #   #   #     #         #     #   #       #       # 
# # ##### ### # # ##### ######### # # ### # # # # # # # ##### ### ### # ##### # # # # ############# # ### ########### ####### # 
# # #     #   # # #     # #     # # #     #   # # # # #     #   #   # #       # # # #         #S  # #   #       #         #   # 
# # # ##### ### # # ##### # ### # # ########### # # # ### # ### ### ######### # # ####### ##### # # # ####### # # ####### # ### 
#   # # #   #                 # # # #         # # # # # # # #   #       #     # #       #     # # #   #     # # #   #   # #     
##### # # ####### ############# # # # ####### # # # # # # ### ######### # ##### ####### ##### # # ##### ### # # ### # # ####### 
#   #   #   #   #       #     # # #   #   # # #   # #   #   # #   #   # #     #   #     #   # # # #     # # # # #   # #       # 
# # ######### # # ##### ##### # # ##### # # # # ### ### ### # # # # ### ##### ### # ##### # # # # # ##### # ### # # # ##### ### 
# # #         # #     #   #     #       # #   #       # # # #   # #   # #   #   # # #     # #   # #   #   # #   # #       #   # 
# # # ######### # ### ### # # ##### ##### ####### ### # # # ##### ### # # ##### # ### ##### ######### # ### # ########### ### # 
# # #   #   #   # #   # # # # #   # #     #     # #   #   # #     #     #       #         # #   #   # # #   # # #   #   # #   # 
# # ### # ### ### ##### # # ### # ### ##### ### # # ##### # # ####### ##################### # ### # # # # ### # # # ### # # # # 
# #     #   #         #   # #   #   # #   # # # # #     # # # #     #       #       #     # #   # #   # #     #   # #   # # # # 
# ######### ### # ### ### ### ##### # ### # # # # ##### # # # # ### # ##### # ##### # ### # ### # ##### ##### ##### # # # # ### 
#   #         # #   # #   #   #   # #   # #   # # #     # # # #   # # #   #   #       #   #     # #             #   # # # #     
### # ####### # ### # ##### ### ### ### # ##### # # ####### # ##### # # # ############# ####### # ####### ####### ##### # ######
# # #       #   # # #     #   #     #   #     # # # # #     #       # # #       #   #         # #       # #       #       #     
# # ####### ##### # ##### ##### ##### ##### ### # # # # ### ########### ####### # # ######### # ####### ### ############# ##### 
#   #     #   #   #     # #     #   #     #     # #   # # #           #   #   #   #   #   #   #       #     #     #     #     # 
##### ### ### # # ##### # # ####### ##### # ##### ##### # # ##### # # ### # # ####### # ### ######### ####### ### # ### ##### # 
#       # #   # #     # # # #       #     # #   #     # #   #     # #     # #   #     #   # #       #           # # #       # # 
# ##### ### ##### ### # ### # # ##### ##### # # ### ### ##### ##### ####### ### # ##### # # ####### ######### # ### ####### # # 
# #   #   # #   # #   #     # # #   #   #     #   # #   # #   #         #   #   # #     #           #         #   # #     # # # 
# # # ### # ### # ########### # # # ### ######### ### ### # ####### ### # ####### # # # ####### ################# # # ### # # # 
# # #     #     #   # #     # # # #     #   #     #   #   # #   #     #   # #   # # # #   #   #     #     #   #   #   #   # #   
# ####### ######### # # ##### # # ####### # # ##### ### # # ### ### ####### # # # # # ##### # # ### # ### # # ############# ### 
# #     # #         # #     # # #         # #   #   #   # #     #   #       # # # # #       # # #   #   #   #   #   #   # #     
# # ### ### # # ##### ##### # # ########### ### # ### ### ####### ### ####### ### # ######### # ####### ####### # # # # # ##### 
# #   #     # #   #     #   # #     #   # # # #   #   # # # #       #       #     # #     #   # #     #   #   #   #   # # #     
# ### ##### # ### # # # # ### ### # # # # # # ##### ### # # # ### # ####### ####### # ### ##### # ### ### ### ######### # # ####
#   # #   # #   #   # #   #   #   # # #   # #   # #   # #   # #   #       #     #   # #   #   #   # # # #   #   #       # # #   
# ### ### # ### ##### ##### ####### # ##### ### # ### # ##### # ####### ####### ### # ##### # # ### # # ### # # # ####### # # # 
#     #   # #   #     #       #   # #     # #   #         #   #       #     #   #   #     # # #   # # #     # # #   #   #   # # 
# ##### ##### ### ##### ####### # # # ##### # ########### # ####### # ### ### ### # ##### # # # # # # ######### ### ### # ### # 
# #   # #   #   #       #       # #   #     # #         #   #   #   #   #   # #   # #   #   # # #   #     #       #   #       # 
# # # # # # ### # ####### ####### ### # ##### # ####### ### # # # ### # ### # # # # ### ##### # ####### ### # # ##### # ####### 
# # # # # #   # #     # #       #   # # #   #   #     #   # # #   #   # #   # # # #     # #   #   #   #     # #     # #   #   # 
# # # # # ### # # ### # ########### ### # # ######### ### ### ### ####### ### # # ##### # # ### # # # ####### ### # # ##### # # 
#   # #   #     #   #   #     #     #   # #             #   # # # #       #   # #   # # # # #   #   # #   #   #   # # #   # #   
# ### ### ####### ####### ### # ##### ### ####### ##### ### # # # # ##### # ##### # # # # # # ### ### # # # ####### # # # ##### 
# #   #   #   # # #     # # #   #     #   #     # #   #   #   #   # #   # #     # #   #   # #   #   #   # # #   #   # # #   # # 
# # ### ### # # # # ### # # ##### # ### ####### # # # ### ####### # ### # ##### ######### # ### ######### # # # # ### ##### # # 
# # #   #   # #   # #   # #   #   #   #   #     #   # #           #   #   #     #     #   #   #     #     #   # #   #     #     
# # ##### ### # ### # ### # ### # ### ### # ########### ######### ### ##### ##### ### # # ### ##### # ##### ### # ####### # ####
# # #       # # #   #   # #     # #   #   #     #       #       #   #       #       #   #   #   #   # #   # #   # #     # #     
# ### ####### # # ##### # ####### # ### ####### # ############# # ########### ### ######### ### ####### # ### ##### ### # # ### 
#   #     #   # #     # # #       #   #         #               #     #   #     # #   #   # # #         # #   #   # # #   #   # 
# # ##### # ######### ### ########### # ############################# # # ####### # # # # # # ########### # ### # # # ####### ##
# #     # #   #     #   #             #     #   #   #   # #         # # # #       # # # # #   #   #       #     #   # #     #   
# ##### # ### # ### ### ############### # ### # # # ### # # ### ##### # # # ####### # ### ### # ### ####### ######### ##### # # 
# #   #   # # # # #   #   #     # #     #     #   #     # # # #     #   # #   #   # #   #   # #   # #                       # # 
# # # ##### # # # # ##### # ### # # # ####### ########### # # ##### ##### # ### # # ### # ### ### # # ##### # # ##### ####### # 
# # #       #   # #       # # # #   #       #   #       #   #   # #     # # #   #   # # #         # #     # # #     #       # # 
# ### ### ####### ######### # # ########### # # # ##### # ### # # # ##### ### ####### # # ######### ##### # ####### # ##### # # 
#   # #   #       #   #   # # #             # # # # #   #   # #   # #   #     #   #   # # # #   #   #     #   #     #   # #   # 
### ### # # ######### # ### # ################# # # # ##### # ##### # # ####### # # ### # # # # # ### ####### ######### # ### # 
# #   # #             # #   #   #               # #   #           # # # #       # #  G  #   # #   #         #   #   #   #   # # 
# ### # ############# # # ##### # ### # ### # ### ##### # ##### # # # # # ####### ####### ### ############# ### # # ####### ### 
# #   #   #   #     # # # #     #   # #   # #     #   # #     # # #   # #       #       #       #       # #   #   #   #   #     
# # ##### # # # ### # # # # ####### # ### # ####### # # ##### # # ##### ############### # ####### ##### # # ##### ### # # ##### 
#   #   # # # # # # # # #   #       #   # #         # # #     # # #   #                     #     #     #   #   # #   # #   #   
# ##### # # # # # # # # ##### ### ####### # # ####### # # ####### ### ############# ######### ##### ######### # ### ### ### # ##
# #   # # # # # # # #         #   #   #   # #       #   # #     #     #       #   # #   #     #     #         #   # #     #   # 
# # # # # # # # # # ########### ##### # ### ### ### ### ### ### ##### # ####### # # ### # ##### ##### ########### # # ### ##### 
#   # #   # #   # #       #   #       #   #   #   #   # #   # #     #   #       # #     # #   # #   #       #   # # # # # #     
##### ##### ##### ####### # # ##### ##### ### ### ### ### ### ##### # ### ####### ##### # # # # # ######### ### # # # # # # ####
# #   #     # #   #   #   # # #   # #   #   #   # # # #   #   #   # # #   #     #     # # # # # #   #     # #   # # # # #   #   
# # ### ##### # ### # # ### # # # ### # ####### # # # # ### # # # # ### ### # ####### ### # ### ### # ### # # ### # # # ####### 
#       #           #       #   #     #         #   #       #   # #         #       #     #     #     #     #       #           
