################################################################################################################################
################################################################################################################################
#             #   #               #   #           #   #   #     #   #   #   #     #   #     #   #       #             #   #     
# # ### # ### # # # # ### # ##### # # # ##### # ### # # # # ### # ### ### # ##### # # ### ### # # ##### # # # # ##### ### # ####
# #   # #   #   #   #   # # #   #   #     #   # #   # # #   # #           #     #   #     #   #   #   #   # # #     #     # #   
# ### ######### ####### # # # # ######### # ##### ### # ##### ####### ######### # ##### ### ####### # ##### # ### # ####### # # 
#   # #   #   #     # # # # # # #       # # # #   #   #     # #   #   #     #         # #   #       # #     # #   #     #   # # 
# ### # ### # ##### # # ### # # # ##### # # # # ### ### ### # # # # ### ### ### ##### ### ### ######### ##### # ######### # # ##
#   #   #   #   # # # #   #   # #   #   # # # # #   # #   #   # # #   # # #   #     #     #   #   #     #     # #         # #   
### ##### ##### # # # ### # ####### ####### # # # ### ### ##### # ##### # ### # ### # ##### # # # # ##### # # # # ######### ### 
#     #   #     #   #     #   #   #   #   #   # #   #     #     # #   # # #   # #   #       # # #   #     # # # # #   #     #   
# ##### ### ####### ##### ##### # ### # # ##### ### ##### # ##### # # # # # ### ##### # ##### # ##### ##### # # # # ### ### # ##
# #   #   # #     #     # #     #   #   #   #   # #   # # #     #   #   #   #       # #   #   # #     #     # #   #     #   #   
# ### ### # ##### # ### # # ############### # ### ### # # ############### ### ##### # ### # ### ####### # ### ########### # ### 
#     #   #     #   #   # # #   #       #   #   #   # #   #           #   # #     # # #   #   #   #     # # #     # #     # #   
##### # ####### # ######### ### # ##### # ##### ### # ##### ######### # ### # ### # # ####### ### # ##### # ##### # # # ### # ##
#   # #       # #   #   #       #     # #     # #   #     #     #     # #     #   # #     #     # #     #   # #   #   # # # #   
# # # ####### # # # # # # ########### ####### # # # ##### ##### # ##### # ######### ##### # ##### # ### ##### # ####### # # ### 
# # #       # #   #   # #   #         #     #S  # #     #     # # #   #     #     #   #   # #   # # #         # #   #   # #   # 
# # ### ##### # ####### ### # ######### ### ########### ##### # # ### ### # # ### ### ####### # # # # ######### # # # ### # ### 
# # #   #   # # #     #   # # #       # #     #         #   #   #   #   # #   #   #   #   #   #   # # # #       # # #   #   #   
# # ##### # # # # ### ##### # # # # # # ####### ######### # ####### ### # ############# # # ####### # # # ####### # ### ##### ##
# #       #   # # # # #     # # # # # # #       #       # #   # #   # # #   #         # # # # #     # # #         #   #     # # 
# ############# # # # # ##### # # # ### # ####### ##### # # # # # ### # ### # ####### ### # # # ### # # ############# ##### # # 
#     #     #   #   #   # #   # # # #   # # #   # #   #   # #   # #   #   # # #       #   # # # #   # # #       #   # # #   # # 
# ### # ### # ##### ##### # ### # ### ### # # # # ### ##### ##### # ##### # # # # ##### ### # # # # # # # ##### # # # # # # # # 
# # #   #   #     # #     #   # # #   #   #   #   #   #   # #     #   #   # # # # #   #     # # # # #   #   # #   # # #   # #   
# # ##### ####### # ##### ### # ### ### ##### ##### ### # # # ####### # ### # # ### # ####### # # # ####### # ##### # # ####### 
# # #   # #     # #         #   #   # #     # #       # # # # #           #   # #   # #         # #             #   # # #     # 
# # # # # # ##### ### ##### ### # ### ##### # # ####### # # # ########### ### ### ### # ############# ########### ### # # # ### 
#   # # # #   #       #   #   # # #   #   # # #   #   # #   #     #   # #   #   # #   # #     #     #       #   # #   # # # #   
##### # # ### # # ##### # # # # # # # # ### # # ### # # # ####### # # # ### ### # ### ### ### # ### ######### # ### ##### # # ##
#     #   #     #   #   # # #       #   #   #       # # # #   # #   # #   #     #   # #   # #   #   #         #   # #     #   # 
# ################# # ##### ########### # ### ####### # ### # # ##### # ### ####### # # ### ##### ### ########### ### ######### 
# #         #       # #     #     #   #     #     #   #     #   #   # # #   #     # #   #   #     #   #         #     #   #   # 
# # ####### # ####### # ##### ### # # # ### # ### # ####### ##### # # # # ### ### # ##### ### ##### ### ####### ####### # ### # 
# #   #   # # #     # #     # # # # # #   #   #   # #     # #     # # # #   # # # # #   #   # #   # #   #   # #   #   # #   #   
# ### # # # # ### # # ##### # # # ### # # ######### # ### ### ##### # # ### # # # # ### ### # # # # # ##### # ### # # ##### ### 
#   #   # # #   # # #       #   #   # # # #     #   #   #   #   # #   # #   # #   # #   #   # # # # # #         #   #   #     # 
# ####### ##### # ################# # # # # ### ### ####### ### # ##### # ### ##### # # # ### # # # # # ############### ##### # 
#       #       #     #     # #         #   # #   #   #     #   #     #   #   #     # # # # #   # #   #               # #   #   
####### ######### ### # ### # # ####### ##### ### ### # ##### ####### # ### ### ##### # # # ##### ##### ############### # # ### 
#     #         # # # #   # #   #     #         # #   # # #   #       #   # #   #     # # # #   #     #           #       #     
# ### ### # ### # # # ##### # ### ### ######### # # ### # # ### ######### # # ######### # # # ####### ### ####### # # ######### 
# #       # #   #   # #   #   #     #       #   # # #     # # #   #     # #   #       # # #               #     #   # #       # 
# ######### ####### ### # ### # ########### ##### # # ##### # # # # # ### ########### # # ##### # ####### # ### ####### ##### # 
# #     #           #   #   #   # #       #   #   # # # #   #   #   #     #       #     # #     #   #   # #   #         #   # # 
# # ### # ########### ##### # ### # ##### # # # ##### # # ### ############# ### # ### ### # ######### # ##### ########### # # # 
# #   # #           # #   #       # #   # # # # #   #   #   # #           #   # #     #   #   #       #   #     #         #   # 
# ### # ### # ####### # # # ####### ### # # # # # # # ##### # # ######### ### # ##### # ##### # ######### ##### ############### 
#   # # #   # #   #   # #   #           # # # #   #   #     # #   # #     #   # # #   #       # #   #   #   #     #       #     
# # # # # ##### # # ### ##### ########### # # ### ##### ##### ### # # ######### # # ######### # # # # # ### ##### # ####### ### 
# #   # #     # # # # #   # #     # #   # # #   # #   # #     #   # #           #             # # # # #   #     # #         #   
# ##### # ### # # # # ### # ##### # # # # ##### # # # # # ##### ### ######### ##### ### ##### # # # # ######### # # ######### # 
#     # #   #   # # #     #   #   # # #   #     #   # # #       #   # #   #   #   # #   #   # # # #   #         # #     # #   # 
##### # ### ####### # ####### # ### # ##### ########### ######### ### # ### ### # # # ### # # # # ##### ######### ##### # # ####
#     #   #     #   #   #     #     #     # #       #   #   #   #           #   # # #   # # # # #     # #                 # #   
######### ### ### ##### ##### ##### ##### # # ##### # ### # # ##### ### ##### ### # ##### # ### ### ### # ### ########### # # # 
#       #   #   #     # #         # # #   #   #     # #   # #     # #   #   # #   #   #   #     #   #   # # #     #     # # # # 
# ##### ### ### ##### # # ####### # # # ### ######### ### # ##### # # ### # # # ####### ######### ### ### # ##### # ### # # ### 
#   # # #   #   #   # #   #       #   # #     #       #   #     #   # # # #   #   #     #       #   #   #       #   # # # #     
# # # # ######### # ####### ##### ### # ####### ####### ##### # ### # # # ####### # ##### ##### # # ### ##### ####### # ##### ##
# # # #       #   #         #   # #   #         #     #     # #   # #   #       # #   # # #   #   #   #     #       #   #   #   
# # # ####### # ############### # # ############# ### ####### ### # ########### ##### # # # # # ########### # ##### ##### # # ##
# # # #   #   # #     #         # # #     #     #   # #     # # #             #       #   # # # #     #     #   #   #     # #   
### # # # # ### # ### # ####### # # # ### ##### ### # # ### # # ####### ##### ############# # # # ### # ##### ### # # ##### ### 
#   # # # #     # #   #     #   # #   # #         # #   #   # #       # #   #         #   # # # # #   #     # #   # # #     #   
# ### # # ####### # ####### # ### ##### # ####### # ##### ### # ##### # # ### # # ##### # ### # # ######### # # ##### ####### ##
#   # # #       # #       # #       # #   #     # #   #   #   # #     # # #   # # #     #   #             #   #       #     #   
### # # ##### ### ####### # ### # # # ### # ### # ##### ####### ### ### # # ### # # # ##### ########### # # ########### ### ####
#   #   #     #   #     # # #   # #   #   # #   #   #   #     #   #     # #   # # # # #   #       #   # #   #           # # #   
# ####### ### # ### # # ### # ### ### ### # ##### # # ####### # # ####### # # ### # ### # ####### # # # ##### ########### # # # 
# #       # # # #   # #     # #   # #     #     # # #   #     # # #     # # #   # #     #       #   # # #   # #         #   # # 
# ######### # # ##### ####### # ### # ######### ### ### # ##### # ##### # ##### # ################### # # # # ### ########### ##
#   #   #     #   #   #   #   # #   # #       #   # # # #   #   #   #           #         #   #     #   # # #   #           #   
### ### # ####### # ### # # # # # ### # ##### ### # # # ### # ##### ####################### # # ### ### # # ### ########### ### 
# # #   # # #     # #   #   # # # #   #     #   # #   #   # #     #           #             #   # # #   # #   # #   #   #     # 
# # # # # # # ##### # ####### # # ############# # # ##### # ### # ########### # ################# # # ### ##### # # # # # ##### 
# # # # # # # #     #   #     # # #           # # # #   # # #   # #       #   # # #         #   #   # #   #     # #   # # #     
# # ### # # # # ######### ##### # # ######### # # # # # # # ##### # ##### ##### # # # ##### # ####### # ### ##### ####### # ####
# #   # #   # #   #       #     # # #     #   # #     # # #     # # #   # #     #   # #   #             # # #             # #   
# ### # ### # ### # ####### ##### # # ##### ### ### ### # ##### ### ### # # ########### # ############# # # ####### ### ### # ##
# #   # #   #   # #     # # #     #   #     # #   #   #   #   #   #   #   # #   #     # #    G    #   # # # #     # #   #   #   
# # ### # ##### # # ### # # # ######### ##### ### # # ####### ### ### # ### # ### ### # ### ##### # # # # # # ### ### # # ##### 
# #   #       #   #   # # #     #       #         # # #     #     #   # # # #   #   # #   # #   #   # #   #   # #   # # # #   # 
# ### # ########### # # # ####### ########### ##### # # ### # ##### ### # # # # # ### ### # # # ##### ### ##### ### ### # # # # 
#     # # #     #   # #   #   #   #   #     # #     #   #   #     # #     # # #   #   #   # # # #     #               # # # # # 
####### # # ### # ### ##### ### ### # # ### # # ################# ### ##### # ##### ######### # ##### # ##### # ##### # # # # # 
#         # #   # #       # #   #   # # #   # # #   #     #       #   #   # #   #   #     #   #     # # #     # #   #       # # 
# ##### ### ##### ##### # # # ####### # ##### # # # # ### ### ##### ### # # ### # ### ### # ####### # ### # ##### # ######### # 
#     #   #   #   #   # # # #       # #   #       # # # #   #           #   # # #     # # # #   # # #     # #   # # #     # #   
##### ### ### # ### # ### # ####### # ### # ### ##### # ### # ##### ######### # ####### # # ### # # ######### # # # # ### # ### 
#   #   # #   # #   #   #   #     # #   #     #     # #     #     #             # #     # #   #   # #       # #   #   #   #     
### ### # # ### ####### # ####### # ### ##### ##### # ####### ### ######### ##### # ### # ### ### # # ##### # ######### ### ####
#     # # #   #       # #         # #         #   #   # #   #   #     #   #     #   # # #   #   # # # # #   #   #       #       
# ##### # ### ### ##### # ######### ##### ##### # ##### # # ### ##### # # # ### ##### # ### ### # # # # # ####### ####### ######
#       #   #   #       #   #   #   #   #   #   # #   #   # #   #   #   # # #   #     # #     #   #   #   #   #                 
# ############# ######### # ### # ### # ### # ##### # ##### # ### ####### ### ### ### # # # ##### ########### # ### ########### 
#       #     # #     #   #   # #     #     #       # #     #   #   #   #   #     #   # # # #     # #         #   #     #     # 
####### # ### # # # # ### ### # ############### ##### # ####### ### ### ### ##### # ### # ### ##### # ######### # # ### # ### # 
#     # # #   # # # #     #   # #   #     #   # #   # #   #   #   #   #   #     # #   # #     #     # #     #   # #   # # #   # 
# ### # # ##### ### ##### # ### # # # ### ### ### # # ### # ##### ### ### ##### # ### # ########### # ##### # ### ### # # ### # 
#   #   #     #     #   # #     # # #   #   #   # # # #       #   #           # #   #   #     #     #     #     # # # # #   #   
### ### ##### ####### ### ######### ####### ### # # # # ### # # ### # ####### # # # ##### ##### ######### # ##### # # # ### ####
#   #       #   #   #               #       #   # # # #   # # # #   # #     # # # #   #         #         # # #   # # #   #     
# ### ##### ### # # ##### # # ####### ####### ### # # # # ### # ##### # ### ### # ### # ######### ######### # # ### # ### ##### 
# #   #       # # #     # # #         # #   # # # # #   #   #   #     #   #     #   #     #     #   #   #   # # # #   #   #   # 
### # # ### # # # ##### # # ### # ##### # # # # # # # ##### # ### ####### ####### # ##### # ####### # # # ### # # ##### ### ### 
#   # #   # # #   #   #   #   # #     #   # # #   # #   #   #     #     #       # #     #   #     #   # #   # # #     #   #     
# ##### # # # ####### ####### # ##### ##### # # ### # # ##### # ### ### ####### # ##### ##### # ####### ### # # ##### # # ######
# #   # # # #       #         #     #       # # #   # #   #   #       #       # # #     #     #     #   #   # #   #   # #     # 
# # # ### # # ##### ### ### ### ### ####### # # ##### ### ################# ### # # ##### ######### # ### ### ### # ### ##### # 
# # #   # # #     #     #   #     #       # # #   #   # #             #     #   # #       #       #   # #   #   # #         # # 
# # ### # # ##### ####### ########### ### # # ### # ### ############# # ##### ### ############# # ##### ### ### # ######### # # 
# #   #   #   #   #   #   #     #   # # # #     # # # # # #           #   #   #       #       # # #   #   # #   #   # #   # #   
# ### ### # ### ### # # # # ### # # # # # ##### # # # # # # ####### ##### # ### # ### ####### # # # # # ### # ##### # # ### ####
#   # # # #   #   # # # # # #   # # #   #     #       # # #     #   #   # # #   #   #   #     # #   # # #   # #     #   #       
# ### # # ### ### ### # ### # # # # ######### ##### # # # ##### # ### # # # # ##### ### # ##### ####### # ### # ####### # # ### 
# #   #     #   #     #     # # # #         #   #   # # #     # # #   # # # #   # #   # #   # #         #     # #     # # # #   
### ######### # ############# # # ######### ### ##### # ##### # ### ### # # ### # ### # ### # # ############# # # ### # # # ### 
#   #   #     # #   #   #   # # # #     # # #   #   #         #     #   # #   #     # #     # # #   #   #     # # #   #   #   # 
# ##### # ####### # ### # # # ### ##### # # # ### # # ####### ####### ####### # ##### ####### # # # # # # ##### ### ######### # 
#     # #     #   #     # # #   # #     #   #     # #   #   #       #     #   # #     #           # # # # #   #   #         # # 
# ### # ##### # ########### ### # # ##### ######### ##### # ############# # ##### ### # ### ######### # # # ##### ######### # ##
#   #   #   # # #           # # #   #   # # #     #     # # #         #   # #   # #     #   #         #   #   # #         # #   
### ##### # # # # ########### # ##### ### # # ### ##### # ### ####### # ### # # # # ##### ### ############### # ######### # ### 
#         # #                 #           #   #         #     #         #   # #   #     #                               #   #   
################################################################################################################################
