################################################################################################################################
         #   #     #   #           #   #     #           #   #   #   #       #   #   #   #   #     #       #         #   #     #
###### ### ### ### # # ### ##### ### # # ### # ### ### ### # # ### ### ##### # # # ### # # # # ### ##### # # ####### ### # #####
     # #   #   #   # #   # #   #     # #   # #   #   #   # # #   # #   #   # # # # #   #   # # # # #   # #   #     # #   #     #
 ### # # ### ### ### ### # # # # ######### # ### ### ### # # ### # # ##### # # ### # ####### # # # # # # ##### ### # # # ##### #
 # # # #   # # #   #   # # # # # #   #     #   #   # #   # #   # #   #   # # #     # #     # #   #   #   #     # #   # # #     #
 # # # ### # # ### ### # ### # # # ### ##### # ### # # ####### # ####### # # ##### # # ##### ############# ##### ####### # #####
 #   #   # # # #     # #     # # #   # #   # #   # # #   #     #           # #   #   # #   #   #         #     # #       # #   #
## ##### # # # # ##### ####### # ### # ### # ### # # ### # ##### ##### ##### # # ### # # # ### # ##### ####### # # ####### # # #
   #   # # # # # #   #     # # # #   #     #   # # #   #         #   #       # #   # #   #   #   #   #       # #   #   #   # # #
 ##### # # # # # # # ##### # # # # ### ##### # # # ### ##### # ### # ############# # ####### ##### ####### ### # ### # # ### ###
 #         # #   # # #   # # # #   #   #   # # # #   #   #   #     #         #     #     # # #   #       #     #     # # # #   #
 ##### ##### ##### # # # # # # ### # ### # # # ##### ### ##### ### ### ####### ######### # # # # ####### ####### ##### # # ### #
     #       #     # # #   # # #   # #   # # #     # #   #   #   #   #       #     #   # #     #       #       # #   #   #     #
#### # ####### ##### ####### # # ### # ### ##### ### # # # # # # # # ####### ##### # # # ####### # ### ### ### # # # ##### #####
   # #         #   #     #     #     #   # #   #   # # # # # # # # #   #   #       # # #   #     # #       #   # # # #   #     #
 # # # ########### ##### # ##### ######### # # ### # # ### # # # ##### # # ##### ### # ### # ##### # ####### # # # # ### ##### #
 # # # #           #   # # #       #     # # #   # # #     # # #     #   #     #     # #   # #   # # #     # # #   #   #   #   #
 # # # # ########### # # # ##### ### ### # # ### # # ####### ####### # ####### ### ### # ### # # # # # ### ### ####### # # # ###
 #   # # #           # #   #   # #     # #   #   #   #       #       #   #   #   # #   # #   # #   # #   #     #   # # # #     #
 ### # # # # ######### ##### # # # ##### ##### ####### ####### ######### # ##### # # # # # ### ##### ### ##### # # # # ####### #
   #   #   # #       #   #   #   # # #   #   #         #     #       # # # #     # # # # #   #     #   #   # #   #   #     #   #
## # ### ### # ##### ### ####### # # # # # # ########### ### ####### # # # # ##### # ### ### ####### # ### # ##### ####### ### #
 # #       # #   # #   #         # # # # # #   #   #       #   #     #   #   # #   #   #   # #       # #   #   #   #     #     #
 # ####### # ### # ### ########### # # # # ### ### ####### ##### ############# # # ### ### # # ######### ##### # ### ### ##### #
 #     #   # #   #   # #           # # # #   #   #     # #   #   #   #   #   #   #   #     # # #   #   # #   # #   #   # #   # #
 ##### ####### ### # # # ########### # ##### ### ##### # # ### ### # # # # # ### ### ######### # # # # # # # # ### ### ### ### #
     #   #   # #   # #   #   #       #   #   #   #   # # # #   #   #   # # #       #     #   #   #   # # # #   #             # #
 ### ### # # # # ### ####### # ######### # ### ### ### # # # ########### # ### # # ### ### # # ######### # ##### # ######### # #
 #     #   #   # #         #           #     #   #     #   #   #       # #   # # #   #     # #     #   #       # # # #   #     #
 # ### ######### ######### # ######### ######### # ####### ### # ##### # ### # ##### ####### ####### # # ##### # # # # # ##### #
 #   #       #       #     #   #     #   #     # #           # # #     #   # #   # #     #   #   #   # # #   # # #   # # #   # #
########## # ######### ##### # # ### ### # ### # ######### ### # # ####### # ### # ### # # ### # # ### # # # ### ##### # # # # #
   #       #       #   #   # # # #   #   #   # #   #     #   #   # #       #   # #     # # #   #   # # # # # #   #     #   # # #
 # # ############# # ##### # # # ########### # ### # ### # # ##### # ####### # # ####### # # ####### # ### # # ### ######### # #
 # # #           # #     # # #   #           #     #   #   #     # #   #     # # #   #   #   #       #   # # # #   # #   #   # #
 # # ### ######### ##### # # ##### ##################### ####### # ### ##### # # # # ######### ######### # # # # ### # # # ### #
 # #   # #     #         #       #     #         #   #   #     # #     #     # #   #           #         # # # #     # # #     #
 ##### # # ### # ##### ### ##### ##### ######### # # # ### ### ######### ##### ########### # ### ########### # ####### # # #####
 #   # #   # #   #   # #       #     #   #       # #   # # #   #       #   #   #         # #   #             #   #   # # # #   #
 # # # # ### ##### # # # ##### # ### ### # ####### ##### # # ### ##### # # ### # ####### # ### ############### # # # ### # # # #
 # #   # #   #   # # #   #     # #   # # # #  S#   #   # # # #   # #     #   # #   # #   #   # #   #         # # # #   #     # #
 # ##### # # ### # # ##### ##### # ### # # # # # ### # # # ### ### # ####### # ### # # ####### ### # ### ### # # # ### # ##### #
 # # #   # # #   # #   #   # #   #     #   # # #     # # #     # #   #   #   #   # # #     #   #   #   #   #   # # #   #     # #
 # # # ### # # ### ### ##### # ### ########### ####### # ####### ### # # ##### ### # ##### # ### ##### ######### # ##### ### ###
   # #   # # # # #   #   # #   #                       #   #     #   # #   #   #   #     # # #   #   #   #       #   #   # #   #
#### ### # # # # ### ### # ####### ####### ##### ####### ### ####### # ### ##### ### ### # # # ### # # ### ##### ### ### # ### #
 #       # # # # #   #   #   #   # #     # #   # #       #   #       # # #     #   # #   #   # #   #   #   #   # # #   #   # # #
 # ##### # # # # # ### ### # # # # # ### ### # # ####### # ####### # # # ##### ### ### # ##### # ##### # ### # # # ### ### # # #
   #   # # # # # # # # # # #   # # # # # #   # #       # #   #     # # #   #   #   #   # #   #   #   # # #   #   # #   #   #   #
## # # # ### # # # # # # # ####### # # # # ### # ##### # ### # ##### # # # ##### ### ### # # ##### # # # ### ##### # ### #######
   # # #         # #   # #   #     # # #   # # # #   # # # #   #     #   #     #   # #   # #   #   #   #   #     # # # #       #
#### # # ######### ##### ### # ### # # ##### # # ### # # # ######### ######### ### ### ### ### ### # ##### # ### # # # ####### #
     #   #         #       #   #   # # #   # # #   # # # #     #           # #     #   #   # #     # #   # # # #   # # #     # #
 ####### # ############### ##### ### # ### # # ### # # # ##### # ### ##### # ####### ####### ####### # # # # # ##### # # # ### #
 # #   # #       #     #         # #   #     #   #   #         # #   #     #       #     #           # #   #     #   #   # #   #
 # # # # ####### # ### # ### # # # ##### ####### ############### # ### ####### ### ##### ############# ########### ### ### # ###
   # #     #   #   # # # #   # #   #         #   #   #           # #   #     # #   #   # #       #   # #         # #     # #   #
#### ####### # ##### # ### # # ######### ### # ### # # ########### # ####### # ####### # # ##### # # # # ####### # # ##### ### #
 #   #       #       # #   # #   #     #   # # #   #   #           #         #   #     # #     #   # #   #     # # #   #     # #
 # ### ########### # # # ####### ##### ### # # # ####### ####### # ############# # # ### # ### ##### ##### ### ### ### # # ### #
 #   #   #     #   # # # #     #     # #   # # # #       #   #   #   #             #   # #   # # #   #   #   #   #   # # # #   #
 ### ### # ### ##### # # # # # ##### # # ### # # # ####### ### ##### # # ############# # ### # # # ### # ### ### ### # # ### ###
   # # # #   #     # # # # # #   #   # # #   #   # #     #     #   # # #     #       # # #   # #     # # #   #     # # #     # #
## # # # ### ##### ### # # # ### # ### # ######### ##### ### ### # # # ##### # ##### ### # ### ##### # # # ### ##### # ####### #
 # #   # # #     #     #   #   # # #     #   #     #     #   #   #   # #   #   #   #     #   #   #   # # #   #       # #     # #
 # ### # # ##### ############# # # # ##### # ### ### ##### ### ####### # # ##### ######### ##### # ### # ### ######### # ### # #
       #       #   #     #     # # #   #   #     # # #       #         # #     #   #     # #     #     # #   #             #   #
 ##### ####### ### # ### ####### # # ### ######### # ####### ############### ##### ### # ### ########### # ### ##### # ####### #
 #         # #   #   # #     #   #   #   #     #   #           #   #       #          G#     #         # #   # #     # #     # #
## ####### # ### ##### ##### ######### ### ### ### ######### ### ### ##### ################### ### ##### ### # ######### ### # #
   #     # #   # #     #     #         #     #                 #     #     #       #   # #     # #       #   # #   #     # # # #
 ### ##### ### # # ### # ##### ######### ### ##### # ######### ####### ##### ##### # # # # ##### ######### ### # # # ##### # ###
   #     #     # # #   #   #     #     # #   #     # #     #   #     #     # #   # # #   #     #   #           # # #   #   #   #
## # ### ##### # ### ##### ##### # # # # # ### ##### # ### # ### ### ##### # ### # # ### ##### ### # # ######### # ### # # ### #
   # # #     # #     #   #     # # # #   # #       # #   # # #   # #       #     # #   #     #   #   #   #       #   # # #   # #
 ### # ##### # ##### # # ##### # ### ##### ######### ### ### # ### ############### ##### ####### ##### # # ####### # # # ### # #
 # #     #   # #   # # #     # #   # #   # #   #   #   #   #   #       #     #     #   # #     # #   # # #   #     # # # # # # #
 # ##### ##### ### # # ##### # ### # # # # # # # # # ##### ####### # # # # ### ##### # # # ### # # # # ##### ####### # # # # ###
 #           # #   # #     # #     # # #   # # # # #   #   #     # # # # #   #     # #   #   # #   # #     # #     # #   # #   #
 # # ####### # # ### ##### # ####### # ##### # # # ### # ### ### ### # # ### ##### # ####### # ##### ##### # # ### # ##### ### #
 # # # #         #   # #   # #       #   #   #   # # #   # # # # #   # # #   #   # #     #   # #     #         #   # #         #
 # # # # ##### ### ### # ##### # ####### ######### # ##### # # # # ### # # # # ### # ### # ##### ########### ### ### # #########
 # #   #   #   #   #   #       # #     #         #     #   # #   # #   # # # #   # #   # #         #       # # # #   #   #     #
 # ####### # # # ### # ##### ### # # ##### ### ####### ### # ##### # ### # ##### # ### ##### ##### ### ### # # # ####### ##### #
 #   #     # #       #       #   # #     #   # #     # #   # #     # #   #     # #   #       #   #     # # # #   #   # #       #
 ### # ##### ######### ### # # ### ### ##### ### ### # # ### ##### # # ####### # ### ##### ### # ####### # # ##### # # ####### #
 #   #     #   #     # #   # #     # #   # #   #   #   #           # #     #   #   # #   #   # # #   #     #   #   #       #   #
 ##### ### ### # ### # # # # ####### ### # ### ### ##### ##### ##### ##### # ##### # # # ### # # # ### ##### # # ########### ###
     #   # #   # #   # # # # #       # #   # #     #     #   # #   #       # #     # # # #   # # #   # #     #   #         #   #
#### # ### # ### ### # # # # ####### # ##### ####### ### # # ### # ##### ##### ##### # # ##### # ### # # ######### ####### ### #
   # # #   #   #   #   # # #         #               #   # # #   #     # #   #     # # #       # #             #   #     #     #
 # # # # ##### ### ### # ################### # # ####### # ### ####### # # # ##### # # ######### ### ######### # ##### # #######
 #   # #     #   # #   #       #   #   #   # # # #     # # #   # #     # # #     # #   #   #   #   #         # #       #       #
######## ### ### # ########### # # # # # # # # # # ### ### # ### # ##### # ####### ##### # # # ### # ### ### # ############### #
       #   #   # #   #   #   #   #   # # #   # # # # #   #   #   #   #   # #   #   #   # #   #   # #   # #   # #     #     #   #
 ##### ### ##### ### # # # # ######### ####### # # # ### ####### ### # # # ### # ### # # ######### # # ### ##### ### # ### # ###
 #   #   #   #     # # #   #   # #   # #     # # # #     #         #   # #   # #   # #         #   # #   #     # # # # # # # # #
 # # ### ##### ### # # ##### # # # ### # ### # ### ####### ####### ##### ### # ### ### ####### # ### ### ##### # # # # # # # # #
 # # #   #   # # # #   #   # #   #     # #   # #   #   #   #                         # #     # #   #   # #   #     # #   #   # #
 ### # ### # # # # ##### ### ########### # ##### ### # # ### ############# ######### # # ### ##### ### # # # ##### # ### ##### #
 #   #     # # #           #       #     # #   #   # # #   # #   #         #     # #   #   # #     #   #   #   #   #   #       #
 # # ####### # ########### ####### ##### # # # ### ### ### # # # # ### ##### ### # ### ### # # ##### ######### # ##### ####### #
 # #       # # #     #   #       #     # #   # #   #   #   # # #   # # #     # # #         # # #   # #   # #   #     #     #   #
 # ####### # # ### # # # # # # ####### # ##### # ### ######### ##### # # ##### # # ####### # # # # # ### # # ##### # # ### # ###
 #   #   # # #   # #   #   # #       # # #   #   #           # # #     # #     # # # #     # # # #         # #     # # #   # # #
 ### # # # # ### # ################### # # ################# # # # ##### # ##### # # # ### ### # ########### # # ##### # ### # #
 #   # # # # #   # #       #       #   # #         #   #     # # #   #   #       #   #   #     # #   #       # # #     #   #   #
 # ### # # ### ### # ##### # ##### # ### ####### # ### # ##### # ### # ################### ##### ### # ######### # ####### ### #
 # # # # # #   #     # #   # # #   #   #         # #   # #     # #   # # #         #     #   # #     # #         #   #   # #   #
 # # # # # # ### # ### # ### # # ##### ########### # # # ### ### # # # # # ##### # # ### ### # # ##### # ####### ### # # ### ###
   #   # #   #   #     #     # # #     #     #     # # #     # #   # # #   #     #   #     # # # #     # # #     # #   # #   # #
#### ######### ### ########### # # ##### ### ### ### # ####### ##### # ##### ############# # # # # ##### # # # # # ##### # ### #
   #           #   #         #   #     #   #   #   # #               # #   # #   #     #   # #   # #     #   # #   #     #     #
 ########### # # ### # ############### ####### ### ####### ########### # # # # # # ### ### # # ### # # ####### ##### ######### #
   #         # #   # # #             #         # #   #     #         #   # # # #     #   #     #   # #       #     #           #
## ### ### # # ##### # # ########### ########### ### # ##### ####### ##### # # ######### # ######### ####### ###################
   #   #   # #       # # #   # #       #         #   #     #   #   #   #   #   #     #   # #     #   #     #     #   #         #
 ### ### # # ######### # ### # # ### ### ####### # ##### # ### ### ### # ####### ### ##### # ### # ### ### ##### # # ####### # #
     #   # #         #   #   # # #   #   # #   # #     # #   #   #   # # #     #   #       # # # #   # # #     # # # #     # # #
 ######### # # ### ####### ### # ##### ### # # # ##### ######### # ### # ##### ########### # # # ### # # ### # # ### # ### # # #
 #       # # # #   #           #   #   #   # # #     #   #   #   #     #     #         # # # # #   #   #   # # #   # #   #   # #
 # ##### ### # ##### # ##### ##### # ##### # ##### # ### # # # ### ######### ######### # # # # # # # ##### # # ### # ####### ###
 # #         # #     # #   #     # #     # #   #   #   #   # # #   #       # #     #       # # # # #   # # # #   # #     #     #
 # ### ####### # ##### # # # # ### ##### # ### # ########### ### ### ##### # # ### # ####### # # # # # # # ##### # ##### ### # #
 #   # #     #   #   #   # # #   #       #   # # #     #     #   # #     # #   # # #   #     # # # # #   # #     # #   #   # # #
 ### ### ### ##### # ##### # ### ######### # # # # ### # ##### ### # ### # ##### # # ### ##### ### # ##### # ### # # # ### # # #
   #     #   #     #       #   #           #   #     #               #   #                   #     #     #   #   #   #       # #
