################################################################################################################################
################################################################################################################################
#   # #           #         #   #               #         #     #   #   #     #       #   #   #   #   #   # #             #     
### # # ######### # ##### # # # # ####### # ##### ####### # ### # # ### # ### # ##### # # # # # # # # ### # # ######### # # ### 
#   # #     #     #   # # #   #   # #     # #   # #     #   # #   #   # # #   # #   # # #   # # #   #     # # #       # # #   # 
# ### ##### # ####### # # ### ##### # ##### # # # # ### ##### ####### # ### ### # # # # ##### # ########### # ####### # ##### ##
# # # # #   #           #   # # #   #     #   # # # #   #   #       # #   #   # # #   #   #   # #   # #     # #       #   # #   
# # # # # ################# # # # ####### ##### # ### ### ### ##### # ### ### ### ### ### # ### # # # # ### # # ######### # ### 
#       # #       #   #     #   #       #   #   #   # #   #   #     #     # #   #   # # # # #   # # #     #   #   #       # #   
# ####### # # ### # # # # ############# ### # ##### # # ### ############### ### ### # # # ### ##### ##### ##### # # ####### # ##
# #       # #   #   # # # #     #     # #   # #     # #   #   #       #   # #       #   #   #   #   #   #       # # #       # # 
# # ####### ### ##### # ### ### # ### # # ##### ##### ### # ### ##### # # # # ####### ##### ### # ### # # ####### # # ####### # 
# # #         #   #   #     # # #   #     #   # #         # #       # # #     #     # #     #   #     # # #   #   #   #   #   # 
# # # ############# ######### # ########### # # # # ####### # ####### ######### ### # # ##### ######### # # # ##### ##### # ### 
# # #     #       #           #       #     #   # # #       # # #   #   #     # #   #                 # # # # #   # #     # #   
# # ####### ##### ######### # ####### # ########### # ####### # # # ### # ### # # ################### # # # ### # # # ##### # # 
#       #   #   # #   #   # #   #     #     #           # #   # # #   # # # #   #     #     #   #     #   #     # # # #     # # 
# ##### # ##### # # # # # ##### # ### ##### ########### # # ### # ### # # # ######### # ### # # # ##### ######### # # # ##### ##
#     #   #   # #   #   # #     #   # #   #   #     #     # #   #   #   # # #     #   #   #   # # #         #     #   # #       
### # ##### # # ######### # ####### # # # ### # ### # ### # # ##### ##### # # ##### ##### ##### # # ######### ####### # ####### 
#   #     # # # #       # # #     # # # #   #   # # #   # # #     # #   #     #   #       #   # # # #         # #   # #         
# ### ##### # # # ##### # # # ##### ### ### ##### # # # ### ##### # # # # ##### # ### ##### # # # # # ######### # # # ######### 
# #   #     #   # #   # # #   #     #   #   #       # #   #   #   #   # # #   # #   #   #   #   # # # # #         # # #   #     
# # ### ########### # # # # ### ##### ### ### ####### ### ### # ####### # # # # ### ##### ####### # # # # ######### ### # # ####
# # #   #     #     #   # #   # #     # #     #   #     #     # #       # # #   # #       #           # # #   #   # #   # # #   
# ### ####### # ### ##### # # # # ##### ####### ### ### # ##### # ####### ####### ######### ##### # ### # ### # # # # ### # # # 
#   # # #     #   #     # # # # #   #           #   #   #   #   #   #     #   # #   #       #     #       #   # # #   #   #   # 
# # # # # ##### # ####### # ### ### ### ######### ### ### # # ##### # ##### # # # # # ### # # ##### ####### ##### ##### # ##### 
# #   # #       # #     # #   #   #   #         # #   # # # #     # #   #   # #   #   #   # #     #   #   #     # #     # #     
# ##### # ####### # ### # ### # ##### # ####### # # ### # # ##### # ### # ### # ####### ######### ### # # ##### # # ### ### ####
#         #     # # # # #   # #   #   #   #   #   #   #   #       #   #   #   # # #     #   #     #   # #     #   #   # #   #   
# # ####### ### ### # # ### # ### # ##### # # ####### ##### ######### ##### ### # # ##### # ####### ######### ### ### ### ### # 
# #   #   #   #     # #     # # #   # #   # # #   #   #             #     # #   #   #     #   #     #       # #     #     #   # 
# # ### ##### ####### ####### # ##### # ### # # # # ##### ############# ### # ####### ####### ### ### # ##### # ########### ### 
# #     #   #   #           # # #   #   #   # # # #     #       #     #     # #         #     #   #   #   #   #     #         # 
# # ##### ##### # ### ### # # # # # # ### ### # # ##### ####### # ### ####### # ####### # ##### ### ##### # ### ### # # # ### # 
# #     # #     #   #   # # # #   # # #     # # # #     #     #   # #             #   # #   #   #   #   #   #     # # # # #   # 
# ##### # # ##### # ##### ### # ##### # ##### # # # ##### ### # ### # ### ######### # ##### # # # ### # ##### ### # # # # ######
#   # # #   # #   #     #     #         #     # # #         # #   # # #   #       # #   #   # #   # # #         # # # # # #     
### # # ##### # ####### # ##### ####### ####### ########### # ### # ### ### ##### # ### ##### ##### # ##### ### # # # # # # ### 
#   #           # #     #       #     #         #         # #   # #     #   #   #   # #     #         #   # # # # # # # # #   # 
# ####### ####### # ##### ### # # ### ########### ####### # ### ######### ### # ##### ##### # ######### # # # # # # # # # ### # 
# #     #         # #     # # # # #S#           #   #     #   #     #   #   # #     #   #   #         # # # #   # # # # #     # 
# ##### # ######### # ### # # # # # ########### ### # ##### # ##### # # ### ####### # # # ####### # ### # # ##### # # # ########
#     # # #   #     # #   #   # #     #     # #     #   #   #   # # # #   #       #   # #   # #   #     # #   #   #   # #       
##### # # # # # ##### # ####### ##### # ### # ######### ### ### # # # ### ####### ##### ### # # ######### ### ######### # ##### 
#   #   # # # #   #   #     #   #   # #   #       #   #   #   #   #   #   # #   #     #     # # #           #         #       # 
# # ####### # ### ######### # ### # # ### ####### # # ### ### # ####### ### # # ##### # ##### # # ####### # ######### # ####### 
# # # #     #   #       #   # #   # #   #     #   # #   # #   #       #     # #     # #     #   # #   #   #         # #   #   # 
# # # # ####### ####### # ### # ####### ####### ### ##### ######### # ####### ### ### ##### ##### ### # ### # ####### # ### # # 
# #   # #   # #   #   # #   #     #   #   #         #     #     # # #   #   #   #   # #   #   #       #   # #   #   # # #   #   
# ##### # # # ### # # # ### ####### # ### # ######### ##### ### # # # ### ##### ### # # # ### # ######### # ### # # # # # ######
#   #   # #     #   #   # #         # #   #   #       #     # # #   # #   #     #   # # #   # # #   #     # #   # #   # # #     
### # ### ##### ######### ########### # ##### # ####### ##### # ##### # ### ##### ### # ### # ### # ##### # ##### ##### # # ### 
# # #   #     #             #     #   #   #   # #   #   #     # #   #   #   #   # #   # #   #     # #   # #     #   #   # # # # 
# # ### ################# # ### # # ##### # # # # # # ### ##### # ### ### ##### # # ##### ######### # # ####### ### # # # # # # 
#   #   #         #       #   # # # #     # # #   #   #       # #   # #   #   # # #       #       #   #   #     #   # # #   # # 
# ### ### ####### # ######### ### # # ##### # ######### ####### ### # # ### # # # ######### ############# # ##### ##### ##### # 
#     # #   #     #     #   # #   #   #     #         # #     # #     # #   # # #   #     # # #       #   #     # #           # 
####### ### # ######### ### # # # ##### # ########### # # ### # # ##### # ### # ### # # # # # # ##### # ######### ### # ### ### 
#     # #   #   #     #   # # # # #     #     #     # # #   # # #   #   #   #     #   # #     # #   #   #     #   #   # #   #   
# ### # # ####### ### ### # # # # # # ####### # ##### # ##### # ##### ### # ########### # ##### ### ####### # # ### ### ##### # 
#   #   #       # # #     # # # #   # #     # #   #   #   #   #   #   #   # #           # #   #   # #       #   #   #   #     # 
### ########### # # ####### # ####### # # ### # # # ##### # ##### # ### # # # ############# # ### # # ########### ####### ##### 
# # #   #     #   #         #   #   #   # #   # # # #     #   # #   # # # # #   #         # #     # # #     #     # #   #   #   
# # # # # ### ##### ### # # ### # # ####### ### ### ##### ### # ##### # # ##### # ####### # ####### # # ### # # # # # # ### ####
# #   # # #     #   # # # # #   # # #   #   #   #   #       # #   #     #     #   #     # #     #   #   #   # # # #   #   #     
# ##### ### ### ### # # # # # ### # # # # ##### # ### ##### # # # ##### ############### # ##### ### ##### ##### # ####### ##### 
# #   #   # # #   # #   # # #     #   #   #     # #   #     # # #     #     #     #     # #     #     #   #     #     #   #     
# # # ### # # ### # ##### # ################### # ##### ### # # ##### ##### # ### # ##### # ##### # ### ### ##### ##### ### ### 
# # #     # #       #     #       #             #   #   # # # #     # #   #     #   # #   # #     # #   #       #       #   #   
# # ####### ######### ####### ### # ########### ### # ### # # ##### # # # ##### ##### # # # # ##### # ######### ######### ### # 
#   #       #       # #       #   # #     #   # #   # #   # # #     #   #     # #     # # # #   #   # #   #   #     #     #   # 
# ### # ##### ##### # # ####### ### # ### # # # # ### # ### # # ############# # # ### # ### # ### # # ### # ####### # ##### ### 
# #   # #     #       #       #     #   # # #   # # # #   # #G# #   #       # # # #   # #   # #   # #     #         # #   #   # 
# ### # # ################### ######### # ##### # # # # ### # ### # ##### ### # # ##### # ### # ### ################# ### # # # 
# #   # #           #       # # #     # #       # #   # #   #     # #     #       #   #   #   # #   #     #       #   #   # # # 
# # ### ########### # ##### # # # ### # ####### # ##### # ######### # ### # ####### # ######### # ### # # # ##### # ### ##### # 
# #   #       #   # # # #   #   #   #   #       #   #   # #         #   # #   #     # #         # #   # # #     #   # #   #   # 
# ### # # ### # ### # # # ######### ##### ######### # ### # ########### # ### # ##### ##### ##### ### # # ##### ##### ### # ### 
#     # # # # #     #   #         # #   # #       # #     # # #     # # #   # # #   # #     #   #   # # #     #   # #   #   # # 
######### # # ################### # # # # # ##### # ##### # # # ### # # ### # # # # # # ##### # ### # # ##### ### # ### ##### # 
#   #   # #       #     #       # # # # # #     # #     # # #     #   #   # # # # # #   # #   #   # # #   #   #   #     #   #   
# ### # # ### ### # # ### # ##### # # ### ####### ##### # # ##### ####### # # # # ####### # ### ### # ### # ### ####### ### ### 
# #   #   #     #   # #   #       # #     #     # #   # # #     #         #   # #     #   #   # #   #   # #   # #     #         
# # ######### # ####### ########### # ##### ### # # # # # ##### ### ######### # ##### # ##### # # ####### # ### # ### ######### 
# # #     #   #   #     # #         #     # #   #   # # # #   # #   #       # #   #     #     # #         # #   # #   #         
# # # ##### ##### # ##### # # ##### ##### ### ### ##### # # ### ##### ##### # ### ##### # ##### ########### # ##### ### ####### 
#   #       #   # #     # # # #   # #   # #   # # #     # #   # #     #         #     #   #       #     # # #       #       #   
########### # # # ##### # # # # # # ### # # ### # # ##### ### # # ##### # ########### ##### ##### # ### # # ########### ### ####
#         # # #     #   #   #   # #   #   #       #   #       # #     # # #   #     #     #     # #   # # # #           #   #   
### ##### ### ### ### ############### ### # ######### ####### # # ##### # # # # ### ##### ##### # ### # # # # # ######### ### # 
#   # #   #   #   #   #             # #             #   #   # # # #     # # #   #   #   # #   # # # # #   # # #         #     # 
# ### # ### ### ### ### ########### ### # ####### # ### # ### # ### ##### # ##### ### # # # # # # # # ### # # ######### ####### 
# # # # #   #   #   #   #         #     # #   #   # #   #     #   # # #   #     # #   # # # # # # #   #   # #       #         # 
# # # # # ##### # ### ########### ####### # # ####### ####### ### # # # ####### # # ### # # # # # ##### ### ### # ### ######### 
# # #     #   # #     #         # #     #   #     #   #     #   # # #   #       #   # # #   # # # #     #   #   #   #         # 
# # ### ### # # ####### # # ##### # ### ### ##### # ### ### ### # ### ### ########### # ##### # # # ### # ### ##### ######### # 
# # #   #   # # #     # # #   #   # # #     #     #   #   #   #         # #   # #   #   #     # # # #   # #   #         #   # # 
# # # # # ### # # ### # # # # # ### # ##### ######### # # ### ##### ##### # # # # ####### ####### ### # # ### # ######### # # # 
# #   # #   # #     #   # # #     # # #     #       # # # #   #   # #     # #   #     #         #   # # # #   #   #     # #   # 
# ####### ### ########### ######### # # ### # ##### # ### # ### # # # ######### ##### # # ##### ### # # # # ##### # ### ####### 
# #     # #   #   #     #     #     # # # # # #     #   # #     # # #   #       #   #   #     # # # # # #   #     #   #   #   # 
# # ### # # ### # # ### ##### # ##### # # # # # ####### # ####### # ### ### ##### ##### ####### # # # # ##### # ##### ### # # # 
#   # #   #     #   # # #   # # #     #   # # #       #   #   #   #   #   #             # #     # #   # #   # #     # #     # # 
# ### ########### ### # # ### # # ######### # ############# # # ### # ### # ######### # # # ##### ##### # # # ##### # ####### # 
# #       #     #     # #     #   #     #   #         #   # # #   # #   # # #     #   #   # #   # #     # # # #     #     # #   
# # # ##### ### ####### ########### ### ### ######### # # # ##### # ### # # # ### ### ##### # # # # ##### # # # ######### # ### 
#   # #     #           #   #       # #                 # # #   # #   # # # # # #   #   #   # #   #     # #   # #       # # #   
##### # ##### ######### # # # ####### ##### ####### ##### # # # # ##### # ### # ### ##### ### ######### # ##### # ##### # # # ##
#     # #     #     #   # #   #       # #   #     # #   # #   # #     # #     # #   #     # #   #   #   # #   # # #   #   # #   
# # ### # ##### ### ##### ##### ##### # # ### ### # # # # ##### ##### # ####### # ### ##### ### ### # ##### # # # # # ##### ### 
# # #   #     #   #   #   #   #   # #   # #   #     # #     # #   #             #     #     #   #   #       #   # # #     #     
# # # ########### ### # ### ##### # ##### # ######### ##### # ### ### # ####### ########### # ### # ### ######### ##### ####### 
# # # #             # # #       #         # #       # #   #     #     # #     #             #     #     #         #   #   #   # 
# # # # ############# # # ############# ### # ##### # # ####### ##### # # ### ############# ### ##### ### # ####### # # # # # # 
# # #   #   #         # #               #   # #     # #               # #   # #         #   #   #     #   # #       # # # # # # 
# # ##### # ########### ############# ### ##### ##### ############### # ### # # ####### # # ### # ##### ### # ####### # ### ### 
# # #   # #             #   #       #   # #     #   #         #   #   #     # # #     #   #     #   #   #   #     # # #   #     
# # ### # ############### # # ##### ### # # ##### ########### # # # ######### # # ### ############# # # ######### # # ### ##### 
# # #   # #         #     # # #         # # #   # #     #     # # #     # #   # # # #       #     # # # #   #       # # #   #   
# # # ### ######### # # ### # # ######### # # # # # ##### ##### ##### # # # # # # # ####### # ### # # ### # # ####### # ### # # 
# #     #   #     #   # #     # #   #     #   # # # #   # #           #   # # #   # #     # # # # # # #   # # #       #   #   # 
# ### ##### ##### ### # ####### # ### ######### # # # # # # ########### ### # ##### # ### # # # # # # # ### # ######### ####### 
#   # #   #     # #   #   #     # #   #     #   # # # # # # #       #     # #   #   # # # # #   # # #   # # #       # #       # 
### # # ####### # # # ### ####### # ### ### # ### # # # # # # ##### ####### # # # # # # # # ##### # ##### # ####### # # ####### 
#   # #         #   #   #         #       #       #   #   # #     #         # #   #   #   #     #         #         #           
################################################################################################################################
