################################################################################################################################
################################################################################################################################
   #         #   #         #       #     #   #               #       #         #         #   #           #     #       #       #
 ### ######### # # ######### ##### # ### # # # ############# # ### # # ####### # ####### # # # ####### ### # ### # # ### #######
     # #       # #         # #   # #   # # #       #       #   # # # # #   #   #   #     # # # #     # #   # #   # #     #     #
 ##### # ####### ### ##### # # # # ### ### ######### ##### # ### # # # # # # ####### ##### # # # ### # # ### # ### ####### ### #
 #     # # #   #   # #   # # # # # #   #   #   #     #     #   # # # #   # # #       #     #   #   # # #   # #   # #       #   #
 # ### # # # ### # # # # ### # # # # ### ##### # ##### ##### # # # ####### # ### # ### ######### ### # ### # ### # # ####### ###
 #   # # # #   # # #   # #   # # # #     #   # #   #   #     #   # #       #   # # #   #   # #   #   #   # #     # # #     #   #
 ### # # # ### ### ##### # ##### # ### ### # # ### # ############# # ######### # # # ### # # # ### ####### ####### # # ####### #
 #   # #   # #     #     #       #   #   # #   #   #       #   #   # #         # # #     #   #   # #       #     # #   #     # #
 # ### ### # ####### ########### ### ### # ### # ####### # # # # ### ############# ####### ##### ### ####### ### ####### ### # #
 #   # #   #     # #   #     # #   # #     #     # #   # #   # # # # #   #   #       #   # #   #   #   #     # #     #   # #   #
 ##### # ####### # # # # ### # ### # ########### # # # ####### # # # # # ### # ##### # # # # # ### ### # ##### ##### # ### #####
           # #   #   # #   # #   # #       #   # # # #       # #   #   #   #   #   # # #   # #   #   # # #       #   # #       #
 ######### # # ### ######### ### # ####### # # # # # ####### # ########### ##### # # # ##### ####### # # # ####### ### # #######
 #     # # # #                   # #       # # # # #   #   # # #         #     # #   # #     #       #   #   #   # #   #   #   #
## ### # # # # ################### ########### # # ### ### # # # ####### ##### ##### # # ##### ########### # # # # # ### ### # #
   #   #   #   #                 #   #       #       # #   # # #   #   # #   #     #   # #   # #       # # #   #   # #   #   # #
 ######### # ### ########### ### ### ####### # ####### # ### ##### # ### ### ##### ### # # # # # ##### # # ######### # ### ### #
 #   #   #           #     #   #     #     # #       #   #   #   # #   #   #     #     # # #     #   # # # #   #   # #   # #   #
 # # # # # ########### ### ### ####### ### # # ##### ### # ### # # ### ### ##### ##### # # ######### # # # # ### ### # ### # ###
 # # # # # #   #       # # # #       # # #   #   #   #   # #   # # #   # #     #           #       #       #   # #   #     # # #
 # # # # # # # # ####### # # # # ### # # ####### # ### ### ##### # # # # ##### # # # ####### ##### ####### ### # # ### ##### # #
 # #   #   # # # #     #   #   #   #           # # # #   #       # # # #         # # # #     #   #       #       # #       # # #
 # ##### ### # # # ### ########### ##### # # # # # # ### ######### # # # # ### ##### # # ##### # # ##### ##### ### # ##### # # #
   #     #   #   #   # #         #     # # # #   #     #   #       # # # #   # #     # #   #   # # #   #       #   #   #   #   #
#### ### # ######### # # ####### # ### # ### ####### ##### ##### ### # ####### # ##### ### ##### ### # # ##### # ##### # #######
     # # #   #       # # #   # # # #   #   # #     #     #   #   #   #       # #       # #       #   # # #     #   #   # #     #
 ##### # ### # ### ### # # # # # ### ### # # # ### ### ##### # ##### ####### # ######### ######### ### ### ### ### # ### ##### #
     # #   # #   # # #   # #   #     #   # # # #     # #   #   #     #   # #       #       #       # #   #   # # # # #   #   # #
#### # ### # ### # # ######### ####### # # ### ##### ### # ##### ##### # # ### ### # # ### # ####### ### ### # # # # # ### # # #
     #   # #   # # #           #       # #   #   # #   # # # #   #     # # #   # #   #   # #   #       #   # #   # # # #   #   #
 ##### # # ### # # # ### ##### # ### ### ### ### # ### # # # # ######### # # # # ####### # ### ####### ### ##### # # # # ##### #
     # #   #   # # #   # #   # #   # #     # # #   # #   #   #         # # # #   # #     #   #       #   # #   # #   #   #   # #
###### ##### ### # ##### # # # ### # # ##### # ##### ####### ####### ### # # ##### # ########### ### # # # # # # # ####### # ###
 #   # #   # #   #   #   # # # #   # # #   #   #   #     #         # #   #   #     # # #       # #   # # # # # #   #       #   #
 # # # ### # ####### # ### # # ##### # # # ##### # # ##### ######### # ##### ##### # # # ##### ### ### # # # # ### # ######### #
 # # #     # #   # # #   # #         #   #     # # # #     #       # #     #   #   #   #     #     # # # #   #     # # #     # #
 # # # ##### # # # # # # ##################### ### # # ##### ##### # ##### # # # ########### ####### # # ######### # # # ### # #
 # #   #     # # #   # #     # #       #     #     # # #     #     #     # # # #   # #   #   #       # #   # #   # #   #   #   #
 # ##### ##### # # ####### # # # ##### # ### # ##### # # ##### ####### ### # # ### # # ### ### ####### ### # # # # ####### #####
   #     #     # # #     # #   #     # # # # # # #   # #   # #   #   #     # #   #   #     #     #   #   # # # # #       #     #
 ### ##### ### # ### ### # ######### # # # # # # # ### ### # ##### # ######### # ### ####### ### # # ##### # # ### # ### ##### #
 #   #     #   #     #   #   #       # # #   #   # #   # #       # #           #   # #         # # # #       # #   #   #     # #
 # ### ##### ######### ##### # ####### # # ####### # ### ####### # ### ### ######### # ### # # ### # # ####### # ########### # #
 # #   #     #       # #     #     # #   #     #   #     #     #   #   #   #         # #   # #   # #     #   #   #   #     # # #
 # ##### ##### ####### # # ####### # ######### # ####### # ### ####### # ### ######### # ##### # # ####### # ##### # # ### # # #
 #       #   #   #     # # #     #   #   #     # #     #   # # #       #   # #   #     #     # #   #     # #     # #   #   # # #
 ######### # ### # ##### # # ########### # ##### ##### ##### # ### # ##### # ### # ### ##### # ##### ### # ##### ####### ### # #
 #     #   # #   #   # # #   # #   #     #     #     # #   # #     #   # #   #   #   #     # #     #   # #   #         #       #
 # ##### ### # ##### # # ##### # # ##### ##### ##### # # # # ##### ### # ##### ##### ##### # ### ##### ##### ######### ####### #
 #         # # #     #         # #       #   #           # # #     # # #       # #   #     # #   #     #     #   #     #       #
 # ##### # # # # ##### ##### ### ####### # # ### ####### ### # ### # # # ####### # ### ##### ##### ##### ##### # # ##### ##### #
 # #   # # #   #   #   #   #   #   #   #   #     #     # #   # #   # # #   #       #   #   #     # #   # #     # #     # #     #
 # # # ### ####### ##### # # ##### # # # ######### ### # # ### # ### # ### # ####### ### # ##### # # ### ####### ##### ### ### #
   # #   # #   # #       # #   #   # # # #         # # # #     #     # # #   #     #     #     # # #   # #       #   #   # #   #
 ### ### ### # # ######### ### # ##### # # ####### # # # ####### ##### # ### # ### # ######### ### # # # # ######### ### ### ###
 #   # # #   #   #   #   #   # #       # #   #     # #     #     #     #     # #   #         #     # # #   # #         #   #   #
 # # # # # ##### # # ### ### # ######### ### ####### ##### # ##### ##### ### # ##### ### ### ####### ####### # ########### # ###
 # # # #   #   # # #   # #   #   #   #   #   #       #   #   #   # #       # # #   # # #   #   #             # #   #       #   #
 # ### ##### ### ##### # # ####### ### # # ### ####### # ##### # # # ### # ### # # # # ### # # # ######### ### # ### ####### # #
 #     #     #   #   #   #   #     #   # #   #   # #   # #   # #   #   # #   #   # # # #   # #         #   #   # #   #       # #
 ####### ##### ### # ### ### # ##### ### ### ### # # ### # # # ##### # ##### ##### # # # ### ########### ### ### # ### ####### #
 #       #     #   #   # #   # #     #   # #     # #   # # # # #     #     #       #   # #   #           #   #   # # # #   #   #
 # ####### ##### ### ### # ### ### ### # # ####### ### ### # # # # ####### ######### ### # ### ######### # ### ### # # # # #####
 # #     # # #   #   #   #   #     #   # # #   # #   #     #   # #   #     #   #     #   # #   #   #     # # # # # #   # #     #
 # ### ### # # ### ### ##### ####### # ### # # # # # ########### ### # ##### # ### ### ### # ##### ####### # # # # # ### ##### #
   #   #   #     #         # #       #     # # # # #     #       #   # #   # #   # #   #   #     # #       # #   # #   #     # #
 ### ### ### ############# # ####### ####### # # # ##### ####### # ### # # # ### # # ##### ##### # # ####### ### # ### ##### # #
   #   # # # #       #   # #         #     # # # # #   #       # #   # # #     # # #     #     #   #       #   # #   #   #   # #
## ### # # # # ##### # # ########### # # ### # # # # # ####### # ### ### ####### ####### ##### ########### # ### ### # # # ### #
       # #   # #   #   #       #       #     # #   # #   #     #   # #   #       #   #   #   # #     #   #         # # #   #   #
 ##### # ### # # # ####### ##### ### ######### ##### ### # ####### ### ########### # ##### # ### ### # # # ######### ##### #####
   #         #   #       # #     #   #   #   # #   # # #   #   #                   #       #     # # # #   #         #   #     #
## # ####### ########### # # ####### # ### # # # # # # ####### ######### ######################### # # ##### ######### # # ### #
   # #     #     # #   # # #   #   # #     #   # #   # #     #   #     #     #             #     # #   # #   #       # # # #   #
#### # ### ### # # # ### # ### ### # ########### ##### # ### ### # ### ##### # # ### ##### ##### # ##### # ##### ### # # # #####
     #   #     #     #   #   #     #                     # #     #   # #   # # #   # #   # #     #       #     # # #   # # #   #
 ####### ######### ### ##### ######### ##### ### # ### ### ########### # # # ####### # ### # ##### ##### ##### # # ##### # # # #
 #   #   # #     #   #     #     #     #   # # # #   # #   #   # #     # # #         #     # # #       #     #   #     # #   # #
 # # # ### # ### ### # ####### ### ##### # # # # ### # # ### # # # ##### # ########### ##### # # ##### # ### ##### ### # # ### #
 # # #     #   #   # # #       #   # #   #   #   # # #       #   #   #   #       #     #   # #   # #   # # #     #   #   #   # #
 # # ############# # # # ####### ### # ########### # ### # ######### # ##### # ### ####### # # ### # ### # # ### ### ####### # #
 # #   #     #     # # # #   #   #   #     #   #   #   # #   #   #   # #   # #     #       # #     # #   #   #   #       #   # #
 ##### # ##### ##### # ### # # ##### ##### ### # ##### # ### # # # ### # # # ####### ####### # ##### ############# # ### # ### #
   #   #   #   #   #       # #     #     #     #   #   #   #   # # #   # # #                       #     #         #   #   #   #
## # ### # # ### # ######### ##### ##### ######### # ##### ##### # # # # # ####### # ##### # # ### ##### # ######### # ####### #
   # #   # #   # #       #       #   #     #       #S#   #     #   # # # #   #     # #     # #   # #   # # #   #     # #     # #
 ### # ### ### ######### ### ### ### # ### # ####### # # ##### # ### ### ### ######### ##### ### # # # # # # # ####### # ### # #
     # #     #   #         #   #   # #   #         #   #   #   #   #   # #       #   # #     #   # # # # #   # #   #   # # # # #
 ##### # # # ### ######### ### ### # ############# ####### ##### # ### # ####### # # # # # # ####### # # ##### # # ##### # # ###
       # # #   #         #     #   #   #   #   #     #   #   #   #     #   #   # # #   # # # #   #   # #     #   #     # # #   #
######## # ############# ####### ##### # # # # # # ### # ### # # ### ##### ### # ####### ### # # # ### ##### ######### # # ### #
     #   #   #   #   #   #       #   #   # # # # # #   #     # #   #     #     #   #   # #   # #   #   #             #   #   # #
 ### ######### # # # # ### ####### # ##### # # ### # ######### ### ##### ######### # # ### ### ##### ### ####### ### ##### ### #
   #   #   #   # # # #   #   #   # # #     # #     # #   #   #   # #     #     #   # #     #   #     #         # #   #   # #   #
 # ### # # # ### ### ### ### ### # # # ########### # # # # ### # # # ##### ### # ### # ##### ### ############# # # ##### # # ###
 # # # # #   # #   #   #   # #   # # # #   #       #   # #   # # # #       #   # #   # #     #   #   #     #   # # #   #   # # #
 # # # # ##### ### # ##### # # ### # # # # # ########### ### # # # # ########### # ### # ##### ### # # ### # ### # ### # ### # #
 # # # # #   #     #             # #   # # #   #     #   #     # # # #           #   # #     # #   #   # # # # # #   #     #   #
## # # # # ######### ############# ####### ### # # # # ######### # ### ############# # # ##### # ####### # # # # ### # ### #####
   #                             # #     #     # # # #         # #     #     #       # # #     # #     # #   #   #   #   # #   #
 # ##### ##### ################# # ##### ##### # # ########### ########### # # # ####### # ##### # ### # ####### # ### # # # # #
 # #   # #   #     #             #   #G# #   # # #         #   #   #     # # # # #       #   #       # # #       #   # # # # # #
 ### # # # # ### # ############# ### # # # # # # ### ##### # ### # # ### # ### # # ######### # ####### # ##### ##### # # # # ###
 #   # # # #   # #   #   #         # #   # #   #   #     # #     #   #   # #   # # #   #   # # #   #   # #     #   # # # # #   #
## ### # # ### # ### # # ####### # # ### # ### ### ##### # ########### ### # # # # # # # ### # # ### ### # ##### ### # # ##### #
   # #   #   # # # # # #         # #   # #   # #   #   # # #     #   # #   # # #     #   #   # #   # # # #     #   # # #     # #
 ### # ##### # # # # ########### ##### # ### # # ### # # ### ### # ### ### # # ########### ####### # # # ##### ### # # ##### # #
 #     #     # #   #         #   #     #     # # #   # #     #   #   #   #   # #   #     #       #   #           # # #     #   #
 # ##### ##### ############# ##### ########### # # ### ##### # ##### ### ####### # # ### ####### ############# # # # ##### #####
 #     #     #       #     #   #   #         #   #   # #   # #         #         #   #   #     # #       #     # #   #   # #   #
 ##### ##### ####### # ####### # ########### ### ### # # # ########################### ### ##### # ##### # ### # ##### ### # # #
 # #   #   # #     # #         #           #   # #   # # #     #         #           # # #     # # # #   #   # #           # # #
 # # ### ### # ##### # ################### ### # # ##### ##### # ####### # # ####### # # ##### # # # # ##### # ### ### # ### # #
 #     # #   #       # #       #     #   #   #   #       #   #   #     #   # #   #   # #         # #   #     #   #   # #     # #
 ##### # # ### ######### ##### ##### # ##### ### ########### ##### ####### ### # # ### ##### ##### ##### ####### ##### ##### # #
   #     # # #   #       #   #       #       # #     #     #     #         #   # # #   #   # #     #     #     #     # #     # #
## ##### # # ### # ### ### ######### ######### ##### ### # # ### ######### # ### # # ### # ### ######### # ### # ### # ####### #
 #   #   # # #   # #   # # #         #         #   # #   #   #   #         #   # # #     #     #       # #   # #   # #     #   #
 ### # # # # # ### # ### # # ######### # ####### # # # ####### ### ########### # # ############# ##### ##### # ### # ##### ### #
     # # #   #   # #   #   #         # # #       # #   # #   #   #   #         #   # #   #         # #       # #   # #   #   # #
###### # ####### ##### ### ######### # # # ####### ##### # # ### # # # ########### # # # ######### # ######### ##### # ##### ###
   #   #   #   #       #   # #     # # # #     #   #   #   #   # # # #   #     # #   # # #         #     #   #   #   # #   #   #
 # # ##### # # ######### # # # ##### ### ##### ##### ######### # ### ### # ### # ### # ### ############# # ##### # ### # # ### #
 #   #       #           #                                             #   #   #           #                       #     #     #
################################################################################################################################
