################################################################################################################################
################################################################################################################################
   #     #   #     #         #     #               #     #       #   #   #   # #     #     #   #     # #     #   #   #   #     #
 # # ### # # # ### # ######### ### # ####### ### # ##### ### ### # # # ### # # # ### ##### # # # ### # # ##### # # # ### ##### #
 # # # # # # # # #   #   #   # # #   #   #   #   #     # #   #   # #   #   # # #   #    G#   # # #   # # #     # # #   #   # # #
 # # # # ### # # ##### # # # # # ##### # # ### ##### # # # ### ### ##### ### # ### ##### # ##### ##### # # ##### # ### ### # # #
 #   # # #   # #   # # #   # # # #     # # #   #     # # # # #   #     #   # #   # #     #     #       # #   # # # # # #       #
 ##### # # ### # # # # ##### # # # ##### # ### # # ##### # # ### # ####### # ### # # ######### ### ### # ### # # # # # # #######
       # #   # # # # #   # # #   # #     # #   # # #     #   # # #         #   #   # #   #         #   #     # #   #   #   #   #
###### # ### # # # # ### # # # ### ####### # ##### # ######### # # ######### ####### # # # ######### # ####### ##### ### ### # #
   #   #   # #   #     #   #   #   #       #     #             # # #       #         # # #   #       #       #               # #
 ### ##### # ####### ##### ##### ### ####### ### ##### # ### ### # ### ############### # ### # ####### ##### # ############### #
 #   #   # # #       #   # #   #     #         #     # #   # #   #   # #       #   #   #   # #   #   # #   # #       #       # #
 # ### ### # # ####### # # ### ############### ##### ### # ### ##### # # # ##### # # # ### # ### # # ### # # ##### ### ##### # #
 #   #   #   #     #   #             #       # #   #   # #   #   # # # # # #   # # # # #   # #   # #     #     # # #   # #   # #
 ### ### ##### ##### ############### # ##### # # ### # ##### ### # # # # ### # # # ### ### # # ### ########### # # # ### # ### #
   #     #   #     #     # #       # # #   # # #   # #     # #   #   #       # # #   #   #   #   #       #   #     # #   #   # #
## ##### # ### ### ##### # # ##### # # ### # ##### ####### # # ##### ### ####### ### ### ############# # ### ##### # # ### # # #
     #   #   #   # #   #   #   #   # #   # #   # #         # # #   #   # #     #   #   #     #       # #     #   #   #   # # # #
 ### # ##### ### # # # ### ### # ####### # ### # ########### # # # ### # # ### ### ### ####### ##### ######### # ### ### # # ###
 #   #     #     #   #   # # # #   #   # # #   #               # #   # #   # #     # #   #     # #   #       # #   # # # # #   #
 # ####### # ############# # # ##### # # # # ############# # ####### # # ### ####### ### # ##### # ### ##### ##### # # # ##### #
 #     #   #                       # #   # # #       #     #         # # # #       #     #   #   # #   #   #     # #   #       #
 ##### # ################# ##### # # ##### # # # ### # ############### # # # ### ########### # ### # ### # ##### # # ### #######
   # # #     #             #     # # #     # # #   #   #         #   # # # #   #   #     #   #     #   # # #   #   #   # #     #
## # # ##### # ########### # ### ### # ### # # ### ##### ##### ### # # # # ### ### # # ### ########### # # # ####### # ### ### #
   # #     # # #   #       #   # #   # #   # #   #   #   #   #   # #   # #   #   #   #     # #       # # #           # #   #S# #
 ### ##### # ### # # ########### # ### # ### ### ### # ##### ### # ##### # ##### ########### # # ### # ######### ####### ### # #
   #   #   # #   #   #   #   #   #     # # #   #   # # #       #   # #   #   # # #             # #   # #         #     # #   # #
 # ### # ### # ####### # # # # # ####### # ### # ### # # # ##### ### # ### # # # ### ########### # ### # ####### # ### # # ### #
 #     # #   # #   #   # # #   # #       # # # # #   #   # #   #     #   # #   #   #     #     # #   # #       # # # # #   #   #
 ####### # ##### # # ### ####### # ####### # # ### ##### ### # # # # ### # ####### ##### # # ### # # # ######### # # # ##### ###
 #       #       #   # #     #   # #   # #   #   #       #   # # # #   # # #     #   # #   # #   # #             #   #     #   #
 # ##### ### ######### ##### # # # # # # ### ### ##### ### ### # ####### # # # ##### # ##### # ######### ######### ####### ### #
 # #   #     #   #   # #   #   # #   # # # #   #     # # # #   #         #   # #     # #     #   #     #     #     #   #     # #
 # # # # ##### # # ### # # ##### ##### # # ### ##### # # # ##### ######### ##### ##### # ####### # ### ####### ##### # # ##### #
 # # # # #     # #       # #     # #   #   # #   # # #   #   #             #     #     #   #   # # # #   #   # #   # #   #   # #
 # # # # # ##### # ####### # ##### # ##### # ### # # # ##### ### # ##### # # ######### ### ### # # # ### # # # # ### ##### # # #
 # # # # #     # # #     #         #     #         # #     #   # #     # # # #     #     #     # # #   #   #   #   # #     #   #
 # ### # ##### # ### ### ##### ### ##### ####### ### # # ##### # ##### # ### # ### # ######### # # # ############# # # #########
 # #   #   #   #     #     #   #     # #   #   # #   # # #   # # #   # # #   #   # #   #       #   #     # #       #   #       #
 # # ### # # ############# ##### # # # ### # # # # ##### # # # # # # # # # ##### # ### # ############### # # ########### ### # #
 # #   # # #   #       # #       # # #   #   #   # #     # # # # # # # #   #   # #     #   #   #   #   #           #     #   # #
 # ### # ##### # ##### # ##### ### # ### ####### # # ##### ### ### # ### ##### # ##### ### ### # # # # ### ##### ### ##### ### #
 #   # # #     #   # # #       #   #         #   # #   #   #   #   #   #       #     #   # #   # #   #   #     #       #   # # #
 ### # # # # ##### # # # ####### ### ####### # ### ### # ### ### ##### ##### ### ### # ### # ### ####### # ### ######### ### # #
   #   # # # #   # # # # #       #   #     # # #   #   #   #     #   #     #     # # # #   #   #   #   # # #   #   #   #   #   #
 ######### # # # # # # ### ####### # # ### # # # ### ##### ####### # ##### # ### # # # # ##### ### ### # # ##### # # # # # #####
 #     #   # # # #   # #   #   #   # #   # #   #   # #   #   #   # #       #   # #   # # #   # # #     # # #     # # # # #     #
 # ### # ##### # ### # # # # # ### # ### # ### ### ### # ### ### # ######### # # ####### ### # # ####### # # ##### # # ### ### #
   #   #     # #   # # # # # #   # #   # #   #   #     #         #     #     # #   #     #   # # #       # # #   # # #   #   # #
 ### ####### # ##### # # ### ### # ##### ### ### ############# ####### # # ####### # ##### ### # # ####### # # ### # ### ### # #
   # #   #   # #     # #   #   # # #     #   #           #   #   #     # # #     # # #   #   #         #   # #   #   # # #   # #
#### # # # ### # ######### ### # # # ####### ### ######### # ##### ##### # # ##### # # ##### ######### # # # ### ##### # # ### #
     # # #     # #   #     #   # # #       #     #         #       #     # # # #   # #     #       #     # #   # #     # # #   #
 ##### # ##### # # # # ##### ### ######### ##### # ################# # # ### # # ### ##### ####### # ##### # ### # # # # # # ###
     # # #   # #   #   #     # #           #     #   #       #       # #       # #   #   #       # # #   # #     # # # # # #   #
#### # ### # ########### ##### ############# ####### ####### # # ##### ######### # ### # # ##### # # # # # ####### # ### # ### #
     #     # #     #     #   #   #       #   #     #   #       #   #     #     # # #   #     #   # # # # #     #   #     # # # #
 ########### # ### # ####### # ### ##### # ### ### ### # ######### ##### # ### # # ####### # ##### # # # ####### ######### # # #
 # #         # # # # #         #   #   #   #   # #   # #     #   #   #   #   #   #       # #       # # #         #       #   # #
 # # ######### # # ### # ####### ### ######### # # ### ##### # ##### ### ### ########### # ######### # ########### ##### # ### #
   # #         #   #   # #     # # #         # # # #   #     #     #   #   #   #     #   #   #       #   #       # #       #   #
 ### # ######### ### ### # ### # # ######### # # # # ############# ### # # ### # ### # ##### # ##### ### # ##### # # ####### ###
   #   #       #   # # # #   # # #         # # #   #         #   # #   # #   #   # #   #   # #   #   #   #     #   #   #   # # #
 # ##### ##### ### # # # ### # # # ####### # # ### ######### ### # # ### # ####### ##### ### ### # ### ### ### ####### # # # # #
 # #     #     # # #   #     #   # #   #   # #   #         #   # #   #   #       #           #   #   # #     #   #   # # #   # #
 # # ##### ##### # ### ########### # # ##### # # ############# # ##### ### ####### # ##### ### ##### # # ### ### # # # # ##### #
 #   #   # #     #   # #     #       # #     # # #   #   #   # #       #   #       #     #     #   # # # #   # # # #   #   #   #
###### # # # ####### # ##### # ####### # ##### # # # # # # # # ####### ##### ########### # ##### # # # # # ### # ######### ### #
     # # #   #       #     # #       #   #     #   # # #   # # #   #   #   #   #     #   #     # # #   # #     #     #   # #   #
 ### # # ##### ########### # # ####### ### ########### ##### # # # # # # # # ### ### # ### ### ### ##### ########### # ### # ###
 # #   #       #         # #   #     #     #         # #   # #   # # # # #   #   #   # #     #     #       #         #     #   #
 # ############# # ####### # ### ### ####### ####### # ### # ##### # # # ##### ### ### ############# ####### ####### ####### # #
 #     #         # #     # # #   #   #       #   # # #     #   #   # # # # #   #   #   #     #       #   #   #               # #
 ##### # # # ### # # ### # # # ####### ####### # # # ##### ### # ### ### # # ### ### ### ### # # ### # ### ### # ####### ##### #
 #   #   # #   # # #   #   # #   #   # #       #   #     # # # # #         # # #   #   # #   # #   #   #   #   # #     #   #   #
 # # # ### ##### ##### ##### ### # # # ####### ### # ##### # # # ######### # # ### ##### # ### ######### ######### ### ### # ###
   # # # #     # #     # #     #   # #   #     # # # #   # #   # #     #   # #   #   #   #   # #       #   #         #   # # # #
#### # # ##### ### ##### # ### ##### ### # ##### # ### # # ##### # ### # ### # ##### # ##### ### ##### ##### ########### ### # #
       # #   #     # #   # #   # #   # #   #   #   #   # # # #   # # # # #   #     # # #   # #   #   #   #   #         #   #   #
 ##### # # # ####### # # # # ### # ### ##### # # ### ### # # # ### # # ### ####### # # # ### # ### # # # # ### ####### # # #####
 #   #     #       #   #   #   # # #   #   # #     #   #   # #     # #     #     # # # #     #   # # # # # #   #   #   # #     #
 # # ######### # # # ######### # # # # # ### ######### ##### ####### ####### # ### # # # ### ### # # # # # # ### # ### ####### #
   #       #   # #   #       #   # # #     #   #   #   #     # #     #   # # # #   #   # #   # # # # # # # #   # #   # #   #   #
 ######### ##### # ### ##### ##### ####### # ### # # ### ##### # ### # # # # # # ####### # # # # # # ### # ### # ### ### # # ###
     #   #   #   #         #     #         # #   # # #     #   #   #   #   # #   #       # #   # # #   #     # #   #     # #   #
#### # ##### # ####### # # ### # ######### # # ##### ##### # ##### ######### ##### ### # # ### # # ### ####### ### ####### ### #
     #     # # #     # # # # # #   #   #     #     #   #     #   #   #     # #       # # #   #   # #   #     #       #   #   # #
 ######### # ### ### # # # # # ### # ### ### ##### ### ##### # # ### ### ### # ####### ######### # ##### ### ### # # # # ### ###
 #         # #   # # # # #   #   # #     #     #   # #     # # #   # #   #   # #     #     #         #   # #     # # # #   #   #
 # ####### # # ### # # ######### ####### # ### # ### ##### # # ### # # ### ### # ### ### # # # ##### # ### # ##### # # # # ### #
   #       #     #   #   #   #   #     # #   # #     #   # # #   # # #   # # # #   #     # # # #   # #     # #     # # # #   # #
#### ######### ######### # # # ### ### # ### # ##### # # # # ### # # ### # # # ### ####### # ### # # ####### # ##### # # ### # #
   #   #     # #       # # # #   # # #     # # #     # #   # #   # # #   # #   #   #       #   # # #         # #     # # #   # #
 # ### # ### ### ##### # # ####### # ### # # # # ##### ##### # ### # # # # ### # ### # ####### # # ### # # ### # # ### # # ### #
 #   # # # #   # # #   #   #       #   # # # #             # # # #   # # # #   #   # #       # # #     # #   # # #   # # # #   #
 ### # # # ### # # # ####### ####### # # # # ############# # # # ####### # ##### # # ####### # # ############# # ### # # # # ###
 # # #     # # #   # #       #       #   # # # #     #   #   # #       # #     # # #     #   # #     #         #   #   # # # # #
 # # ##### # # ##### # ####### ##### ##### # # # ### # ### ### # ##### # ##### ### # # ### # # ##### # ######### ####### # # # #
 #       #   #     # # #     # #     #     # # # # # # #   #   # #   #   #   #     # #   # # # #   # #   #   #   #       # #   #
 ####### ### ##### # # # ### # # ##### ### # # # # # # # ### ### # ##### ### ####### ### # # # # ### ### ### # ### ####### #####
 #   #   #   #   # #   # #     #     # #   #   # # # #   #   #   # #   #   #         #   # # # #   #   # #   #   #       #     #
 # # # ### ### # ####### ########### # # # ##### # # ### # ### ### # ##### ######### # ### # # ### ##### # ############# ##### #
 # # #   #     #         #   #       # # # # #   #       #   # #   # #   #           # # # # #   # #     # #     #       #     #
 ### ### # ######### # ### # # ######### # # # ######### ### # # # # # ############### # # ### ### # ##### # # # # ####### #####
   # # # # #     #   #     # #   #       #   # # #         #   # #   #     #       #   # #   #     # #     # # #   #       #   #
## # # # # # ### # # ########### # ##### ##### # # ####### ######### ##### # ### # # # # ### ####### # ##### # ####### # ### # #
 #   # # # # # #   #     #     # #     # #   # # #   #                       #   # # #     #   #   # #     # #       # #     # #
 ##### # ### # ##### ##### ### # ### # ### # # # ### ########### ############# ### # ######### # # # ##### # ####### # ####### #
 # #   #   # #   #   #   # #   #   # #     # #   #   #       #   #       #   #   #   #     #   # # #   #   # #     # #       # #
 # # ##### # ### ##### # # # ##### ##### ### ##### ### ##### # # # ##### # # ### ##### ### # ### # ### # ### # ### # # ####### #
     #     #   # #   # # # #       #   #   #   #   #   #     # # # # #   # #   #     #   #   #   #     #   # #   #   #     #   #
 ##### ##### # # # # # # # ####### # # ##### ### ### ### ####### # # # ### ### ##### ######### ### ####### # ### ##### ### # ###
     # # #   #   # #   # #   #     # #     #   # #   # # #       # # #     # #   #     #   #   #   #   #   #   #     #   # # # #
 ### # # # ####### ##### ### # ##### ##### ### # # ### # ##### ### # ####### ### # # ### # # ### ### # # ### # ##### # ### # # #
 # #   # #       # #   #     #     #     # # # #   #   #   #   #   #           #   #   # #   #   #   #   #   #     # # #   # # #
 # ##### ### # ### ### ### ####### ##### # # # ##### # ### # ### ####### ##### ####### # ####### # ####### ### ##### # # ### # #
 #         # #   #     #   #     # #     # # #       #   # #   #   #   # #       #     # #       #   #   #   #   #   # #   #   #
 # ####### # ### ########### ### ### ##### # # ######### # ####### # # # # ##### # # ### ### ### ### # # ### ##### ####### #####
 # #     # #   #       #   #   #   # #     #   #       # #       # # # # # #   #   # #   #   #   #   # #     #     #       #   #
 # # ### # ### # ##### # # # # ### # # ######### ##### # ####### # # # # # # # ##### # ### ####### ### ####### ##### ####### # #
 # # # # #     # #     # # # #   # # # #   #     #   # # # #     # # # # #   #     # # #     #   # #         # #   # #   #   # #
 ### # # ######### ##### # # ### # # # # # # ##### ### # # # ##### ### # ######### ### # ##### # # ########### # # # # # # ### #
   # #   #   #   #   #   # #   # # # #   #   #     #   #   #   #   #   #     #   #   # # #   # #   #     #     # #   # #   #   #
## # # ### # # # ##### ### ##### # # ######### ### # ######### # ### ######### # ### # ### # # ##### ### # ##### ##### ##### # #
     #     #   #       #         #   #           #             #     #         #     #     #   #       #   #           #     # #
################################################################################################################################
