################################################################################################################################
             #           #           #             #                   #   #       #   #                   #   #     #   #     #
 # # ####### ####### ### # # ####### # ####### ### ##### # ######### ### # # ##### # # # # ########### # # # # # ### ### # ### #
 # # #     # #     # #   # # #     # #       #   #       # #       #     #   #   # # # # # #   #       # # # #   # #   # # #   #
 ### ##### # # ### # # ##### # ### # ### ####### ####### ### ##### ########### # # # # ### # # # ####### # # ##### ### # # # ###
   #   #   # # #   # #       # #   #   # #   #   #   #   #       # #       #   # # # #   # # # #   #   # # # #     #     # #   #
## ### # ### # # ### ######### ####### # # # ### # # ##### ####### # ####### ##### # ### # # # ### # # # # ### ### # ##### ### #
     # #   # # #   #   #     #   #     # # #   # # #       #       #   #     #     # #   # # # # # # #   #       #   #   # # # #
 ##### ### # # ### ### # ### # # # ####### ### # # ######### ######### # ##### ##### ##### # # # # # ##### ##### ##### # # # # #
 #   #   # #   #   #   #   #   # #   # #   #   # #         #         #   # #   #   # #   #   #   # #   #   #   #     # # # # # #
 # # ### # ##### ### ##### ##### ### # # ####### ######### ######### # ### # ### # # # # ####### # ### # ### # ####### ### # # #
   #   #   #   # #   #         #   # # #       #         #       # # #           #   # # #     # #   # #   # # #     #     #   #
 ########### # # ##### ### ### ### # # ####### # ####### ####### # # ############# ### # # ### ##### # ### # ### ### ####### ###
     #   #   #       #   #   # # # # #       # #       #     #     #     #   #   #     # #   #       #   # #   #   #     #   # #
#### # # ########### # # ##### # # # # ##### # ####### ##### # ####### # # # # # ####### ######### ##### # ### ### ### ### ### #
     # #       #     # #     #   # # # #     #   #   # #   # #   #   # #   #   #   #   #   #     # #   # #       #   #   #   # #
 ##### ####### ##### # ##### ##### # # # ####### # ### # # ##### # # # ########### # ##### # ### ### # # # ##### ### ### ### # #
     # #     #     #   #   #   #   # # #         #     # #   #   # # #     #     # #   # #   # #     # # # #   #   #   #   # # #
 ### # # ### # ### ### # # ### # ### # ############### # ### # ### # ### # # ### # ### # ##### ####### ### # # ### ### ### # # #
   # # # #   # # #   # # # #   #           #   #       # # #   #   #   # # #   # # #   #     #       # #   # #   # #   # #   # #
## # # # ##### # ### # # # ########### # ### # ##### ### # ########### ### ### # # # ####### # ### # # # ### ### # # ### ##### #
   # # #   #     #   # # #           # #     # #   #   #     #     # #   #     # # #         # # # # # #   #   #     #       # #
#### # ### ####### ### # ########### ##### ### # # ######### ### # # ### ####### # # ######### # # # # ########### ######### # #
     #   #         #   # # #       # #   #   # # #   #     # #   # #   #   #     # #             # # #           # #   #   #   #
 ####### ########### ### # # ####### # # ### # # ### # ### # # ### # ##### ####### # ########### # # ########### # ### # # ### #
   #     #   #           # #         # #   # #   # # #   # #   # #   #   # #       # #   #     # # # #     #     #       #     #
#### ##### # # ########### ######### # ### # ##### # ### # ##### ### # # # # ####### ### # ### # # ### ### # ##### #############
     #     #             # #       # # # # #       #     #         # # #   #   #   # #   #   # # #   # # #   # #   #   #   #   #
 ##### # ######### ### ### # ##### ### # # ##### ############### # # # ####### # # # # ####### # ### # # ##### # ### # # # # # #
 #     #     #   #   #     # #   #   #   # #   #         #       # # #         # # # #     #   #   #   #           # # # #   # #
 # ####### # ### ### # ##### # # ### ##### # # # # # # ### ####### # ########### ### # ##### ### # ##### ### ####### # # ##### #
 #   #   # #   #     #     #   #   #       # # # # # #   #     #   #     #   #   #     #     #   #       #   #       #   #   # #
 ### # # # ### ####### ### ####### ######### # # # # ### ##### # # ##### # # # ### ##### ##### # # ### ### # # ############# # #
 #   # # #   # #     #   #       #   # #     # # # # #   #   # # #     # # # #     #     #     # # #   #   # # #           # # #
 # ### # ##### # # # ### # ##### ### # # ##### ### # ##### # # # ##### # ### # ##### ########### # ##### ##### # ######### # # #
   #   #   #   # # #     #     # #   # # #   #     #       # # # #     #   # #     #   #     #   #   #               #   # # # #
 ######### # ### # ####### ##### # ### # # ################# # # # ####### # # ####### # ### # ##### # # ############# # # # # #
 #     # #   #   #   #   # #     # #   # #   #     #       # # # # # #     #       #   #   # # # #   # # #         #   # #   # #
 # ### # ##### # ##### # ### ##### # ### ### # ##### ##### # # # # # # ##### ##### # ####### # # # ### # # ####### # ### ##### #
   #   #       #   #   #   #     # #   #   # # # #   #   # # # # #   # #         #   #   #   #   # #   # # #     #   # #       #
 ### ####### ####### ##### ####### ### ### # # # # ### # # # # ####### # ####### ##### ### ### ### ### # # # ### ##### #########
   #   #   # #     # #   #         #     #   #   # #   #   # #   #     # #     # #   #     #   # #   # # #   # #     #   #     #
## ### # # # ##### # # ############# ### ####### # ##### ### ### # ##### # ### # # # # ##### # # ### # ####### ##### ### # #####
   # # # # #       #   #   #       # #         # # #   #   #   #   #     # #   # # # #     # #   #   # #       #   #     # #   #
 ### # # # ######### ### # ####### # ##### # # # # # # ### # # ##### ##### ##### # ####### ####### ### # ####### ######### # # #
 #   # # #       #   #   #   #   #   #   # # #   #   #   # # #           #   #   #   #   # #       #     #   #   #       #   # #
 # # # ######### # ### ##### # # ##### # ### ### ####### # # # ### ##### ### # # # # ### # # ####### # ### # ### # ##### ##### #
 # # #         # #   #     #   # #     # #   #       # # #   # #   #     # # # # # #     # # #       # #   #   #   #     #   # #
 # # ######### # ### ##### ##### # ##### # ### ##### # # ##### # ### ##### # ### # ####### # # ####### # ##### ### ####### # # #
   # #     # # #   # #   #     # #     # #   # # #     #   #   # #   # #   #     #     #   # #   #     #     #   #         #   #
#### ##### # # ### # # # ##### # ##### # ##### # # ####### # ### ##### # ######### ### # ### ### # ####### # ### ############# #
         # # #     #   #     # #   # # #       # # #   #   #   #   #   #         # #   #     #   # #     # # # #         #   # #
 ####### # # ########### ##### ### # # ######### # # # # ######### # # ######### # # ######### ### ### # ### # ######### # ### #
       #       #       # #   # # # #   #       #   # # # #       # # #           # # #       #   #   # #   # #   #       #   # #
 ##### ######### ##### # # # # # # ##### ### ### ### # # # ####### # ############# ### ##### # # ### # ### # ### # ######### # #
 #   #         # #   #   # #   # # #   # #   #     # # # #         #             #   #     # # # #   #   # #   # # #     #     #
 # # ######### # # # ##### ##### # # # ### # # ##### ### ####################### ### ##### ### # # ####### ### # # # ### ### ###
   #         #   # # #     #     # # #   # # # #   # #   #               #     # # # #   # #   # #       #     # #   # #   # # #
########## ####### # # ##### ##### ##### # # # # # # # ##### # # ##### # # ##### # # # # # # ### ####### ####### ##### ### # # #
     #     #       #   #     #     #   # # #     #   #     # # # #     #             # #     #     #     #   #         #   # # #
 # ### ##### ########### ### # ##### # # ##### ########### ### # # ##### ########### # ####### # # # ##### # # ######### ### # #
 #       #   #           #   # #     # # #   #   #     #   #   # #   #   #         # #     #   # # #       # #   #   #         #
 ######### ### ############### ####### # # # ### # ### # ### # # ### ##### ####### # ##### # ### # ######### # # # # # ####### #
 #       # #   #       #     #   #   # #   #   # # #   # #   # # #   #   #     # # #       # #   #     #   # # #   # # #     # #
 # ##### # # # # ##### # ### # # # ### ####### # # ##### # ##### # ### # ##### # # ######### # ####### # ### # ####### # ### ###
 # #     # # # #     #   #   # # # #   # #     #   #   # #   #   #   # #       # #           #   #   # # #   #       # #   #   #
 # # ##### # # ##### ##### ##### # # ### # ##### ### # # ##### ####### ### ##### ############# # # # # # # ######### # ####### #
 # #     #   #     #   #   # #   # #   # # #     #   # #     # # #   # #   #   #       #     # # # # #   # #     #   # #   #   #
 # ########### ######### ### # ### ### # # # # ### ### ##### # # # # # ##### # ####### # ### ### # # ##### # ##### ### # # # ###
   #   #   #   #         #   # #     # #     # #   #         #   # # #       # #   #   # # #   #   # #     #           # #   # #
 ### # # # # ### ######### ### # ### # ####### # ############# ### # ######### # # # ### # ### # ### # ########### ##### ##### #
 #   #   # # # # #   #   #   # # #   #     #   #     #   #       # #   #     # # # #     #   # # #   #       #   #     #       #
 # ####### # # # # # # # ### # ### # ##### # ####### # # ####### # ##### ### # # # ######### # ### # ####### # # ##### ####### #
   # #   # #   # # # # # #   # #   # #     # #     #   # #     # #       #   #   #       #   # #   #       #   #     #       # #
#### # ### # ### # # ### # ### # ### # ##### # ### ##### # ### # ######### ####### ##### ### # # # ##### ##### ##### # ##### # #
       #   # #   # #     #   # # #   # #     #   # #     #   # #   #     #   #   #     #   # # # # #   # #   # #   # # #   # # #
 ####### ### # ### ######### # ### # # ### ##### # # ####### ### ### ### ### # # # ####### # # # # # # ### # ### ### # # ### # #
         #   # #   #     # # # #   # #     #     # # #     #   #       #   # # # #   #     #     # # #   # #     #   # # #   # #
 ####### # ### # ### ### # # # # ### ### ### ##### # ### # ### ########### # # # ##### ############# ### # ####### ### # # ### #
       # # #   #     # # # # # # #   #   #   #   #   #   #   #           # #   #     #   # #         # #   #       # #   #     #
 ##### ### # ######### # # # # # # ### ### ##### ##### ##### ########### # ######### ### # # ######### ##### ####### # ####### #
     #     #   #     #     #   # #       #     # #     #           #   #       # #   #   # #S    #   #       #     #   #     # #
 ############# # ### # ### ##### ####### ##### # # # ############# # ##### ### # # ### ### ##### # # ### # ### ####### # ### # #
   #           #   # # #         # #     #     #   #   #   #   #   # #       #   #     #       #   # #   #   #         #   #   #
 # # ############### # # ##### # # # ### # ############# # # # # ### # # # # ################# ##### # ##### ##### ### ####### #
 # #       #   #     # # #   # #   # #   #             # # # # #       # # #         #         #     # #     #   # #   #   #   #
 # ####### ### # ####### # # ####### ### ############# # # # # ######### ### # ### ### ####### # ####### ##### # ### ### # # # #
 # #     #   # # #       # #       #   # #     #     #   # # #       #   #   #   #   #   #     # #     # #     #     #   #   # #
 ### ### ### # # ### # # # ####### ### # ### ### ### ##### # ####### # ### ######### ##### ##### ### # # # # ######### # ##### #
     # # #   # #   # # # # #     #   # # #   #   #   #   # # #   #   # # #   #     #   #   #   #     #   # # #   #     # #   # #
###### # # ### ### ### ### # ### ### # # # # # ### # # ### # # ### ### # ### # ### # # # ### ############# ### ### ####### # # #
     #   # #           #   # #       # #   #   #   # # #   # # #   #   #   #   # # # # # #   #   #         #   #   #       #   #
 ### # ### ############# ### ################# # ##### # ### # # ### # ### ##### # # # # # ### # # ### ##### ### ### ######### #
 # # #   # #       #   # # #   #     #       # # #     #     #   #   # #   #   # # # # #   #   # # #   #       #   #   # #   # #
 # # ### # # ##### # # # # ### # ### # ##### # ### ############### # ### ##### # # # # ### # ### # # ### ############# # # # # #
   #   # # #     #   #   # # #     # #     #   #   #       #     # #   # #       # # #     #   # # #     #     #       # # #   #
###### # # # ########### # # ####### ##### ### # ### ##### # ### # ### # ### ##### # ######### # # ####### ### # ####### # #####
       #   # #     #   #       #     #   # #   #     #   #   #   # #   #   # # #   #     #   # # # #       #   # #   #   #     #
 ####### ### # ### # # ##### ### ####### # # # ####### ####### ### # ##### # # # ##### # # # # # # # ####### ##### # # ####### #
   #         #   # # # #   # #   #   #   # # #       # #     #     #       #   # #   # #   # # # # # #   #   #   # # #         #
## # ####### ##### # # # # ### ##### # ### # ##### ### # ### ##### ########### # # # # ####### # ### # # # ##### # # ##### ### #
   #   #   # #   #   # # # #   #           # #   # #   #   #   #               # # # # #       # #   # # #     #   # #   # #   #
 ##### # # ### # ##### # # # ####### ##### # ### # # ##### ### # ### # ### ### # # # ### ####### # ##### ##### ##### # # ### # #
 #       #   # #     # # #   #     # #   # #     # # #     # #   #   #   #   # # # # #   #   #   #     #   # # #       #   # # #
 ####### ### # ##### # # ### # ### ### # ######### # # # ### ##### ### # ### # # # ### ### # # ####### ### # # ### ####### ### #
           #   #   # #   #   # # #     #   #       # # #   #       #   #   # # # # #   # # # # #     #     # #   # #   #       #
######## ######### # # ####### # ######### # ##### # ##### ####### # ##### # ### # # ### # # # # ### ####### ### ### # ####### #
             # #   # # #   #   #   # #     #     # #   #   #       #     # # #   #   #   # #   # # #   #   #   #     #     # # #
#### # # ### # # # # ### # # ##### # # ######### # ### # ### ######### ### # # # ##### ### ##### # ### # ##### ########### # # #
   # # #   # # # # #     #   #       #   #       # #   # # # #   #   # #   # # # #     # #   # # # #   #               #   #   #
 # # # ##### # # # ########### ######### # # ##### # ### # # # # # # ### ### # # # # # # ### # # # # ##### ####### ##### ##### #
 #   # #   # #   # #   #   # #     #   # # # #   # #     #   # # # # #   #   # #   # #   #   #   #     #   #     #   #   #   # #
######## # # ##### ### # # # ##### # ### # # # # # ########### # # ### ##### # ##### # ### ########### ### # ### ### # ### # # #
         #   # #   #   # #   #   # #     # # # # # #       #   # # #   #     # #   # #   #   #     # #     # # #   # #     # # #
 ############# # ### # # ##### # # ######### # ### ### # # # # ### # ### ##### # # # # ##### # ### # ##### # # ### # ####### # #
       # #     # #   #         # #           # #   #   # # # #   # # #   #   # # # # #     #   # # #       #   #   #   #     # #
###### # # ##### # ### ######### ### ### # ### # ### ### # # ### # # # # # # # # ### ### # ##### # ##### ######### ### # ##### #
     # #           #   #       #     #   #   #       #   # #   # #   # #   # # #     #   #   #     #   # #       #     # # #   #
#### # ### ######### ### ##### ##### # ##### ######### ### ### ############# # ####### # ##### ##### # # # ##### # ##### # # # #
     #   # #       # #   # #   #   # #     #   #     # # #           #     # # #   #   # #   #       # # #   # # # #     # # # #
 ### ### ### ##### # # ### # ### # # ### # ### # ##### # ##### # ### # ##### # # ### # ### # ######### ##### # # # # ##### # ###
   #   #   # #     # #     #     #   # # #   #   #     #       # #   # #     # #     #   # # #   #   # #     #   #   #     #   #
## ### ### ### ##### ################# # ######### ############# # ### # ##### ######### # # # # # # # # ##### ### ##### ##### #
   #     #     #         #   #         # #       # # #           #   #   #  G  #       # # #   #   #   # #   #   #     #   # # #
 ####### ####### ##### # # # ####### ### # ##### # # # ############# ### # ##### ##### ### ############### # ### ##### ### # # #
 # #           #     # #   # #     # #   #     # #   #   #               #     # #   #   #   #       #     #   # #   # #     # #
 # # ######### ##### # ##### # # ### # ####### # ####### ############### ##### # ### ### ### # ### # # ##### ### # # # # ##### #
   #         #       #     #   #     #         #       #               #     #         #       #   #       #       #           #
