################################################################################################################################
       #     #   #               #             #         #           #     #                 #     #       #     #   #     #   #
 ##### # # ### # ######### ##### # ### # ##### # ####### # ######### # ### # ############### ##### # ##### ### # # # ##### # # #
   # # # # #   #     #   # #   #   #   # #     # #     # # #   #       #   #           #   #       # #   #     # # #   #   # # #
## # # # # # ####### # # # # # ##### ### # ##### # ##### ### # ########### ########### ### ######### # # ####### # ### # ##### #
 # # # # # #   #   # # # # # #   #   #   # #   # # # #   #   #       #   #           #     #     # # # #           #   #       #
 # # # ### ### # ### # # ### ### ##### ### # ### # # # ### ######### # # # # ####### ##### # ### # # # ### ####### ########### #
   #   #   # # #   #   # #   #   #     #   #   #   # #     #         # # # #   #   # #       # # #   # #   #     #     #       #
 ####### ### # ### ####### ### ### ####### ### ##### ####### ######### # ##### # # # # ####### # ##### ##### ### ##### # ##### #
 #     #     # #           #   #     #   # #   #           #     #     # #     # #   # #     #   #     #   # # #     #   #     #
 # ### ##### # # ########### ### # # # # # # ### ### ########### ### ### # ##### ##### # ### # ### ### # # # # ##### ##### ### #
 # #   #     #   # #   #     #   # #   # #   #   # #     #   #   #   # #   #   # #     # # # #     #   # #   #   # # #     # # #
 # # ### ######### # # # ####### ####### ### # ### ##### # # # ### ### ##### # # # # ### # # ##### ##### ##### # # # # ##### # #
 # # #       #   #   # #       #       #   #     #       # # # #   #         #     # #   # # #   # #   #     # #   #   #   # # #
 ### ####### # ####### ####### # ############### ######### # # ##################### # ### # # # # # # ##### # ### ##### # # # #
   # #   #       #   #     #   # # #       #   #   #   #   # #   #           #   #   #   #   # #   # #   #   # #       # #   # #
## # # # ####### # ####### # ### # # ##### # # ### # # # ### ### # ######### # # ####### # ### ##### ### # ##### ##### # ##### #
 # #   #       # #   #     #   # # # #     # # #   # #   #     # #       #   # # #     # # #   #     # #   #     # #   #   #   #
 # ########### # ### # ####### # # # # ##### # # # # ##### ### # ######### ### # # ### # # # ### ##### ##### # ### # ### ### ###
 # # #         #     # #   #   # # # #   #   #   #   #   # # # # # #   #   #   #   # #   # #   # # #     #   #     #       #   #
 # # # ######### ##### # # # ### # # ### ########### # ### # # # # # # # ### ####### ##### ##### # # ### # ######### ##### ### #
 # #       #     #     # # # #     #   # #           #     #   # # # #   #     #   # #   #       # # # #   #     #   #   #   # #
 # # ##### # ##### ##### ### # # ##### ### ### ##### ########### # # ####### # # # # # # ######### # # ### # ### # ### # ##### #
     #   #   #     # #   #   # #     #     #   #   #           # #         # # # # #   #   #     # # #     #   # #     # #     #
 ##### # ##### ##### # ### ### ################# # # ######### # ######### ### # # ####### # # # # # ########### # ##### # #####
   #   # #   # #   # # # #   #       #         # # #   #   #   #   #     # #   # #   #   # # # #     #           # #     #     #
 ### ### # # # # # # # # ### ####### # ####### # # ### # ### # ### # ### # # ### # ### # # ### ####### ########### ########### #
 #     #   # # # #   #     #   #     #     #   # # #   #     # #   # #   #   # # #   # # #     #       #           #   #       #
 # ######### # ##### # ####### # ######### ####### ### ######### ### # ####### # ### # # ### ### ####### ### ####### # # #######
 # # #   #   #   #   # #   #   # #   #       #   #   #     #   # # # #     # # #   # # #   # #   #     # #   #       #   #     #
 # # # # # # ### ### # # # # ##### # ####### # # ### ### ### # # # # ### # # # ### ### ##### # ### ### # # ### ########### ### #
 # #   #   #   # #     # # # #     #       #   # # # #   #   #   # #   # #                   # #   #   # #   # #       # #   # #
 # ############# # ### # # # # ########### ##### # # # ### ####### ### # ################# ### # ### ####### # # # ### # ##### #
 # #   #       # # #   # # #   #     #   #   #   # # #   # #           # #G  #         #   #   #   #   #   # # # # #   #       #
 # # # # ##### # # # # # ####### ##### # ### # ### # ### # ############# # # # ####### ### # ##### ### # # # # ### # ### #######
     # # #     # # # # #   #     #     #   # #           #             # # #   #     #   # # #   #   #   # #       # # # #     #
###### # # ##### ### # ### # ### # ####### # ### ####### ############# # # ##### ### ### ### # # ### ##### ######### # # ### # #
     # # # #   #     #   #   #   #   #   # # #   #     # #       #     # # #   # # #   #     # # #   #   #       #   # #     # #
 ### # # ### # ### ##### ##### ##### ### # # ### # ### # # ##### # ####### ### # # # ########### # ### # ####### # ### ####### #
 #   # #   # #     #     #   #   # # #   # #   #   #   # # #   #   #       #       # #   #     #   #   # #       # #         # #
 ##### ### # # ##### ### # # ### # # # ### ### ### ####### ### ####### ##### ####### # # # ### ### ##### # ####### # # ##### # #
   #         # #   #   #   # #   # # #   #   #             #     #   # #     #     # # # # #   #   #   #   #       # #     #   #
## ############# # ### ##### # ### # ### ### ##### ##### ### ### # # # # # # # ### ### # ### ####### # ### # ####### ##### ### #
 #       #       # #   #     #     #     # #     #     #   # #     # #   # #     #   # #   # #   #   #   # # #       #   #   # #
 ####### # ####### ##### ### ##### ####### ##### # ### ### # ####### # ### ######### # ### # # # # ##### # # # ### ### # ### # #
   #   # # #     #     #   # #   #   #     #   #   #   #   #     #   #   #       #   # # #   # # #   #   #     #   #   #     # #
## # ### # # ### ##### ##### ### ### # ### # ####### ### ######### ### # ##### # ##### # ####### ##### ### ######### ######### #
   #   #   # # # #   #     #       # # #   # #     # #           # #   #     # #       #   #   # #     # #       #   #   #     #
 ##### ##### # # # # ##### ##### # # # # ### # ### # # # ####### # # ####### # ######### ### # # # ##### # ##### ### ### # ### #
   #         # # # #     # #     # #   # #   # # #   # # #     #   #     #   # #         #   #   #             # #   #   # #   #
## # ######### # ### ### # # ##### ##### # ### # ##### # ##### ##### ### ##### # # # # # # ####### ########### # # ### ### ### #
   #       #   # #   # # #   #       #   #   #   #     # #           # # #   #   # # # #   #   #           #   # #     #   #   #
 ### ##### ### # # ### # ##### ### # # ##### ######### # # ########### # # # ##### # ### ### # # # # ##### ##### ####### ### ###
   #     #   # #   #           #   # # #   #   #       # # #   #   #   #   # # #   #   #     #   # #     #   #   #     # #   # #
## ######### # ##### # ### ### # ### # # # # # # # ##### # # # # # # ### ### # # ### # # ### ### # ### ##### # ### ### # # # # #
 #   #     # # #     #   # #   #   # #   # # #   #     # # # #   # # #   # # # # #   # #   #   # #   # #   # #   #   # # # #   #
 ### # ### # # # # ####### ####### # ##### # # ######### # # ##### # ### # # # # ##### # ##### # ### ### # # ### ### ### # #####
     #   #   # # # #   #   #     # #     #   # #       # #   # #   #   #   # # #   #   # #     # #   #   #   # # # #     #     #
 ####### ##### # # ### # # # ### ##### ####### # ##### # # ### # ##### ##### # ### # ##### ####### ### ####### # # ####### ### #
 #   #   #     # #     # # #   # #   #       # # #   #   #     # #   # #     #   # #   #   #     # #   # #   #   #       # #   #
 # # # ### ##### ####### ####### # # ### ### # # ### ##### ##### # # # # ####### # ### # ####### # # ### # # ##### ##### # ### #
   #   # #   #   #       #       # #   # #     #   #   #   #   #   # # # # #   # # # # # #     #   #   # # # #     #     #   # #
######## ### # # # ####### ####### ### # # ####### ### ### # # ##### # # # # ### # # # # # ### ####### # # ### ##### ####### # #
       #   #   # #   #   #   #   # # #   # #       #       # #   #   # # #         #   #   #   #     # # #     #   #         # #
 ##### ### ##### ### # # ### # ### # ##### # ############# # ### # ### # ################### ### ##### # ######### ########### #
 #     #   #     #   # # #   #     #     # #   # #   #   # #   # #   # #       # #       #   # #     # #       #   #         # #
 ####### ### ### # ##### # ########### # # ### # # # # # # ##### # # # ####### # # ##### # ### ##### # # ### # # # ### # ### # #
   #   #     #   #       #       #     #   #   # # # # # # #     # # #       # # # #   # #   #       # # #   #   #     #   # # #
## # # ####### # ############### ### ####### ### # ### # # # ####### ####### # # # # ### ### ####### # # # ####### ####### # # #
 # # #   #   # #               #   #       # #   #     #   #   #     #     #   #   # #   # #       #   # #     #   #       #   #
 # ### ### # # ### # ##### ####### # ##### # # ########### ### # # ### ######### ### # ### ####### ##### ##### ##### ###########
 # #       # # #   # #     #       #     # # # #     #     # # # #   # #       #   #   #         # #   #     #     #     #     #
 # # # ####### ##### # # ### ####### ##### # # # ### # ##### # ##### # # ##### ### ######### ##### # ### # ####### ##### ##### #
 # # # #     #   #   # # #   #       #   # # #     #         #   #   # # #   #   # #       # #     #     #       #   #   #     #
 # ### # ### # # ##### # # ########### # ### # ######### # ##### ##### # # # ### # ####### # # ######### ### ####### # ### #####
   #   #   # # #     # # #   #       # # #   #   #     # #     #     #   # #     #     #     # #           # #     # #   #   # #
 ### ##### # ##### # # # ### # ##### # # # ### # # ### ##### # ##### ### ####### ##### ##### # # ####### # # # ##### ### ### # #
       #   # #   # # # #   #   #   #   #   #   # #   # #   # #     #   # #   #   #   #       # #   #   # # # # #     # #   #   #
 ### # # ### # # # # # ### ##### ########### ### ### # # # ####### ### ### # # # # # ####### # ##### # # ### # # ##### # # ### #
   # # # #   # # # # # #   #   #       # #     #   # # # # #   #   #   #   #   # # # #       #     # # #   # #   #     # #   # #
 # # ### # ##### # # # ### # # ####### # # ### ##### # # # # # ##### ### ####### # # # # ### ##### ### ### # ##### ##### # # # #
 # # #   #       # # #   #   #   # #   # #   # #     #   # # # #   # #   #     # # #   # #     #   #   #   #       #     # # # #
 # ### ############# ### # ##### # # ### ### ### ########### # # # # # # # ### # # ##### # ### # ### ### # # # ##### ####### # #
 # #   #   #         #   #   #   # #   #               #   # # # #   # # #   #   # #     # #   #     #   # # #     #   #     # #
 # # ### # # ######### ##### # ### ### ############### # # # # # ##### # ### ####### ##### # ######### ### # ##### ### ### ### #
 # #     # #   #       #     # #     #               #   # # #   #     # #           # #   # #         #   #   #   #   #   # # #
 ######### ### ### ##### ##### ### ################# # ### # ######### # # ########### # ### # # ##### # ##### # ### ### ### # #
 #       #     #   #   #     #   #   #   #       #   # #   # #     #   # # #     #     #   #   # #   # # #   # #   # #       # #
 # # ### ####### ### # # ####### # # ### # ##### # ### # ### # # # ##### ### ### # ####### ####### # # # ### # ### # # ##### # #
   #   #         #   #     #     # #   # # #   # # #   #   # # # #     #     #   # #     # #       # # #     #   # # # #   # # #
## ##### ### ##### ##### # # ##### ### # ### # # # # ##### # # # ##### # ##### ### # ### # # ######### # ####### # # ### # ### #
   #     #   #   # #     # # #   #   # # #   #   # #   #   # # # #   # #     #     #   # #   # #     # #   #     # # #   #   # #
 ### ##### ##### # # ##### # ### ### # # # ####### ### ##### ### # # # # ### ####### # # ##### # ### # # ### ##### # # ##### # #
   # # #   # #   # #   #   #     #   #   #   #     #   #   #     # #   # #   #       # #       #   # # #   # #     #   #   # # #
#### # # ### # ### ### # # ####### ### ### ### ##### ### # ####### ##### # # # ### # # ##### ##### # # ### # # ### ##### # # # #
   # # #   # # #   # # # #           #     #   #     #   #       # #     # #   #   # #     #     # #   #   # #   # # #   # #   #
 # # # ### # # # ### # # ####### # # ####### ### ##### ######### # ####### # ### ### ##### ####### ######### ### # # # # # #####
 # #   #   #   #   #   # # #   # # # #       #   #     #     # #   #       #   #   #     #     #   #   #     #   #   # # #     #
 # # ### ### ##### ##### # # # # # # # ####### ### ######### # ##### ############# # # ####### # ### # # ##### # ##### # ##### #
 # #   #   # #   # #   # #   # # # # # # #       # #       # #       #     #     # # # #   #   # #   # # #     #   #   #     # #
## ####### # # # # ### # ##### # # # # # # # ##### # ##### # # ### # ##### # ### # # ### # ### # # ### # ####### ### ####### ###
   #       #   # #   #   #   #   # #   #   # #     # # #   #   #   #       #   #   #   # #   # # # # # #       #   #S#     #   #
 ### ########### ### ### # # ##### ##### ### # ##### # # ##### # ##################### # ### ### # # # ####### ### # # ### ### #
     #             # #   # # #   #         #   #   # #   #     #           #     #   # # # #   # # # #       #   # # #   #   # #
########## ####### # ##### # # ### # ##### # ### # # ### # # ####### ####### ### # # ### # ### # # # # ### ##### # # ### ### # #
           #       #     # # #     # # #   # #   # #   # # # #     #       #   #   #   #     # #   # #   #   #   # #     # # # #
######## ####### ####### ### ####### # # ### # ### ### # # ### ########### ### ####### # ##### # ### ### ### # ### ####### # # #
       # #     # #     #     #   # # # # # # #   # #   # #   #             # #     #   # #     #   # # #   # #   #         # # #
 ##### ### ### # # ############# # # # # # # ### ### ### ### ############### ##### # ### # ##### # # # ### ##### ########### # #
   #   #   # #   #           #   # # #   #     #     # #   #           #       # # #     #   #   #   #   #     #             # #
## ### # ### ### ##### ##### # ### # ################# ### ######### # # ##### # # ######### # ### ### ##### # ####### ####### #
 #   #   #   # #   #   #   # #     #                 #   #       #   #   #   #   # #   #     #   #     #   # # #     # # #     #
 ### ##### # # ### # ### # # # ##################### # # ####### ##### ### # ##### # ### ####### # ##### ### ### ### # # # #####
 #   #   # # #   #   #   # #   #     #     #       #   #   #   #   #   #   # #   # #   #       # # #     #   #   #   #   #     #
 # ### # # ### # ### # ### # ### ### # ### # ########### ### # ### # ### ### # # # ### ####### # # # ##### ### ####### ####### #
   # # # #     #     # # # # #   # #   # # #   #       # #   #     #     #   # #   #         # # #   #   #   # #   #   #       #
#### # # ########### # # # # # ### ##### # ### # ##### # # ######### ##### ### ##### ######### # # ### ##### # # # # ### ##### #
   # # #     #   #   # # # # #         #   #     #     #   #             #   #   #     #       # # #       # #   # #   #   #   #
 ### # ##### # # # # # # # # ######### ##### ##### ############# ### ### ### ### ##### # ####### # # ##### # ##### ### ### ### #
     # #   #   #   # # # # # #       # #     #   # #     #     # #     # #     #   # # #   #   # # #   #   #     # #     # #   #
 ##### # # ### ##### # # # # # ##### # # # ### # # # ### # # # # ##### # # ####### # # ### ### # # ### # ####### # ####### # ###
     # # #     #     # # # #   #     # # # #   #   # # # # # # #   #   # #       # #     #   # # #     #     #   #   #     #   #
#### # ### # ### ##### # # ##### ### # ### # # ### # # # ### # ### ##### ##### # # ##### ### # # ########### # # ### # ####### #
     #   # #   #     # # #     #   # #     # # #   #   #     #     #       #   # #       # # # # #         # # #   # # #     # #
 ####### ##### ####### # ##### ##### ### ### ### # ################# ##### # ########### # # # # # ####### # # ##### # # ### # #
       #   #   #       #       #   #     #   #   #   #       #   #   #   # # #   #   # # #   #   #   #   # # #   #   # # #   # #
###### ### # ### ############### # ####### # # ##### # # ### # # # ### ### # # # ### # # ########### # ### ##### # ### # ##### #
           #   #                 #         # #     #   #   #   #   #       #   #       #             #           #     #       #
