################################################################################################################################
#             #     #       #       # #                       #     #     #   #   #       #       #       #     #           #   
# ### ##### # # ##### ##### ##### # # # ##################### # # # # ### ### # # # ##### # ##### # ##### # ### # ##### ### # ##
#   #   #   #   #     #   #     # #   #     #           #   #   # # #   #   # # # # #   # # #     # #   #     #       #   # #   
### ### # ##### # ####### ##### # ######### ### ######### # # ### ##### ### # ### # # # # # # ##### # # ################# # ### 
#   # # #     # #       #       # #       #     #         # #   #     # # #   #   # # #     #     # # #   #     #         #     
# ### # ##### ######### ######### # ##### ##### # ######### # ##### ### # ##### ##### ############# # ##### ### # ######### ####
#     #     #       # # #         # #   # # #   # #     # # # #     #   # #     #   #   #           # #   # #   # #     #       
# ######### # # # # # # ####### ### # ### # # ### # ### # # ### ##### ### # ##### # # # # ########### # # # # ### # ### ####### 
# #   # #   # # # #   #       #     #   #   # # # #   #   #   #       #   #       #   # # #   #       # #   # # #   # #   #     
# # # # # ##### ############# # ##### # ##### # # # ####### # ########### ######### ##### # ### # ##### ##### # ##### ### # ### 
#   # #   #     #           # #       #   #   # # # #     # # #     #   # #     #   #     # #   #     # #   # #     # #   # #   
# ### ### ####### ### ####### # ########### ### # # # ### # # ##### # # # # # ### ### ##### # ####### # ### # ##### # # ### ### 
#   # #   #     # # #                 #               # # # #   #   # #   # # #   #   #   #   #   #   #   # # #   # #   #     # 
### # ##### ### # # ################# # ### ### ####### # # ### # ### ##### # # ### ##### # ##### # ##### # # ### # ##### ### # 
#   #     # #   # # #       #     #   # #   #   #       # # #   #   #   #   #     #     #   #   # #     #   # #   #       #   # 
# ####### # # ### # # ##### # ### ##### ### # ### ####### # # ##### # # # ############# # ##### # ##### ### # # # ##### # # ####
#   #   #   # # # #   #   # #   #     #   # #   #         # # #       #     #   #     # #     #   #     #   # # #       # #     
### # ####### # # ### # # # ### ##### ### # ### ############# # ############# # # # # # ##### ### # ##### ### ##### # # # ##### 
#   # #   #   # #   # # # #   #     #     #   #       #     # #     #     #   #   # # # #   #     # #   #   # #     # # # #   # 
# ### # # # ### ### ### # ### ##### ####### ########### ### # # ##### ### # ####### ### # ####### # # # ### # # ####### # # # # 
#   # # #   #     #   # #   # #   # #   #     #     #   #     #       #   #   #   #     # #   #   #   # #   # # #     # # # # # 
### # # ######### ### # ### # # ### # # ### # ##### # ######### ####### ##### # # # ##### # # # ####### # ### ### ### ### ### # 
#   #   #           #   #   # #     # #   # # #     # #   #       #   #     # # # #         #   #       # # #   #   #   #     # 
# ####### # ####### ##### ### ####### ### # # # ##### # # ##### # # # ### ### # # ####### ### ######### # # ### ### ### # ##### 
#   #     # #   #     #G#     #       # #   #       #   #     # #   #   # #   # #       #   # #     #   #     #     # # # #     
### # ### ### # # ### # ##### ### # ### ### ################# # ####### # # ### ####### ### # # ### ##### ########### # # # ### 
# # #   # #   # #   #     #   #   # #     #   #               #   #   # #     #     # # #   # #   #       #   #     #   # # #   
# # ### # # ### ### ##### # ### # # ##### ### # ################# # # # ########### # # # ####### ######### # ##### ####### ### 
# # #   # # #   #   #     #     # #   # #   # # #     #     #   # # # #           #   # #   #     #   #     #     #       # #   
# # # ##### # ### # # ### ####### ### # ### # # # ### # ### # # # ### ####### ####### # ##### ####### # ######### ####### # # # 
#   #   #   #   # # #   #       #   # #       # #   # # #   # # #     #       #       #     # #   #   #         #       # # # # 
# ####### ##### # ##### ####### # # # ######### ### # ### ### ####### ######### ########### # # ### ######### ######### # # # ##
#       # #   # # #     #     # # # #         #     #   # #   #   # #       #   #   #   # #   #       #   #   #   #     #   #   
####### # # ### # # ##### ### # # # ####### # ######### # # ### # # ##### ### ### # # # # ######### # # ### ### ### ########### 
# #   # # # #   # #   #   #   #   #   #   # #   #       # # #   #         #   #   #   # #     #   # #   #   #   #   #   #       
# # # # # # # ### ### # # # ####### ### # ##### # ####### # ### ######### # ########### ##### # # # ##### ### ### ### # # # # # 
#   # # # #   #     # # # #       # #   #       #       #       #   #   # #         #       #   # #   #   #   #     # #   # # # 
# ##### # # ### # ### # # ####### # # ################# ####### # # # # # ######### ####### ##### ### # ### ##### # ####### # # 
#       # #   # # #   # #   # #   # # #   #     #   #   #     # # # # #         # #     # # #         #   # #   # # #   #   # # 
# ####### ### # ### ####### # # ### # # # # ### # # # ### ### ### # ##### # ### # ##### # # # ##### ##### # # # ### # # ### # # 
#         # # #   # #     # # #     #   # # #   # # #       #   # #     # # # # # # #   # # # #   #   #   #   # #   # #   # # # 
########### # ### # # ### # # ### ####### # # ### # ### ####### # ##### ### # # # # # ### # # # # ### # ####### # ### ### ### # 
#   # #     #   # # #   #   #     #   #   # #     #   #   #   # # #   # #   #   #   # # #   #   #   # #   #     # #   #       # 
### # # ####### ### # # ########### # ##### ######### ##### # # # # # # # ### ##### # # # ### ##### # ### # ##### # # ######### 
#   # # #     #     # #     #     # #   #   #     # #       # #   # # # #   #   #   # # # #   #   # # # # #   #   # #   #     # 
# ### # ##### ####### ####### ### # ### # ### ### # ######### ##### # # # # ### ### # # # # ### # # # # # ### ### ##### # ### # 
#   # #                 #     # #   # #   #   # #           #       #   # # #   #           #   #   #   # # #     #   # #   #   
### # ######### # ####### ##### ##### ##### # # ####### ####### ########### # ### ##### ######### ####### # ####### ### ########
# # #           # #       #                 #   #     #         #   # #   # #     #   # #   #   # #     #   #       #   #       
# # # ######### # # ####### ############### ##### ### ########### # # # # # ##### # # # # # # # ### ### ### # ####### # # ##### 
# # #   #     # # #   #         #   #         #   # # #   #   #   # #   #   #     # # # # #   #     #   #   #     #   # # # #   
# # ### # ### ### ### ######### # # # ####### # ### # # # # # # ### ############### # # # ########### ### ####### # # ### # # ##
# #     #   #   #   #         # # # #   #   # # #   #   # # #   # #   #   #       # #           #   #     # #   #   # #   #   # 
# ##### ### ### ### ######### ### # ### # # ### # ####### # ##### ### # # # ##### ############# # # ####### # # ##### # ####### 
#         #   #   # #       #   # #   # # # #   # #     #   #     # #   # #     #       #     #   #         # #     # #     #   
# ### # ##### ##### # ##### ### # ### ### # # ### # ### ##### ##### ##### ############# # ### # ##### ####### ##### ####### ### 
# #   # #   #   #   # #   #   # # # #     #   #     #     # #     #     #             #   #   # #   # #   #   #     #   # # #   
### ### # # ### # ### ### # # # # # ############### # ### # ##### ##### ############# ##### ##### # # # # # ### ##### # # # # # 
#   # # # #     #   # #   # # #   # #   #     #   # # # #       #   #       #   #   # #   # #   # #   # #   #   #   # #   #   # 
# ### # # ######### # # ### ####### # # # ##### # ### # ####### ### # ##### # # ### # # # # # # ##### # ##### ### # ##### ##### 
#   #   #           # # #   #       # # #     # #   #   #         # # #   #   #     #   # # # #     # #   # #   # #     # #   # 
# # # ############### # # ### ### ### # ##### # ### ##### ####### # ### # ######### ##### # # ##### # ### # ### # ##### # # # # 
# # # #   #         #   #   #   # #   # #   #   # #     #   #   # #   # #   #     #   # # #   #   # #     #     #   # #   # #   
# # # # # # ####### ### ####### ### ### # ####### ##### # ### # ##### # ### # ### ### # # ##### # # ### ########### # ##### ####
# # # # #   #       # #       #   # #   # #       #     # #   # #     # #   # # #       # #     # #   #   #   #   # #     # #   
# # # # ####### ##### ### ### ### # ##### # ##### # ##### # ##### ##### # ### # ######### # ##### ### ### # # # # # # ##### # # 
# # # #       #   #       #     # #   #     #   #   #         #   #     # #   #       #   # #   #   #   #   #   #     #   # # # 
# # ######### ### # ####### ### # ### # ##### # ### ####### # # ### ##### # ######### # ### # # # # ### ##### ####### # # # ### 
# #     #   #   # # #     #   # # # # # #     #   #         # #   # #     #   #       # #   # # # # #   #   #       #   # # #   
# ##### # # ##### ### ### ##### # # # ### ####### ######### ##### # # ####### # ####### ### # # # # # ### # # ##### ####### # ##
#     #   # #     #   # #     # # # # #   #     #     #     #   #   #   #     #   #   #   # # # # #   #   # #   #   #     # #   
# ### ##### # ##### ### ##### # # # # # ### ### ##### # ##### ######### ### ##### # # ### ### # # ####### # ### # # # ### # # # 
#   # #   #   #   # #   #     #       # #     # #   # #       #       #   #         # # #     # #         # #   # # # # #   # # 
### # # # ##### # # # # # ########### # ####### # ### ####### # ##### ### ### ####### # ####### ########### # ### ### # ##### ##
#   #   # #     #   # # # #   #     # # #     #     # #     #   #   #   #     #   #   # #       #   #       # #   #             
# ####### # ######### # # # # # ### # # # ### ### # # # ### # ### # ######### # # # ### # ######### # ####### ##### ####### ### 
# #   #   #   # #   # # #   # # # # # #     #   # #   #   # # #   #           # # #     # #                   #     #     #   # 
# # # # ##### # # # ### ##### # # # # ######### # ####### # # # ############### # ####### # ############### ### ##### ### ### # 
#   # #     # #   # #   #   # # # # #     #   # #       # # # # #     #       # #   #     # #         #   #       #   # #   # # 
# ### # ### # ##### # # # ### # # # ##### # # ######### ### # # # ### # ### # # ### # ####### ####### # # # ##### # ### ### # # 
# # # #   # # #     # #   #   # # #   #     # #   #   #   # #   #   #   #   # #   #   # #     #     #   # # #   # #     #   # # 
# # # # # # # # ####### ### ### # ### ####### # # # ##### # # ####### ########### ##### # # ### ######### # # # # ### ### ### # 
#   # # # # # #         #   #   #   # #   # #   # # #     # #       #     #   # #     #   #   #   #     # # # # # #   #   #   # 
# ### # # # # ######### # ####### # # # # # ##### # # ##### ####### # ### # # # ##### ##### # ### # ##### # # # ### ### ### ### 
# #   # # #         #   #       # #   # #     #   #                 #   #   #     #   #   # #   # # #     # # #     #   #   # # 
# # ##### ##### ##### ######### # ####### ### # ### ##### # ######### # ########### ### # ##### # # # ##### # ############### # 
# # #     #   #   #   #   #   #   #     #   #         #   #           # #   #       #   #       # # #     # #   #     #     #   
### ####### # ### # ### # # # ##### ### # # ######### ########### ##### # # # ####### ########### # ##### # ### ### # # ### ####
#   #       # #   # #   #   #   #   #   # #       #   #     #   # #   #   # #   #           #   # # #   # # # #     # # # #     
# ### ####### # ### # ### ##### ##### ### ####### # ### ### # # # # # ##### ### ########### # ### # ### # # # ####### # # ##### 
#     #     # #         # #   #       #   #   #   # #   #   # #   # #         # #           # #   #   # # # # #       #     # # 
########### # ####### # # # # # ####### ### # # ##### ### ### ##### ####### ### # ########### # ##### # # # # # ########### # # 
# #       # #   #   # # # # # #   #       # #   #     #   #   #       #       # # #       #     #     # # #                 #   
# # ##### # ### # # ### ### # ### # ##### # ##### ##### ##### # ##### # ##### # ### ##### # ##### ##### # ### ##### ############
# # #   # #   #   #   #     #   #     #   # #   # #   # # #   # #   # #     # #     #   # # #   #             #   #             
# # # ### # ######### ######### ### ### ### # # # # ### # # ##### # # ##### # ####### # # # # ####### ######### # ############# 
# #   #   #         # #   #   #   #   #   # # #     #   # #   #   # # #   # #     #   # # #   #   #   #       # #   #         # 
# ### # ##### ##### # # # # # ### ### ### ### ####### ### ### # ### ### # ####### # ### # ### # ### ### ##### # ### # ####### # 
#     # #   #   #   #   #   # #   #   # #     #       # # #   # # #   # #       # # #   # # # #   # #   #       #   #       # # 
# ##### ### ### ############# # ### # # ####### ####### # # # # # ### # ####### ### ##### # # ### # # ########### ### ####### # 
# #   #   #   #   # #   #   # # #   #   #   #   #   #   # # # #   # #   #     #   # #   # # #       # #   #     # #     #   #   
# ### ### ### ### # # ### # # # ##### ### # # ##### # ### # ##### # ##### ### ### # # # # # ##### ### # # # ##### ####### # ### 
# #     #   # #     #     #   #   #   #   # #       #       #   #   #   # #       # # #   #       #   # # # # #   #       # #   
# # ### # ### # ############### # # ### ### ################# # ### # # # ####### # # ######### ### ### # # # # ### ####### ### 
# #   # #     # #         #   # # #   # # # #   #       #   # #   # # # #       # #   # #     #   #   # #   # # #         #     
# # # # ####### # ####### # # # # ### # # # # # # ##### # # # ### # # ######### # ##### # ### ### ### # ##### # ############### 
# # # #   #     #   #   #   #   #   # # # #   #   # #   # #   # #   #     # #   #   #   # #   #   # # # #     #   #   #       # 
# # # ### # ####### # ######### ### # # # ######### # ### ##### ##### ### # # ##### # ### # ### ### # # # ### ### # ### ##### # 
# # #   #   #     # #     #   #   # # # #           #     #   #   # #   #   # #     #     #   #     #   #   #   # # #   #   #   
# ##### # ### ### # ##### # # # # # ### ######### ########### ### # # # ##### # ############# ########### ### ### # # ##### ####
#       # #   #   # #   #   #   # #     #       # #         # #       #     # #             # #   #S      #   #   #   #     #   
######### # ### ### # # ### ##### ####### ##### # # ####### # # ########### # ### ####### ### # # # ####### ### ### ### ####### 
# #       # #       # # #   #   #             #   # #     # # #           # #   #       #     # # # #     # #   #               
# # ####### ########### ##### # # # # # ##### ##### # ### # # # ####### # ##### ##### # ####### # # # ### # # ### # ##### # ####
# # #   # #       #   #       # # # # #     #     # #   #   #   #     # #   #   #   # #     #   #   #   # #   #   #   #   #     
# # # # # ####### ### ######### ### # ##### ##### # ### ##### ### ### ##### # ##### # # ##### ####### ### ##### ##### # ####### 
#     #   #     # #   #       #     #     #     # #   #     # #   #       # # # #   # #     #   #       #         #   #   #     
######### # # # # # ### ############### # ##### # ### ##### # # ######### ### # # ### ##### ### # ##### # # ##### ##### # ######
#     #     # # #   #             #     # #   # #   #   # #   # #       #     #       #   #   # # #     # #     #     # #       
# ### ####### # ##### ############# ##### # ### # ##### # ##### # ##### ############### # ### # # # ##### ##### ##### ######### 
# #   #       #   # # #             #       #   #     #       #   #   #           #   # #   #   # #     # #   #     #   #       
# ### # ######### # # # # ####### ### ### ### ############### ##### # ########### # # # ### ### # ##### # # ### ####### ####### 
#   #   #   #   #   # # # #   #   # # #   # #           #     #   # # #     # #   # #   # #   # # #   # # #     #   #   #   #   
### ##### # ### ### # ### # # # ### # # # # ######### # # ####### # # # ### # # # # ##### ### # # # # # # ##### # # ##### # ####
# #     # #   #     #   # # #   # #   # # # #     #   # # #       # #   #   # # # #   #       #   # # # # #   # # #     # # #   
# ##### # ### ##### ### ### ##### ##### # # # ### # ##### # ### # ####### ### # ####### ########### # # # # # ### ##### # # # # 
#       #   #               #           #     #   #         #   #             #         #           #   #   #         #   #   # 
