################################################################################################################################
################################################################################################################################
     #     #     #                                 #                 #     #   #       #             #     #       #     #     #
#### # ### # # # # ######### ####### ############# # ### ##### ##### # ### # ### ##### # ### # ##### # ### ##### # # ##### #####
     #   # # # # #     #   # #   #   #     #   #   #   # #   # #       #         #   #   #   # #   # #   #       # #       #   #
 ####### # ### # ##### # # ### # # ### ### # # # ### # ### # # ####### # # ####### # # ######### # ############### # ####### # #
 #   #   #   # # #   # # #   # # #   #   #   # # #   # #   # #     #   # # #       # # #         # #         #     #   # #   # #
 # # # ##### # # # # # # ### ### ### ### ##### # # ### # ######### ##### # # ####### # # ######### # ####### # ####### # # ### #
 # # # #   # # #   # # #   #   #   #   #     #   #   #   #   #   #   #   # #     #   # # #         #       # #   # #     # # # #
 # # # # ### # ##### ##### ### ### ### ##### ############# # # # ### # ########### ### # ####### ####### ### ### # # ### # # # #
   #   #   #   #   #       # # # # #   #   #   #     #     #   #     #     #     #   # # #     # #   #   #   #   #   #   # # # #
########## ##### # ######### # # # # ### # ### # ### # ####### ########### # ### ### # # # ### # # # # ### ### ####### # # # # #
   #   #       # #     #     # # #   #   #   #   #   # #       #       #   # #   #       #   # # # #   #   #   #     # # # # # #
 # # # # ##### # ##### # ### # # ##### ##### ##### ### # ####### ##### # ### # ######### ### # # # ##### ### ##### # ### # # # #
 # # # #   # #   # #   #   # # #   #   #   #   #   #   # #   #   #   # # #   #           #   # # #     #     #     #     #   # #
 # # # ### # ##### # ### ### # # ### ### ##### # ### ### # # # ##### # ### ##### ####### # ### # ##### ######### ### ######### #
 #   #     #     # # #     # # #     #   #     # #   #   # #   #   # #     #     #     #   #   #     #   #     # #   #   #     #
 ############### # # # ### ### ####### # # ##### # ### ### ##### # # ####### # ### ### # ############### # ### # # ### # # #####
   #     #       # # #   # #   #   #   #   #   # #   # #   #     # # #       #   # #   #       #         # #   # #   # # # #   #
## # # ### # ### # # ### # # ### # # ##### # # # ### # # ### ##### # # ########### # ##### ### # ######### # ####### # # # # # #
   # #     #   #   # # # # #   # #   #   # # # #     # #   #   #   #   #         # #     #   # # #     #   # #       # #   # # #
 ### ######### ##### # # # ### ####### # # # # ####### ### ##### ##### # ####### # ##### ### ### # ### # ### # ####### ####### #
   #         #           #   # #     # # # # #         # #       #     #   #   # #   #   # # #   #   # #   # # #     #       # #
#### ######### ######### ##### # ### # # # # # # ##### # ######### ####### # # # ##### ### # # ##### # ### # # # ### ####### # #
     #   #   #     #   #   #   #   # # # #   # #   #   #   #     #   #   # # # # #   #   #   # # #   #   # # #   #     #     # #
 ##### # # # ####### # ### # ##### # # # ##### ### # ##### # ### ### # # # ### # # # ### ### # # # ##### # # # ### ##### ##### #
   #   # # #   #     #   # #   # # # # # #       # #   #   #   #   #   # # #   #   #   #     #   # #   #   # # #   #     #     #
 ### ### # ### # ####### ##### # # # # # ######### ### # ##### ### # ##### # ######### ##### ### # # # ##### # # ### ##### ### #
 #   #   # # #   # #   #     # #   # # # #   #   #   #   #   #   # #   #   #       #   # #   #   # # # #   # # #           # # #
 # ### ### # ##### # # ####### ##### # # # # # # ### ##### ####### ##### ### ####### ### # ### ### # # # # # # ##### ##### # # #
 #   # # #       # # #         #   #   #   # # #   #         #   #   #   #   #       #   # #   # #   # # #   #     #     # #   #
 ##### # ####### # # ########### # ######### ##### ######### # # ### # ##### # ####### ### # ### ####### ##### ### # ### #######
   #   #           #             #           #     #   #   # # #     #     # # #     #   # #   # # #     #     #   #   #       #
 # # ##### ####### # ############# ########### ##### # # # ### ########### # # # ##### ### ### # # # ##### ########### ####### #
 # # #     #     #   #     #     #   #     #   #   # # # #   # #     #     #   #       #   #   #   # # #         #         # # #
 # # ### ### ### ### # ### # ### ### # # # # ### # ### # ### # # ### ####### ######### # ### ### ### # # ##### # ######### # # #
 # #     #   # #   # #   #   #   #   # # #     # #   # # # #   # # #         #   #     #   # #   #   #   #   # # #   #   #   # #
 ##### ### ### ### # # ####### ### ### # ### # # ### # # # ##### # ########### # # ### ### # # # # ### ### # ### # # # # # ### #
   #   #   # #   #     #     #   #     #   # #   # #   # # #   # #   #         #   #       # # # #   #   # #     # #   # #   # #
## # ### ### ### ### ### ### ### ######### # ##### ##### # # ### # # # ### ### ##### ##### # ### ### ### # ####### ##### ##### #
     #   # #   # #   #   #   #   #       # # #     # #   #       # #   #   #   #     #   # # #     #     #     #     #   #   # #
 ##### ### ### # # ### ####### ### ##### # # # ##### # ######### ##### # ### ### ##### # # # # ### ########### # # # # ### # # #
 #   # #     #             #     # #G  # # #           #   #   #     # # #   #   # #   # # # #   #   #         # # # #     #   #
## # # # ### ### ##### ### # # # # ### # # ### # ### ##### # # ##### # # # ### ### # ### # # ### ### # ########### # ######### #
   #   # #     # #   #   # # # # #   #   #   # #   # #     # #   # # # # #   #     #   #   #     # #   #           # #   #     #
 ####### # ### # # # ### # # # # ### ##### # # ### # # ##### ### # # ### ################# ####### ##### ### ####### # # # ### #
 #   #   #   #   # #   # # # # #   #     # # # # # #   #   #   # #   #   #   #       #   #   # #   #       # #     # # # # #   #
 # # ####### # ### ### # # ### ### ##### ### # # # # ### ##### # ### # ### # # ##### # # ### # # ######### # ##### # # # # # ###
 # #     #   # #   #   # # #     #     # #   # # # # #       # #   # #   # # # #     # # #     # #         #       # # #   #   #
 # ##### # ### # ### ### # # ######### # # ### # # # # ##### ##### # ### # # # ##### # # # ##### # ##### ########### # ####### #
 #   #   # # # # # # #   # #         # #   #   #   #   #   #       #   # # # # #   #   #   #     #     # #       #   # # #     #
#### # ### # # # # # # ### ########### ##### ####### ### ############# # # # ### # ### ##### ######### # # ##### # ### # # # ###
   # # #   #   # # # # # # #       #   #     #         #             # # # #   # #     #     #         # # #   #   # # #   # # #
 # # # ### ##### # # # # # # ##### # ### ##### ##### # # # ### ####### # # ### ####### # ##### ### ####### # ####### # ### # # #
 #   #   # #     #   # # # # #   #   # #   #   #     # # #   # #     # # # #   #       # #     #   #       #         # #   #   #
 ####### ### # ##### # # # # # # ##### ### # # # ####### ### ### ### # # # ##### ####### ####### ### ######### ### ### # # #####
 #     #     # #   #   #   #   #   #       # # #         # #       # # # #             #       # #   #       # #   #   # #     #
## ### ######### # # ####### ##### ######### ############# ######### # ##### ##### ### ####### # # ######### ### # # ######### #
   # #   #   #   # # #     #     #     #   #     #         # #       #   #   #   #   #   #   # # # #       #   # # # #       # #
 ### ### # # # ### # # ### # ##### ### # # # # ### ### # # # # ######### # ### # ### # ### # # # # # ##### ### # # # # ##### # #
 #   #   # #   #     # # # # #   #   #   # # #     # # # #   #       #   # #   #   # #   # #   # # #     # #   # # # # #   # # #
 # ### ####### # # ### # # ### # ######### ### ##### # # ########### # ### # ##### ### # # ##### # ##### # # ##### # ### # # # #
 #     #     # # # #     #   # #     #   #   #       # #           #   #   #     #   # # #   #   # #   # #   #     # #   #   # #
 # ####### # ### # # ####### # ##### # # ### # ### ### ##### ### ####### ####### ### # # ### ##### # ### ##### ##### # ####### #
 #   #     #     #   #       #   # # # #     #   #   #     #   #       #     #   # # # #   #       #     #   # #   # # #       #
#### # ####### ##### ########### # # # ######### ### ##### ### # ### ### ##### ### # # # # ######### ##### # # # # # # ### ### #
     #     #   #   #     #     #   # #     # #   #   #   # #   #   #     #     # #   # # # #     #   #     #   # #   #   # #   #
 ######### ##### # # ### # # ### ### # ### # # ####### # # ##### ######### ##### # ##### # # ##### ### ##### ### ####### # # ###
 #     #   #     # # # # # #     #   #   # # # #     # # #   #   #       #   #   # #     #   #   #     #     #   #       # # # #
 ##### ##### ##### # # # # ####### ####### # # # ### ### ### # ### ######### ### # ### ####### # ### ####### # ### ####### # # #
     # #     # #   #   # #   # #   #   #   #   #   #   #     #     #       #   # #   #       # #   # #   #   #   # #       #   #
#### # # ##### # ##### # ### # # ##### # ######### ### ############# ### ##### # ### # ##### # ### # # # # # ### # # ### # #####
   # #   #   #   #     #   # # #       #         #   #   #   #     # # #     # #   # #   # # #   # # # #   #   #   # #   #     #
 ### # ### # ### # ######### # ##################### ### # # # ### # # ### ### ### # # # # # ### ### # ####### ####### #########
 #   # #   #       #   #   # #                   # #   # # # # # #   # #   #   #   # # #   #   #   # # #               #   #   #
 # ##### ####### ### # # # # ### ############### # ### ### ### # ##### # ### ### ### ######### ### # # ############# ### # # # #
 #   #   #     # #   #   # #   #   # #   #   # # #   # #   #   # #     # #   #     #     #     #   # #   #   #     # #   #   # #
 ### # # # ### # # ####### ### ### # # ### # # # # # # # ### ### # ##### # ####### ##### # ##### ### ### # # # ##### # ####### #
 #   # # # # # # #       #   #   # #   #   #       #       # #     #   # #     # #   #   #   #   #     #   #   # #   # #     # #
 # ### # # # # # ####### ### ### # # ### ### ######### ##### # ##### # # ##### # # ### ##### # ### # # ######### # ### # ##### #
 # #   # # #   #   #     #   #   # #     #   #       #   #   #   #   # #     # #     # #     # #   # # #     #   #     #   #   #
 # ### # # ##### # # ##### ### ### ######### # ##### ### # ##### # ### # ### # ### # # ####### ### # # # ### # ########### # ###
 # #   # #       # #     # #   #   #   #     #   # # #     #   # # #   #   # #   # # #       #     # #   # # # #       #   # # #
 # # ### ######### # ##### # ### ### # # ### ### # # ##### # ### # # ##### ##### # ######### ####### ##### # # # ### ### ### # #
   #   # #     #     #   # #     #   #   #   #   # # #   #       # # #   # #   # #       # #   #   #     # # # #   # #   #   # #
 ##### # # ### ##### # # ########### ##### # # ### # # # # ####### # # # ### ### # # ### # ### # ##### # # # # # # # # ### ### #
       # #   # #     # #     #     #     # # #     # # # # #     # #   #   #   # # #   #   #   #       # #   # # # # # # #   # #
######## ### ### ### # ##### ### # # ### # # ####### # # # # ### # ####### ### # # ### ### # ########### ##### # # ### # ### # #
 #     #   #   # #   #     #   # # # #   # # #     #   #   #   # #   #   #   #   #   #   # #               #   # #   #     #   #
 # ##### # ### # # ####### ### # # ### ### # # # ######### ### # ### # # # ####### # ### # # # ######### # # ### ### ##### #####
 #       # # # # #     #   #   # #     #   #   #     #       # # #   # # # #     # #   # #   # #   #     #   #   #       #     #
 ######### # # # ##### # ####### ######### ########### ##### # # # ### # ### ### # ### # # ### # # ### ####### ### ########### #
             #   #     #   #   #   #         #     #   #   # # #   #   # #     # # #   # # #   # #   #       # #   #       #   #
 ######### ####### ####### # # ### ### ####### # ### ##### # # ##### ### # ##### # # ### ### ### ### # ##### # # ### ### ### ###
 #   #       #     #     #   #   #   # #       # #   #   #   # #   # # # # #     # #   #   #   # # # # #   #   #     # #     # #
## # # ### ### ### # ########### ### # ######### # ### # # ### ### # # # # ####### ####### ### # # # # # # ########### ####### #
   # #   #   # #   #       #   #     #       #   #     # # # # #   #   #   #     #       #   #     # #   #               #     #
 ### ### ### # ### ####### # # ##### ##### ### ########### # # # ##### ##### ### # ##### ### ####### ######### # ##### # # ### #
   # #   #   #   #   #   # # #       #   #       #   #       # # #   # #       # # #   # #       #   #   #     # #   # # # #   #
## ### ### ##### ### # ### ### # ##### # ######### # # ####### # # # # # # ### # ### # # # # ##### ### # # ##### ### # ### # # #
 #     #   #   # #   #   #   # # #   # # #         # #     #   # # #   # #   # #     #   # # #     # # # #     # #   #   # # # #
 ####### # # # ### ##### ### ### # # # # # ######### ##### # ### # ######### # ####### ### ### ##### # # ##### # # ##### # # # #
       # # # #   #   #   #   #   # #   # #   #       #     # #   #   #       # #       #   #   #     # #       # #     #   # # #
###### # # # ### ### # # # ### # # ##### # # ### ##### ##### ### ### # ####### # ### ### ### ### ##### ######### # ######### # #
         # # # #   #   # #     # # #   # # #   #   #   #     #   # # # #       # #   #   #   #   #     #         # #       # # #
 ########### # ### # ### ####### # # # # ##### ### # # # ##### # # # ### ####### # ### # # ### ### ######### ### # # ##### # # #
   #         #     # #           # # # # #     # # # #         # # #   # #       # #   # # #     #         # #   # # #   #   # #
## # ####### ##### ### ####### ### # # # # ##### # ############# # ### # # # ### ### ### # ##### ######### # # ### # # ####### #
   #     #   #   #     #     #   # # #     #     #             # # #   # # #   # #   #   # #   #     #     # #     # #     #   #
 ####### # ### # ####### ### ### # ############# ############# # # # ### ##### # # ####### # # ##### # ##### ####### ##### # ###
 #       # #   #       # # #   # # #   #                 #   # # # #   #     # # # #     #   # #       #   #     #   #   # #   #
 # ####### # ######### # # ##### # # # ### ##### ######### # # # # ### ##### # # # ##### ##### ######### # # ##### ### # # #####
 # # #     # #       # # #       # # #   # #   # #     #   # # # # #   #     # # #   #   #   #     #   # #   #   #     #   #   #
## # # # # # ####### # # ### ##### # ### ### # # # ### # ### # # # # ### ##### # ### # ### ####### # # # ##### # ########### # #
   #   # # # #   #   #   #   #   # # #   #   # #     #     # # #   # #   #     #   #   # #       #   # # #   # # #           # #
 ######### # # # ### ##### ##### # ### ### ### ### ######### # ### # # ### ####### ##### # ##### ##### # ### # # # ########### #
         # #   #   #   #   #     # #   #   # #   #         # #   # #   #   # #           # #     #     #     # #   #   #     #S#
 ####### # ####### # # # ### ### # # ### ### ### # ####### # ### # ##### # # # ##### ##### # ##### ##### ##### ####### # ### # #
   #   # # #     #   #   #     # # #   #     # # # #     # #   #     #   #   #   # #   #   # #     #       #   #         #   # #
 # # # # # # ############# ### ### ### ####### # # ##### # ####### # # ######### # # # # ### # ##### ####### ### ############# #
 # # #   #     #           #   #   #   #       # #   #   #       # #   #     #   # # # # #   #     # #     #   #   #           #
## # # ####### # ### ### ### ### ### ### ####### ### # # ##### # # ##### ##### ### # # # ##### ### ### ### ### ### # ######### #
   # # #   #   # # #   #   # # #     #   #       # #   #   #   # #     #   #   #   # # # #   # #   #     #   # # # # #         #
 # # ### # ##### # ### ### # # ####### ### ####### ####### # ### ##### ### # ##### ### # # # ### ### ####### # # # # ##### #####
 # #   # #       # #   # # # #   #       # #             # #   # #   #   # # #   #     # # #     #   #     #       # #   #     #
 ##### # ######### # ### # # ### # ### ### # ##### ####### ### # # # # ### # # # ####### # ####### ### ### ######### # # ##### #
     #           #   #     #         #           #         #   #   # #     #   #         #           #   #           # #       #
################################################################################################################################
