################################################################################################################################
################################################################################################################################
   #   #         #             #     #   #   #         # #         #               #                 #             #       #   #
 ### ### ####### # ########### # # # ### ### # ####### # # ##### ### ####### # # # # ############### # ########### # ##### # # #
 #   #   #     #     #       #   # #   #   # #     # # # # #   #           # # # # # #           #   #   #         #     #   # #
 # ### ### ### ####### ##### ##### # # ### # ##### # # # # # # ##### ####### # # # # # ######### # ##### # ####### ##### ##### #
 #   #     # #   #   #     # #     # #             #   # #   # #   #     #   # # # # #   #     # #     # # #   # # #   # # #   #
 ### ####### ### # # ####### # ############# # ######### # ##### # ##### # ##### # # ### ##### # ##### ### # # # # # # # # # ###
             #   # # #   #   #   #     #   # #           # #     # #   # #   #   # #   #       #         # # # #   # #     #   #
 ########### # ### ### # # ### # # ### # # # # ######### # # ####### # # ### # ####### ### ############# # # # # ### ####### # #
   #   #   #     # #   # # #   #     #   # # # #     #   # # #       # # #   #   #   #   # #   #   #   #   # # # # # #     # # #
#### # # # ##### # # ### # # ######### ### # # # ### # ### # ##### ### ### ### # # # ### ### # # # # # ##### ### # # ##### ### #
     # # #   #   # # # #   # #       # #   # #   #   # #   #       # #     #   #   #   #     #   #   #       #     #   # #     #
 ##### # ### # # # # # ####### ##### # # ### # ####### # ########### ####### # ####### ####################### ####### # #######
 # #   #   #   #   # #   #     #   # # # #   # #     # # #     #             # #     #               #   #     #     # #   #   #
 # # ####### ##### # # ### # ##### # # # ### # # ### # # # ### ########### # # # ### # ### ##### ##### # # ##### # ### ### # # #
   # #     # #     # # #   # #   #   # #   # # # #   #   # #   #   #   #   # #     # #   # #   #   #   #   #   # #     #   # # #
#### ### # ### ### # # # # ### # ### ##### # ### # ### ### ### # # ### # # # ####### ### # # # ### # ####### # # ####### ### # #
   #   # #     #   # # # # #   #   #   #   # #   # #     #   # # #   #   # #   #     #   # # # # # # #       #   #     #   # # #
 ##### # ### ##### # # # # # ##### ### ##### # ### ######### # # ### ##### ##### ##### ### # # # # # # ############# # ### # ###
 #     # #   #     #   # # #     # # #   #   #   #           # #   #     # #   # #     #   # # #   # #     #   # #   #         #
 # ##### ### # ### ### # # ##### # # ### ####### ############# ### ##### # # # ### ##### ##### ##### ##### # # # # ### ####### #
   #   #   # #   #     # #     # # #   #         #           # #   #     # # #   #     #       #     #   #   # # #   # #   #   #
 ### ##### # ####### ### ####### # # ####################### # # ### ####### ### ##### # ####### ##### # ##### # # # # # # # ###
 # #       #   #   #   #   #   # # #     #           #       # #   # #       # #       # #   #   #     #   # # # # # # # # #   #
 # ########### # # ### ### # # # # ##### ### # ##### ### ##### ### # ######### ##### ##### # # ### # ##### # # # ### # # # ### #
 #             # # #     #   #   # #   #  S  # #   #   # #     #   #     #   #       #   # #   #   # # #   # # #     # # #     #
 ### ########### # # ### ######### # # ######### # ### # # ##### ####### # # ######### # # ######### # # ### # ####### # ##### #
   # #           # # #   #   #     # # #   #     #   #   #       #       # #           # #   #       #   #   #       # # #   # #
## ### ### ####### ### # # # # ####### # # # ####### ### ######### ####### ############# ### # ####### ##### ####### ### # # # #
   #   #   #   # # #   #   # #   #     # #   #     # #   #     #   #     #   #   #         #   #   #   #           #   # # #   #
 ### ##### # # # # # ##### ##### # ##### ##### ### # # # # ### # ##### ##### # ### # ##### ##### ### ### ######### ### # # ### #
   #     # # # # # # #   # #   #   #     #   # #   # # # #   # # #     #   # #     # #   # #     #   #     #       # #   # #   #
## ##### ### # # # ### # # # ####### # ### ### # ### # # ### ### # ### # # # ####### # ### # ### # ### ### # ##### # ### ### # #
 #     #   # # #       # #           #     #   # #     #     #   # #   # #   #       #   # # #   #   # #   # #   #       #   # #
 ##### ### # # ######### ### ### # ######### ### ########### # ### # # # ##### ##### ### # # # ##### ### ### # # ######### ### #
     #     # #     #   #     #   #         #   #           #       # # #     # #   #   # #   #     #   # #   # #   #   #   #   #
#### ### ### ##### # ####### # # ##### ### ### ########### ### ##### # ##### # # # ##### ######### ### # # # # ### # # # ### # #
         #   #   # #         # #     #   #   #       #   #     #     #     # #   # #     #       # # #   # # # #     # #   # # #
 ### ### # ### ### ### ####### ######### ### ####### # # ##### # ######### # ####### ##### ### # # # ##### # # ####### ##### # #
   # #   # #     #   # #     # #       #   #   #   # # # #     # #         #       # #     #   #       #   # #     #   #   # # #
## # ##### # ### ### ### ### # # ##### ### # ### # ### # ####### ######### ####### # # # ### ####### # ### ####### # ### # ### #
   # #     # #           #     # # #   #   # #   # #   #     #   #         #     #   # #   #   #   # #   # #     # #   # #     #
 ### # ##### # ########### ##### # # ### ### # ### # ####### # ### ####### ##### ##### ### ### # # # ### # # ### # ### ####### #
   # #   #   #     #     # #   # # #   # #   #   #   #   # # # #   #     #   #   #     #   #   # #   # #   #   #   # #   #     #
#### ### ########### ### ### # # # ##### # ##### ##### # # # # # # # ### ### # # ####### ### ### ##### ##### # ##### ### # ### #
       #             # #     #     #     # #     # #   #   #   # # # #   #     #         #   #   #     #   # #     # #   # #   #
 ##################### ##### ##### # ##### # ##### # ########### ### # ################# # ### ### ##### # ####### # # ##### # #
 #               #     #   # #   # # #     #   #   # #   # #   #     #       #           #   #     #   # # #   # # # #     # # #
 # ######### # ### ##### # ### # ### ######### ### # # # # # # ############# ######### # ### ####### # # # # # # # # ##### # # #
 #     #   # # #   #     #     #     #       #   # # # # #   #             #   #     # #   #     #   # # #   # # # # #   #   # #
 ##### # # # # # ### ##### ########### ######### # # # # ### ##### # ##### ### # ### # ### ##### # # ### ##### # # # ### ##### #
     # # # # # # # # #     #     #   # #         # # # #   # #   # # #   # #   # # #   #     # # # #   #   #   #   # #     #   #
 ##### # ### ### # # ##### # ### # # # # ######### # ##### # # # # ### # ### ### # ### # # # # # # ### ### ######### # ##### ###
     # #   #     # #     # # #   # # # # #   #                 # #     #   # #   #     # # # # # # #   # #   #     #   #   # # #
 ### # ### ####### ##### ### # ### # # # ### # # ############### # ####### # ######### # # # # # # # ### ### # ### ### # # # # #
   #   #             # # #   # #   # #   #   # #     #     #   # #   #   # #       # # # # #   #   #   #   #   # #   #   #   # #
## ##### ########### # # # ### # ### ##### ### ##### # ### # # # ##### # # ####### # # # ############# ### ##### ### # ####### #
 #                 #   #   # # #   #     # #   #   # #   # # # #   #   #   #   #   #   # #         # # #   #   # # # #         #
 ### # ########### ### ##### # ### ####### # # # # # ### # ### ### # ####### ### ####### # ##### # # # # ### # # # # # #########
 #   #   #     # #   # #   # #   #         # # # # #   # #   #   # #       #     # #   #   #   # #   #   # # #     #   #       #
 # ### # ##### # ### # ### # ### ######### # # ### # # # ### ### # # ############# # # ##### # # # ####### # ######### # ##### #
   #   #       #   # #     #   #   #     #   # #   # # #   # # #   # #     #     #   #     # #   #   #   #   #       # #   # # #
#### # ########### # # ####### ### # ### # ### # ##### ##### # # ##### ### ##### # ######### ##### ### # # ### ##### # ### # # #
   # #   #         # #     #   # #   # # #   #   #   #     # # # #   #   #   #   #           #   #     #   #   #     #   # #   #
 # # ### # ######### # ### # ### ##### # # # ##### # ##### # # # # # # ##### # # ############# # # ######### ######### ### #####
 #     #   #   # #   #   # # #   #     # # #       #   # #   # # # #   #   # # #           #   #     #   # #   #   #   #   #   #
 ########### # # # ##### ### # ### ##### # ########### # ##### # # ##### ### ##### ####### # # ### # ### # ### # # ### # ##### #
 #   #       #   #     # #   # #   #     #         # # #     #   # #   #     #   #   #   #   #   # #     # # #   #   # #     # #
 # ### ######### ##### ### ### # ##### ########### # # ##### ### # ### ####### # ##### # ### ### # ####### # ####### # ##### # #
 #     #   #   # #   #     #   # #     #           #   #       # # #   # #     #     # #   # #   #           #       #     #   #
 ####### ### # # # ######### ### # ##### ##################### # # # # # # ######### ##### ### ##### ##### # # ########### ### #
 #     #   # #   #     # #     #   #   #       #   #       #     #   # # #       #   #   #   # #   # #     # #     #     #   # #
 # # # ### # ######### # # ### ####### # ##### # # # ##### # ######### # ### ##### ### # ### # # # # # ########### ##### # ### #
   # #   # #   #     # #   #   #     #   #   #   #   #   # #   #           # #     #   # #     # # # #           #   #   # #   #
 ### # ### ### # # ### # ####### ### # ### # ######### ### ##### ##### ### # # ##### ### ####### # ### ####### # ### # ### # ###
   # #       # # # #     #     #   # #     #   #     # #   #   #   #   #   # # #     # #   #     #   # #   #   #   #       #   #
## # ######### # # # ##### ### ### # ######### # ### # # ### # ##### ### ### # # ##### ### # ####### ### # # ######### ####### #
   #           # #   #   #   #     # #   #     #   #   # #   # #     #     # # # #       #   #     #     # # #         #     # #
 ############### ##### # ########### # # # ####### ### # # ##### ##### ### # # # # ##### ##### ########### # # ####### # ##### #
           #     # #   #             # # #   #   # #   #   #     #     # #   #   #   #       #         #   # # # #     #     # #
## # ### ### ##### # ################# # ### # # # # ####### ####### # # ########### # # ### # ######### ##### # # ######### # #
   #   #   # #   # #   #       # #     # #   # # # #     #   #       #   # #     #   # # #   # #       # #   #   # #       # # #
 ##### # # # ### # ### # ##### # # ####### ##### ##### ### ### ### ####### # ### # ### # # ### # ##### # # # ##### # ####### # #
 #   # # #   #       # #   #   #         # #   #     #   #   #   #       #   # #   #   # #     # # #   #   # #   #       #   # #
 ### # ### ### ####### ##### ########### # # # ##### # # ### ####### ### # ### ##### ### ####### # # ####### # # ####### # ### #
     #   # #   # #     #   # #     #     # # #     # # # # #       #   #   #       # #     #   # #     #     # #       #   # # #
######## # # ### # ##### # # ##### # ##### # ### ### # # # ####### ### # ### # ##### # ### # # # ##### # ##### ####### ### # # #
       # #   #   # # #   # # #   # #           #       # #     #   #   #     #     # #   # # # # #   #   #   #   #   #   # # # #
 ##### # # ##### # # # ### # # # # # ##### ### ######### # ##### ### ### ######### # ##### ### # # # ##### # ### ### ### # # # #
     #   # #   # # #   #       #     #   # # # #       #   #     # # # #         # #   #   #   #   #   # # #   #   #   # #   # #
 ### ##### # # # # ##### ##### ####### # # # # # ##### ##### ##### # # # ####### # ### # ### ######### # # ### ### # ### ### # #
   # #       #   #     #     #   #     # # #   # #           #   # # #   #   #   #   # #     #       # # # #       # #   #   # #
#### # ############### # ### ### # ##### # ##### # ########### # # # # ### ### ####### # ##### ##### # # # ######### # ### ### #
     #       #           # #   #   #     # #   # # #       #   # #   # #   #   #   #   #     #     # # # #       #   # #       #
 ######### # # ######### # ### # ### ####### # # ### ##### ### # ##### # ### ### ### ############# # # # ######### # # # #######
   #       # # #   #   # #     #   #         # #     #   # #   #       # #   #     # # #           # # #     # #   #     #     #
## # # ####### ### # # ######### ############# ####### ### # ####### # # # ### ### # # # ############# # # # # # ######### ### #
   # # #   #   #   # # #   #         #     #   #       #   #     # # # #   # # #   # # #               # # # # #   #   #   #   #
 ### # # # # ### ### # # # ### # # ### ### # # # ####### ### ### # # ####### # # ### # ################### # # ### # # # ### ###
 #   # # #   #   #   # # # #   # #   # #   # # # #     #   #   #   #   #   # # #   #   #             #   # #     #   # # # #   #
 ##### # ##### # # ##### # # ####### ### ### # # ### ##### # # ####### ### # # ######### ### ##### # # # ##### ####### # # ### #
     # #       # #       # #       #   # #   # #   # #   # # #   #   #   # # #     #     #   #   # # # #       #       # #   # #
#### # ######### ######### # ### ##### # # ### ### # # # # # ### # ##### # # ##### # # ####### # ### # ####### # ####### ### # #
     #   #       #       # #   #     #   #   #   #   # #   #   # #       #       # # # # #     #   # #   #   #     #     # # # #
 ####### # ####### ### ### # # ### ######### ####### # ####### ########### ####### # # # # ####### # # ### # # ### # ##### # # #
   #   # #   #   # # # #   # #   #         # #     # #       #             #   #   # #   # #     # # # #   # # #   # #     #   #
 # # # ### ### # # # # # ##### # ####### # # # # ### ####### # # ### ####### # # ### ##### # ##### # # # ### ### # # # #########
 #   #   # #   #   # #   #     #       # # #   #     #     # # #   #         #   #     # # #     # # # #   # #   # # # #   #   #
 ####### # # ####### ##### ######### # # # ########### ##### # ### # ############### # # # ##### # # ##### # # ### # # # # # # #
   #   #   # # #                 #   # # #       #         # #   # #   #     #       #   # #   #   #   # # #   #   # # # #   # #
 ### # ##### # # # ### ######### # ##### ######### ####### # ##### # # # ### ####### ##### # ######### # # # ##### # # # ##### #
   # #     # #   #   #   #   #   # #   #         # #   #   # #   # # # # # #   #     #     #   #   # # #   # #   #       #     #
## # ### # # ####### ### # # # ##### # ######### # # # ##### # # # ### # # ### # ##### ##### # ### # # ### ### # # ##### #######
   # #   # #     #     #   # #       # #     # #   # #       # #   #   # #     # #     #   # #       # #   #   # # #   # #     #
 ### # ### ##### ##### ####### ####### # ### # ##### ######### ##### # # ######### ####### # ######### ##### ### # # # # # ### #
     # # #     #     # #     # #       # # #   #   # #     #   #     # # #   #     #             #   #   #   #   # # #     #   #
###### # # ### ##### # # ### # # ####### # ##### # # # ### # ### ### ### ### # ##### ### ######### # ### # ######### ##### #####
     # # #   # #   # # # # # # #G          #     #   #   # # #   # #     #         #   # #   #   # #   # #         # #   #     #
 ### # # # # # ### # ### # # ##### ######### ########### ### # ### ####### ### ### ### # # # # # # ### # ######### ### # ##### #
 #   # #   # # #   #     # #     #     #     #         #     # #   #         # #   #   #   #   #   # # #       #   #   # # #   #
 ##### ##### # # ######### ##### ### ### ########### # ####### # ### ####### # # ### ############### # ####### # ### ### # # ###
   #     # # #   # #   #     # #   # #   #     #   # # #       # #   #   # # # #     #   # #         # #     # #     # # # #   #
## ##### # # ##### # # ##### # ### ### ### ### # # # ### # ### # # ### # # # # ####### # # # ##### # # # ### # ####### # # ### #
 #     # # #     #   # #   # #   #   # #   # # # # #     #   # # # # # #   # # #       #   # # #   # #   # # #   #     # # #   #
 ##### # # ### # ##### # # # # # ### # # ### # # # ######### # # # # # ##### # # # ######### # # ######### # ### # ##### # # ###
         #     #         #     #   #   #     #   #           #       #       #   #             #           #                   #
################################################################################################################################
