################################################################################################################################
#                                         #         #       #       #   # #     #   #   #   #     #       #   #         #       
# ######### ##### ### ### ########### # # ######### # ##### # ####### # # # ##### # ### ### # ### # ### ### # # # ##### # ##### 
# # #       #     #   #   #         # # # #       #   #   #     #     # #     #   #             # #   #     #   #     # #   # # 
# # # ############# # ##### ####### ### # # ##### ### # # ##### # ##### ### ### ################# ### ############### # ### # # 
# # #     #         # #     #     # #   #   #     #     #     # #     #   #     # #       #   #   #   #   #   #   # # #     #   
# # ##### # ######### # ##### ##### # ####### ####### ####### ########### # ##### # ##### # # # ### ### # # # # # # # ##########
#   #     #   #   #   # # #   # #   #   #   # #     #       # #           # # #   #   #   # #   #   #   #   # # # # #           
# ### ######### # ### # # # ### # ##### # # # ### # ### ### # # ####### ### # # ### ### ### ### # ########### # # # ########### 
#   # #   # #   #   # # #       # #     # #   #   # #     # #     #   #         #   #   #   #   #   #       # # #     #   #   # 
# # # # # # # ##### ### # ####### # # ### ##### ### ### # ##### ### # ##### ##### ### ### ### ##### # # ##### ##### ### ### # # 
# # # # #   # #   #   # #   #   # # #   # #   #   #   # #     # #   # #   #    G  #   #   #   #     # #   #   #   # #   #   #   
# # # # ##### # # ### # ### # # # # ### # # # ### ### # ##### ### ### # # # ####### ########### ##### ### # ### # # # ### ######
# # #   #   # # # #   #   #   #   #   # # # #     #   # #   #   # # #   # #       #   #     #   #   #   #   # # #   #     #   # 
# # ##### # # # # # ##### # ########### # # ####### ### # # # # # # ##### ####### ##### ### # ### ##### ##### # ########### # # 
# #     # # # # # #       # #           # # #     # # # # # # # # #     # #     # #       # #   #     #   #   #   #       # # # 
# ##### ### # # # ######### ############# ### ### # # # # # ### # # # # # # ### # # ####### ### ##### ### ### ### # ####### # # 
#     #     # # #         #         #   #     #         # #     #   # # # # #     #   # #   #   #   #   #   #       #       # # 
# # ######### # ######### ######### # # ####### ####### # ########### # # # ######### # # ### ### # ### ### # ####### ####### # 
# #       # # #   # #   #   #   #   # #         #     # # #   #     # # # # #     # # # #   #     # #           #     #   #   # 
# ####### # # ### # # # ### # ### ### ########### ### ### # ### ### # ### ### ### # # # ### ####### ##### ##### # ##### # # ### 
#     # #   #     # # #   # #     #   #       #   # #   # #   #   # # #   #   # # # # #   #       #     #   #   # #     # # #   
# ### # ########### # ### ### ####### ### ### # ### ### # ### ##### # # ### ### # # # # # ####### ##### # # # ### ####### # ### 
#   # # #   #       # # # #   # #   #   # #   # # # #   #   # #     # #   #     # #   # #       # #     # # # #   #       #   # 
### # # # # # ### # # # # # ### # # ### ### # # # # # ### # # # ##### ### ####### ### # ####### # # ##### # ### ### ######### # 
#   # # # #   #   # # # # #   #   #   #     # #   # # #   # # # # #     # #     #   # #     #   #   #   # #     #       #   # # 
# ### # # ######### # # # ### ####### ####### ### # # # ##### # # # ### # # ### ### # ####### ####### # # ####### ##### # ### # 
#   #   #   #     # # # #     #   #   # #   #   # # # #     # # #   #   #   # #     #   #   # #   #   # #   #   # #   # # #   # 
### ####### # ### # # # ####### ### ### # # ### # # # # ### # # ##### ####### ######### # # # # # # ### ### # # # # # # # # ### 
#           # #   # #   #       #   #     #     # #   #   #   #     # #       #       # # # # # # #   #   #   # #   # # #   #   
# ### ### ### # ####### ### ##### ### ########### ####### ######### # # ### # # ##### # ### # # # ### ### ##### # ### ####### ##
#   #   #     #     # #   #     # #           #   #   #         #   #   #   # #     # #   # # # #     # #  S  # #   # #         
### # # ##### ##### # ### # ### # # ### ##### # ##### # # ### ### ####### ### ### ### ### # # # ####### ##### # ### # # # ##### 
#   # # #   #     #     # # # #   #   # #   # #     #   # #   #   #     # #     # #   #   #   # #     # # #   #   # #   #     # 
# ##### # # ##### ####### # # ##### # ### # # ##### ##### # ### ### ### # # ##### # ### ##### # ##### # # # ##### # ######### # 
# #   # # #     # #     #           #   # # #     # #     # # # #   # #   # #   # #     # #   #     #     #   # # #   # #     # 
# ### # # ##### ### ### ### ########### # # ##### # # ##### # # # ### ##### # # # ####### # ####### ### ##### # # ### # # ##### 
# #   # # #   #   #   # #   #     #   # # # #   # # # #   #   # #   #         #   #   #     #     #     #     #   #     # #     
# # ### # # ##### ##### # ### ### # # # # # # # ### # # # ##### ### ####### ####### # # ##### ######### # ##### ### ##### # # ##
# # #   # #     #     # # #   #   # # # # #   # #   #   #     #     #               #                 # # #     # #     # # # # 
# # ### # ##### ##### # # # ### # ### # # ##### # ### ##### # ####### ### # ##### # ##### ########### # # # ##### # ### # ### # 
# #   # # #   # #     # #   #   # #   #     #   #   #   #   #   #   #   # # #     #   #   #     #     # # #       # # # #   #   
# ### # # # ### # ### # # ### ##### ### ##### ##### # ### ####### ##### # # ######### ##### ### ####### # # ### # # # # ### ### 
#   # # # #     #   # # #   #   #   #     #   #   # #   # #       #   # # # #       # #   #   #         # #   # #     #   #   # 
# ### # # ### ##### ### # # ### # ####### # ### # # # # # # ####### # # # # # ##### # # # ### ########### # # ########### ### # 
#   # # #   #     #     # #   # # #     # #   # #   # # # #         # # # #   # #   # # #     #   #   # # # #     #   #   #   # 
# # # ##### ##### ####### ### # # # # # ##### # ##### # # ########### # # ##### # ##### ####### # # # # # # ##### # # ######### 
# #   #   #   #   #       #   # # # # #       # #     # #       #     # #       # #     #       #   #   # #     #   #         # 
####### # ### # ### ### ####### # # # ######### ####### ####### # ##### # ####### # ##### ####### ####### ##### ######### ### # 
#   #   #   # # # # #   #     #   # #     #     #     #       #   #   # #       # # #   # #     # #     # #     # #     #   # # 
# # # ##### # # # # ##### ### ############# ##### ### ### ### ####### # # ##### # # ### # # ### ### ### # # ##### # ### ### # ##
# # #   #   #       #   # #   #       #   # #     # #     #   #       # #     # #   #   # # # #     # #   #   #   # # # #   #   
### ### # ### ####### # # # ### ##### # # # ####### ####### ### # # ### # ### ####### ### # # ####### ####### ### # # # ####### 
#   #   # #   #       # # #   # #   #   # #   #                 # # #   #   #         #   #   #       #           #   # #     # 
# ### ### # # # ####### # ### # # ####### ### ### # ### ######### # # ### ############# ############# # ####### ####### # ### # 
#     # # # # # #     # #   # # #       #   #   # # # # # #   #   # #   #         #   #   #                   # #       #   # # 
####### # ### # ### # # ##### # ####### ### ### # # # # # # ### # ##### ##### # # # # ### # ################# # # ######### # # 
#     # # #   #   # # # #     #       #   #     # #   #   #   # # #     #   # # #   # #   # # #         # #   # #           # # 
# ### # # # ##### # # # # ########### ### ####### ########### # # # ####### # # ####### ### # # ####### # # ### ############# ##
# #   # # # #       # # # #         # #             # #     #   # # #     #   #   #     # # # #   #     # #   #     #       #   
# # ### # # # ######### # ### ##### # # # ### # ### # # ### ##### # # ### ##### # # ##### # # ### ####### ### ##### # ##### ### 
# # #   # #       #     #   # #     # # # #   #   #   # # # #     #   #   #     # # #   #     #   #   #   #   #   #     # #   # 
# # # ### ####### # ####### # ####### # # # ##### ##### # # ##### ##### ######### # # # ### ### ### # # ### # # # ##### # ##### 
# # #   #   # #   # #   #   # #       # # #   # #     # # #     # #     #       # # # #   # #   #   # # #   # # #     #   #     
# # ### ### # # ### ### # ### # ####### # ### # ####### # ##### ### ##### ##### # # ##### # # ### ### # # ### # ##### ##### ####
# #         # #   #   # #     #   #   # #   #   # #   #   #   #   # #   # #     # #   #   # #   # #   #   #   # # #   #     #   
# ##### ##### # ##### # ### ##### # # # ### ##### # # ### # # ### # # # # # ##### ### # ### ### # # ##### ##### # # ### ####### 
# #   #         #   # # #   #     # #   # #       # #   #   # #   #   #   # #         # # #   # # # #     #       #   # #       
### # ##### ##### # # # # ### ##### ##### # # ##### ######### ############# # ### ##### # # # # # # ##### # ######### # # ### # 
#   #     # #     # #   #   #   #   #   #   # #     #   #   # #         #   #   #       # # # # # #     # #     #   # # # #   # 
# ####### # # ##### ####### ### ##### # ##### # ##### # # # # # ####### # ##### ######### # ### # ##### ####### # # # # ### ### 
#       #   #     #     #   # #     # #   #   # #     # # # # #     #   # # #       #         #   #   # #   #   # #   #   # #   
########### ##### ##### # ### ##### # ### ##### # ##### # # # ##### # ### # # # ### ######### ####### # # ### ########### # # ##
#           # #   #   # # #       # #   #   #   # # #   # #     #   #     #   #   # #       #       # # #   #     #   #   # #   
# ########### # ### ### # ####### # ### ### # ### # # ### ####### ############# # # # ##### ####### # # ### ##### # ### ### ### 
#   #     #   #     #   #         #   # #   #   # #     #   #     #   #   # #   # # # #   #   #   #           #   #   #   # #   
### ### # # ######### ########### ### # ####### # # ####### # ##### # # # # # ### # # # # ### # # ####### ##### ##### ### # # ##
#   #   # #                   #   #               # # #   # #       # # # # #   # #   # # #   # #       # #   #   #     #   # # 
# ### ### ### # ##### ##### ### ### ######### ##### # # # # ######### # # # ### # ####### # ########### # # # ### # ### ##### # 
#   # # #     # #   # #   #         #   #   # #   #     #   #     #   # #   # # # #       #     # #       # #   # #   #   #   # 
### # # ####### ### # # # ########### # # # ### # # ### ##### ### # ### ### # # # # ########### # # # ### # ##### # # ### # ### 
# # #   #     #   # # # # #           #   #     # # #   #   #   # # # # #     # #   #         # #   # #           # #   # #     
# # ##### ### ### # # # # # ##################### ### # # # ### ### # # # ##### # ### ##### # # ####### ####### ####### # ##### 
# #       # #   # # # # # # # #                 # #   # # #   #     #   #   #   #       # # # # #     #   #   #   #   # #     # 
# ######### ### # # # # # # # # ############# # # # ### # ### ########### ### ### ##### # # ### # ### ##### # ### # # ##### # # 
#       #   #   # #   # #   # #       #     # # # # # # # # #   # #   #   #   #   #   # # #   #   #   #     # #     #       #   
# ##### # ### ### # ### ##### ####### # ### ### # # # # # # ### # # # # ### ### # # ### # ### ##### ### ##### ######### ##### ##
# #   # #   #     # #   #             #   #   # # #   # # #     #   #   # # #   # # #   #     #   # #   #   #   #   #   #   #   
# # ### ### ####### # ### # ########### ##### # # ##### # ####### ####### # ##### # # ####### ### # # ### ##### # # ##### # ### 
# #   #             # #   #   #         #     #   # #   # #   # # #     # #     # #   #           #   #     # # # #   #   #   # 
# ### # # # ####### # ######### ######### ##### ### # ### # # # # # # ### ##### # ### ##### ########### ### # # ##### # ##### # 
# #   # # #     #   #         # #       # #   # #     #     #       #         # #   # #   #   #   #     # #   #       #   #   # 
# # ##### ##### # ########### # ####### # ### # ##### # ####### ##### ####### # ### ### # ##### # # ##### ################# ### 
# # #     #   # #         # # #   #     # #   #     #   #   #   #   # #   #   #   #     #     # # # #           #           #   
# # # ##### # # ### ##### # # ### # ##### # # ##### ##### # ### # # ### # ####### ##### ##### # # # # ######### # ########### # 
# # #     # # # #   #   #   #     #     # # # #   #   #   # #   # #   # # #   # # #   #     #   #   # #       # # #   #       # 
# # ##### # # # ##### # ############### # ### # # ### # ### # # # ### # ### # # # # # # # ########### # ##### # # # ### ### ####
#   #   # # #   #     # #       # #     #   #   #   #   #     #     #   #   #   #   # # #           #   # #   #     #   #   #   
# ##### # # ##### ##### # ##### # # ####### ####### ##### ######### ##### ########### ##### # ##### ### # # ####### # ### ### # 
# #     # #   #   #   #   #     # #   #   #   #           # #     #     #             #     # #   #   # # # #     #   #   #   # 
# # ##### ### # ##### # ### ##### ### # # ### # ### ### ### # ### # ################### ##### # ##### # # # # ### ##### ### ### 
#   #   #   #   # #   #   #   #       # #   # # #   #   #   #   #   #     #         #   # #   #       # # # # # #   #   #   #   
# ### # # # ##### # ######### # ####### ### # # ##### ### ####### ### ### ##### ### # ### # ########### # # # # ### ##### ### ##
# #   # # # #     #           #     # #   #   # #   #     #       #   # # #   # # #   #   #             #   #   # # #   #   #   
# # # # # ### # # ################# # ### ##### # # ####### ### ### ### # # # # # ##### ##### ####### # ####### # # # # ### ### 
#   # # #     # #   #           #   #   # #       #   #     #   #   #   # # # # # #   #     #   #     # #     # # # # #     #   
##### # ####### # ### ##### ### # ##### # # ####### # # ####### # ### ### ### # # # # ##### ### # ####### ### # # # # ####### ##
#   # # # #     #       #   #   # #     # # #     # # #   #   # #   # # # #   # # # # #   #     #         #   # # #   #   #   # 
# ### # # # ######### ### ### ### ##### # # # ##### # ##### # # ### # # # # ### # # # # ######### ######### ### # ##### # # # # 
#     #   #         # #   #     # #   # # # #     # #   #   #     # #   # # #   #   #               #   # #     # #     # # # # 
####### ########### # # ### ### # # # # # ####### # ### # ####### # ### # # # ### ### # # ### ##### ### # ####### # ##### # ### 
#           #     # # # #     #   # #   #   #   #   # # #   #     #   # #   #   # #   # #   #     #     #       #   # #   # #   
# # ####### # ##### # # ##### ##### ####### ### ##### # ### # ####### # ####### # # ### ### ##### # ##### ##### # ### # ### # ##
# #       #   # #   # #   #             # #   #     # #   # #     #   #         # #   #   #     # # #   #     #       # #   #   
######### # ### # ####### ####### ##### # ### ##### # # # # ##### # ### ### ############# # ##### # # # ### ####### ### # ##### 
#     #   # #   #   #   #       #     # # #   #   #     # #   #   # #   #   #         #   #   #   # # # #   #     #   # #       
# ### # ### # ##### # # # ##### ##### # # # ### # ####### ### # ### ##### ##### # ### ####### # ### # # # ### ### # ### ########
#   # # # #   #   #   # #     #     # #   #     # #   #     # #   #       #   # # #       #   #   #   #   #   #   #   #         
### ### # # ### # ##### ####### ### # ########### # # ##### # ### ########### # # ####### # ##### # ####### ######### ### ######
# #     # #     # #   # #     #   # # #     #   #   #   #   #   #       #   # # #   #   # # # #   #   #   #         #   # #     
# ####### # ##### # # # # ### # ### # # ### # # ####### # ########### ### # # # ### # ### # # # ### # # ########### ### # # ### 
#   #     # #     # # #   # # #   # #     #   # #     # # #           #   #   # #   #   # #   #   # #   #       #   #   #     # 
### # ####### ### # ##### # # ### # ########### # ### # # # ######### # ######### ##### # ####### # ##### # ##### ############# 
#   #   #     #   #     #   #   # #   #   #     #   #   # #     #     #       #   #     # #       #     # #       #     #       
# ##### ### ### # ##### ####### ##### # # # ####### ########### ##### ####### # ####### # # ####### ##### ######### ### # ##### 
# #   #     #   #     # #   #   #   # # # #     #   #   #       #         #   # # #   # # #     #   # #   #   #     # #   #     
# ### ########### ### # # # # ### ### # # ##### # ##### # ####### ### ### # ### # # # # # ##### # # # # ### # # ##### ##### # ##
#                 #   #   #   #       # #       #       #       #   #   #       #   #           # #   #     #   #           #   
