################################################################################################################################
################################################################################################################################
     #   #       #                                               #     #   #         #                 #         #     #   #   #
 ##### # # ####### ############################### ######### ##### # ### # # # ### # # ### ##### ### # # ####### # ### # ### ###
 #     # #       # #                         #   # #   #   #   #   #     # # #   # # # # #     #   # # #   #   # #   #         #
 # ##### ####### # ##### # ### ############# # # ### # # # # # # ######### # ### # # # # ##### ### # # ### # # # ### ######### #
       #       # #     # #   # # #   #     #   # #   #   # # # #   #   # # #   # # #       # # #   # #   #   # #   # #         #
 ########### ### ##### ####### # # # # # ####### # # ##### # # ### # # # # ### # ####### # # # # ### # ####### ### ### ####### #
           #     #   #         # # #   #       # # # #   # # # #   # #   #     #   #   # #   # #   # #         # # #   #       #
 ######### ##### # # ########### # ####### ##### # ### # # # # # ### ##### ####### # # ####### ### # ########### # # ### ##### #
     #   #     # # # #       #   # #     #       #     # # # #   #   #   #   #     # #       # # # #         # #   # #   #   # #
#### ### ##### ### # ####### # ### # ################### # ### ### # # # ### # ##### ####### # # # # # ### # # ##### # ### ### #
   #       # # #   # #               #                 # #   #     # # #   # #   # #   #   # # #   # # #   #   #   # # #     # #
 # ####### # # # ##### # ######### ### ######### # ##### ### # ##### # ### # ### # ### ### # # ##### ### ### ##### # # ##### # #
 #         #   #     # # #       # #   #   #     #     #   # #   #   # #   #   # #   #     # # #       # #   #   #   #   #   # #
 ################### # # # ##### # # ### # # ######### ### # ### # # # # ##### # ### # ##### # ####### # # ##### ####### # ### #
 #       # #     #   # # # #   #   #     # # #   #       # # #   # # # #   #   #     # #   # # #   #   # # #   # #       # #   #
 ### ### # # ##### ### # # ### ### ####### ### # ####### # # ### # ### ### # ######### # # # # # # # ### # # # # # ####### # ###
   # #   # #   #   #   # #   #   # #           # #     # # #   # #   #   # # #       # # #   # # # # # # #   # # # #         # #
## # # ### ### # ##### # ### ### # ### ##### ##### ### # # ### # ### ### # ### ##### # # ##### # # # # # ### # # ### ######### #
   # #       # # #     #   #     #     #     #     #   # # #   # # # # # # #       #   #S#     # #   # #   # #   #   #     #   #
 ### ##### ### # # ### ####### ######### ### # ##### ##### # ### # # # # # # ####### ### # ##### ##### # # # ##### ### ### # # #
 # #   #   #   #   #   #     #   #     #   # # #   #       #   #   #   # #   #     # #   # # #   #   # # # #             #   # #
 # ### # ### ####### ### ### ##### ### ### # # ### ########### ######### ##### ### ### ### # # ##### # ### ####### ##### ##### #
 # #   # #             #   # #   # # #     # #   #   #       #         #     #   #     # # #   #   # #   #       # #   # #     #
 # # ### # ########### ### # # # # # ####### ### # ### ############### ##### ### ####### # ##### # # ### ####### ### # # ##### #
 # # #     #     #       # #   #   # #     # # # # #   #   #       #   #   #   # #   # #   #     #     #   #     #   # #   #   #
 # # ####### ### # ##### # ### ##### ##### # # # # # ### # # ####### ### ##### ### # # ##### ### ### # ### # ##### ### # # # ###
 #   #     #   # #     # #   # #   #     # # # # #   #   #   #     #   #   #   #   # #   #   #   #   # # #   #     #   # # # # #
 ##### ### ### # ##### ##### # # # ##### # # # # ### # ######### # ### ### # ### ### ### ### # ### ### # ######### # ##### # # #
 #     # #     #   #   #     # # # #   #       #   #             #   #     #   # #   # # #   #   # #   #   #       #       #   #
 # ##### ######### # ### ##### # # # # ### ####### ##### ########### ##### # ### ##### # # ### ### # ### # # ############### ###
   #   # #   #     #   # #     # #   # #   #     #   #   #                       #   #   # #   #   #     # #   #       #       #
#### # # # # # ####### # ####### ####### # # ### ### # ### ################# ##### # # ### # # # ######### ### # ##### # # ### #
   # # #   #           #     #   #       # # # #   # #   #   #       #     #   #   # #     # # # #     #   # #   # #   # # #   #
 # # # ####### ############# # ##### ##### # # ##### ##### # # ##### # ### ### # ### ####### ### ##### # ### ##### # ### # # ###
 # # # #       #   #       # #       #   # # #       #   # # #     #   #       # # #     #   #   #       #       #   #   # # # #
 # # ### ####### # # ##### ########### # # # ### ##### # ### ################# # # ##### # ### ### ##### # ##### ##### # ### # #
 # # #   #   #   #   #   #   #     #   #   #   #   #   #     #           #     # # # #   #   #   # #   #   #           # #   # #
 # # # # # # # ####### # ### # ### ####### ### ### ### ####### ######### # # ### # # # ######### # # # ##### ##### # ### # ### #
 #     # # #   #   #   #   # # #   #     #   #     #   #   #   #         # # #   #   # #   #   # # # #     # #     # #   # #   #
########## ##### # ### ### # # # ### ### # # ####### ### # # ### ########### # ##### # ### # # # # # ##### ### ##### ##### # ###
         # #     # #   #       #     # #   #       # #   # #   #       #     # #   # #     # #   # # #   #   # #   #     # #   #
 ####### # ####### # ################# # ##### ### # # ### ########### ### ### # # # ############### # ##### ### # ##### # ### #
 #   #   #     #   #   #       #       # #     #     # # #     #     # #   #     #         #   #   # #     # #   # # #   #   # #
 # # # ####### # ##### # ##### ####### # # ########### # ##### # ### # # ### ########### ### # # # # # ##### # ### # # ### # # #
 # #   #   #   #       #     # #     # # # #         # # #   #   # #   # #     #   #   # #   #   # # #     # # # # #   #   # # #
 # ##### ### # ############### # ### # # # # ####### # # ### ##### ##### # ##### # # # ### ####### # # ### # # # # ### # ##### #
 #       #   # #     #         # #   # # #   #       # #       #     #   # # #   #   # #   # #   #   #   # #   # #   # #   #   #
 ######### ### # ### # ######### # ### # ##### ##### # ##### # # ### ### # # # ######### ### # # ##### ### ##### ### ### # # ###
     #   # #   #   #   #         #   #   #   #     # #       # #   #   #         # #   #   #   #   #     # #     # #   # # # # #
#### # # # ### ### ##### ########### ##### # ### # ########### ####### ######### # # # ### # ##### # ### # ##### # ### ### # # #
   #   #   #     #       # #   # #   #   # #   # #           #       # #   #       # #     # #   #   # # #     # # #   #   # # #
 ########### # # ######### # # # # ### # ##### ##### # ############# # # # # # ##### ####### # # ##### # ### ### # # ### # # # #
 #   #   #   # #         #   #   # #   #     # #     # #   #   #   # #   #   # #     #   #   # #       #   #       # #   # #   #
 # ### # # # ### ####### ####### # # ####### # # ####### # # # # ### ######### # ##### # # ### # # ####### ######### # # ##### #
 # #   #   #   #       #   #   # # #       #   #   #     # # # #           #   # #     #       # # #     #     #     # #     # #
 # # ##### ### ### ####### # # # # ####### ######### ##### # # ########### # ### # # ####### ### # # ### ##### # ##### ##### # #
 #   #       #   #   #   # # # # # #                 #   #   #     #     #         #       #   # #     #   #   # #   #   #   # #
 ##### ######### # # # # # # # # # ################### # ######### # ### # ############# # # # # ######### # ### # ### # # # # #
       #         # #   # #   #   #         #           # #       # # #             #   # # # # #   #     # #   # #   # # # # # #
 ##### # ######### ##### ################# # ######### # # # # # # # # ########### # # ### ### ### # ### ### # # ### # # # ### #
 #   # # # #       #             #         # # #     # # # # # # #   # # #     #   # # #   #     # # # #   # # #   #   # #   # #
 # # ### # # ##### # ##### # ##### ######### # # ### # # ### # # ##### # # ### # ##### # ### ##### # # ### ### ### # ####### # #
 # # #   #   #   # # #     #   #   #         #   # # # #   # # #   #   # # # # # #     #   #     # #   # #   #   # # #     #   #
## # # ### ### # ### ########### ### # ##### ##### # ##### # # ### # ### # # # # # ##### # ##### # ##### ### # # # ### ### #####
   #   #   #   # #   #         #     #     #       # #     # #   # # #   # #   #   #     # #   # # #     #   # # #   # # #     #
 ######### # ##### ### ####### ### ####### # ### ### # ########### # # ### # ####### ### # # # # # # # ### ### # ### # # ##### #
 #     #   #       #   #   #   #   #   #   #   #   # # #         # # # #   # # #   # #   #   # # # # # #   #   #   #   #   # # #
 # ### # ######### # ### ### ### ### # ####### ### # # # ####### # # # # ### # # # # # # ##### ### # # # ### ############# # # #
 #   #   #   #     #     #   #       #   #   # #   #   #     #   # #   #   # #   #   # # #   # #   # # # #       #       # # # #
 ######### # ##### ####### ### ######### # # # # # ######### # ### # ####### ######### # # # # # ##### # ### ### # ##### # # # #
           #     # #   #   #   #     #   # #   # #   #       #   # # #   #   #     # # # # #   #       #   # #   # #   # #   # #
###### ######### # # ### ### # # ### ####### ### # # # ######### # # # # # ### ### # # # # ##### ######### ### ### # # # # ### #
     # #         # #   # # # # # # #       # #   # # # #   # #   #   # #   # # #   #   # #     # # #       #   #     # #   #   #
 ### ### ######### ### # # # # # # ####### # # ### # # ### # # ##### # ##### # # ############# # # # ####### ### ########### # #
   #     # #     #   #       # # #   #     # # #   # #G#     #     #         # #   #       # # #   #   #           #   #     # #
 # # ##### # ### ####### ##### # ### # ####### # ### # # ### ##### ######### # ### # ##### # # ####### # ########### # # ##### #
 # # #     # # #   #     #   # # # # # #   #   #   #   #   #     # #     # # #   # # #     #   #       # # #     #   #   # #   #
 # ### ##### # ### # ### # # ### # # # # ### ##### # ### # ####### # ### # # ### ### # ####### # ####### # # ### # ####### # ###
 #   # #   #   # # # #   # # #   # # # #     #     #     #       # # #   #           # #       #   #     # #   #   #       #   #
 ### # # # ##### # # # ### # # ### # # ######################### # ### ##### # ##### # # # ####### ##### # ### ####### ##### # #
   #   # # #         #   # #   #   # #   #               #   #   #     #     # #   # # # #   #     #     # # #       #     # # #
 # ##### # # ########### # ##### ### # # # ############# # ### # ############### # # # ####### ##### ##### # ####### ##### ### #
 #   #   # # #   #       #   #   #   # # #     #   #   # # #   #     #         # # # #       #   #         #       # #   #     #
 ##### ### # # # # ######### ### # ##### ##### # # # ### # # ####### # ####### ### # ####### ### # # ############# # ### ##### #
 #     #   # # #   #   #   # #   #     # #     # #   #   #   #     # # #     #     #       #   # # #   #           # #         #
## ##### ##### ### # # # # # # ####### # # ####### ### ### ### ### # # # ################# ##### # # # ### ######### # ####### #
   #   #     #   #   #   # # #       # # #   #   # #   #   #   #   #   #                   #   # # # # #   #   #     # #       #
 ### ####### ####### ##### # ####### # # ### ### # # ##### # ### ### ### ### ######### ##### # # # ### # ### # # ##### # ##### #
   #           #   #   # # #       # #   # #     # # #     # #   #     #   #   #     # #     #   #   #     # #   #     # #     #
 # ##### ##### # # ### # # ####### # ##### ####### # ####### # ##### ### # ##### ### # # ########### ####### ####### # # ##### #
 #   #   #   #   # #   #     #     # #   #     #   #   #     #     #     #     #   # # #   #   #   # #       #     # # # #   # #
 ### ### # # ##### ### ####### ##### # # ##### ### ### # ######### # ######### ### # ##### # ### # # # ####### # # ### # # # # #
   #   # # #   #     # #       #   # # #   #   #     #   # #       #     #   #   # #     # #     #   #   #   # # #     # # # # #
###### # # ### ##### # # ####### # # ### ### ### ######### # ########### # # # # # ##### # ############# # # ### ####### # ### #
       # # # #   #     #     #   # #   #   # #             # #           # #   # #   # # #       #   #   # #   # #     # #     #
 ######### # ### ##### ##### ### # ### # # # # ######### # # ######### ### # ####### # # ####### # # ##### ### # ##### # #######
   #           #     #           #       #     #   #   # # #     #   # #   # #     # # # #   #   # #   #   #   #     # #       #
 # # ########### ### ################# ######### # # # # ####### # # ### ##### ### # # # # # # ### ### # ### ##### ### ####### #
 #   #     #   #   #   #           #   #     #   # # # #       #   #   # #   #   # # # # # # # # #   # #   # #   # #   #     # #
 ##### ### # # ##### # # ######### # # # ### # ### # # ### ########### # # # ### # # # # # # # # ##### # ### ### # # ### ##### #
     # # #   # #   # # # #         # #   #   # # #   #   # # #     # # #   #     #     #   # #   #     # #   #   #       #     #
#### # # ##### # # ### # # ############# ##### # ####### # # # ### # # ################### # # ### ##### # # # ########### #####
   # # # #   # # #   # # #             # #   #       #   #   #   # # #                   # #   #         # # # #   #   #   #   #
 ### # # # ### # ### # # ############# # # # # ####### # ######### # ################### # ##### # # # # # # # # # # # # # # # #
     # # #   #   #   # #       #   #   # # #   #   #   # #   #     #   #         #     # # #     # # # # # # # # # # # # # # # #
#### # # # # ##### ### ####### ### # ### # ##### # # # ### # # ##### # # ####### # ### # ### ##### ### # # ### # # # ### ### # #
     #   # #     #     #     #     #   # #   # # #   # #   #   #     # # #     #   #   #     #   #   # # #   # # # #   # #   # #
 ### ##### # ########### ### ######### # ### # # ####### ############# # # ### ##### ######### # ### # # ### # # # ### # # ### #
   #       #           #   # #       #         # #       #   #     #   # #   # #     #     # # #   # # #   #   # # #   # #   # #
 # ### ### ####### # ### # ### ##### ### ##### ### ####### # ##### # ### ##### # ##### ### # # ##### # ### ##### # ### # ### # #
 #   #   # #   #   # #   # #   #   # #   #   #   # #     # #           # #   # #     # #   # # #     #   #     # #   # #   # # #
 ### ### ### # # ##### ##### ### # # ##### # # # # # ### # # ######### # # # # ####### # ### # # ####### ### ### ### # ### # ###
   # #   #   # #     #   #   #   #         # # # # #   # # # #   #   # # # #   #       #       # #     #   # #   #   #   # #   #
## # ##### ### # ### ### # ####### ######### # ### ### # ### # # # # # # ##### # # ######### ### # ### ### # # ### ##### # ### #
   #       #   #   #   # #       # #   #     #         #   # # # # #   # #     # #   #   #   #   # # # # # #   # # #   #   #   #
 ########### ##### ### # ####### ### # ### ####### ####### # # # ####### # ##### ### # ### ### ### # # # # # ### # # # ### # ###
     #     #   #   # # # # #   #     #   #   #     #   #   # # # #     # # #     #   #     # #   # #   #   #     # # # #   #   #
 # ### ### ### # ### # # # # ########### ### ####### # # ### # ### ### # # # ##### ### ##### ### ### ####### ### # # # ####### #
 # #   # # # # #     #   # # #   #   #   # #       # # #     #   #   # # #   #     #   #       #     #       #   #   #     #   #
 # # ### # # # # ######### # # # # # # ### ####### # # ##### ### ### # # ##### ##### ######### ########### # # ########### # ###
 #   #   #   # #       #   # # #   #   # #   #   #   # #   #   #     # # #   #   # # #     #   #       #   # #       # #   #   #
 ##### ####### ####### # ### # ######### # ### ####### # # # ######### # # # ### # # # ### ### # ##### # ### ####### # # ##### #
 #       #   # #     # #   # # #   #     #   #   #   #   # # #         # # #   # # # # #   #   # #     # #   # #     # # #   # #
 # ### # ### # # ### # ### # # # # # ####### ### # ####### # # ######### # ### # # # # # ### # # ####### # ### # ##### # # # # #
   #   #     #   #   #     #   # #                                         #     #     #     #           #     #       #   #   #
################################################################################################################################
