################################################################################################################################
#         #         #     #     #         #       #         #   #     #             #     #       #                       #     
# ####### ####### # ##### ### ### # ### ### # ##### ######### # # ### ### # # ##### # ### ####### ### # ##### ##### ### # # ### 
# #     # #       #   # #   #   # #   #     #       #   #   # # #   #     # #     #   # #       #   # #   # #     # #   #   #   
# ##### # # # ####### # ### ### # ### # ############# ### # # # ### ### ######### ##### ####### ### # ### # ##### # # ####### ##
#     #   # # #                 # # # # #             #   #   # #   #   #     #   #   #   #   # # # #   # #   #   # #     # #   
##### ##### # # ##### ########### # # # # ############# ####### # ####### ### # ### ### # # # # # # ### # ### # ######### # ### 
#   #       # #     #     #         # #   # #       # # # #     # #         # #   #     # # #   # #   # #     #         # #   # 
# # ######### ####### ### # ######### # ### # # # # # # # # ##### # ######### ### ####### # ##### ### ####### ########### # ### 
# # #   #   #   #   # #   # #   #     #       # # #   #   #     # #     #   #   #   #   # #   #     #       #       #     #   # 
# ### # # # ##### # # # ### # ### ##### ### ### # ############# # # ##### # ####### ### # ### # ### ####### ######### ##### # # 
#   # #   #       # # # #   #     #     # # #   # #   #     # # #   #     #     #   #   # #   # #   #     #           #   # #   
### # ############# # ### ######### # ### # ####### # # # # # # # ### ######### # ### ### # ##### # # ################# # # ####
# # # # #     #     #   # # #   #   #     # #       # # # # # # #   # #     # # #   #     #     # #       #   # #   #   #     # 
# # # # # ### # ##### # # # # # ### ####### # ####### # # # # # ##### # ### # # ### # ### ##### ######### # # # # # # ####### # 
# # # # #   # #   #   #   # # #   #       #   #   #   # # #   # #     # #   # #     #   # #   #     #   #   # # # #   #     #   
# # # # ### # ### # ####### # ### ####### ##### # ##### # ### # # ##### # ### ####### # ### # ##### # # ##### # # ##### ### ####
# #   #     #     #         #   #       #     # # #     #   # # #       # #           #     # # #   # #     #   #   #   # #     
# ##### ################### ### ####### ####### # # ####### ### ### ##### ########### ####### # # ### ##### ### ### # ### ##### 
#     # #       #                 #   #         #     #   #   #   # #   #         #       #   # # #   # #           #   #     # 
##### # # ##### # ######### ####### # ### ############# # ### ### ### # # ####### # # ##### ### # ##### # ######### ### # ##### 
#     # # # #   # #       #   #     #   #           #   # # #   #     # # #     # # #     # #   #     # #   #     #   #   #   # 
# ##### # # # ##### ##### ### # ####### ############# ### # ### ####### # # ### # ### ### # # ####### # ### # ### # ### ### # # 
# #   #   # #     #   #     # #   #   #       #   #   #   #         #   #   #   #   #   # #     # #   #   # # # # #   # #   #   
# # ####### ##### # # ##### # ### ### ####### # # # ### ########### # ######### ### # # # ##### # # ##### # # # # # # # # ##### 
# #         #   # # #   # # # # #     #     #   # #   #       #     #         # #   # # #   #   # # #       # #     #   # #   # 
# # # ### ### # # ##### # # # # ##### # ### ##### ### ####### # ############# ### ### # ### # ### # ######### # ######### # # # 
# # # # #   # # # #   # #   #     # #   # # #   #   # #       #             #     # # # #   #     #           #   #     # # #   
# # # # ### # # # # # # # ####### # ##### # # ####### # ####### ########### ####### # # ####### ################# # ### # ##### 
#   # #     # #   # # # #       #       # # #     #   # #   #   #   #     # #   #   # #       # #     #   #       #   # #   #   
# ### ####### ##### # # ####### ####### # # # ##### ### ### # # # # # ### # ### # ### ####### # # ### ### # ##### # # # ### ### 
#   # #     #   #   #   #     #       #   # # #   #   #     # # # # # #     #   #       #   # #   # # #   #     #   # #   #   # 
# # ### ### ### # ####### ########### # ### # # # ### ####### # ### # ####### ######### # # # # ### # # ####### ######### # # ##
# #   # # #   # # #             #     # #   #   #   #   #     # #   #       #       # # # # # #     #     #     # #     # # #   
# ### # # ### # # ######### ### # ##### # ##### # ##### # ##### # ######### ####### # # ### # ############# ##### # ##### # ### 
# #   #     #   #         # #   #   # # # #   # #     # #     # #         # #     # #       # #       #   # #   # #     # # #   
# ### ##### ############# # ####### # # # # # # ####### # ### # ######### # # # # # ####### # # ##### # # # # # # ##### # ### # 
#   #     # #       # #   #       # #     # #   #       #   # #     #   # #   # # #         #   #   #   # #   #   #   #   #   # 
# # ##### # # ##### # # ### ##### # ### ##### ### ######### # # ##### # # ##### ####### ##### ### # ##### ######### # ##### ### 
# #     # # # #   # # # #   #   # #   #     #   # #         # #       # #   # #   #   # #   #     # #   # #   #   # #     #   # 
# ##### ### # # # # # # # ##### # ### ##### # # # ####### ### ######### ### # ### # # # # # ####### # ### # ### # ##### # ### # 
#     #       # #   #   #   #   #   # #   # # # #       # #   #       #     #   # # #   # #       # #   # #     #   #   #   # # 
# ### ####### # ########### # ### ### # ### # ######### # # ### # ########### # # # ##### ####### ##### # ######### # ##### # # 
#   #       # #                 #     # #   #   #       # #     # #   # #     # #   #   #   #     #  S#     #     #   #   #   # 
# ######### # ################# ####### # ### # # ####### ####### # # # # ##### ##### # ### # ##### # # ##### ### ####### ##### 
#   #       #   #   #         #           #   # # #           #   # # # #   #   #     #   # # #     # # #   #   # #     #     # 
# # ######### # ### # ####### ### # # ##### ##### # ### # ### # ##### # ### ##### ####### # # # ##### # # # ### # # ### # ### # 
# # #   #   # #     #   #     # # # #       #     # #   #   # #       #   #   # #   #   # # #   # #   # # # #   #   #   # #     
# ### # ### # # ##### ### ##### # # ### ##### ####### ##### ########### ##### # # ### # # # ##### # ### # # # ####### ### ##### 
#     #   #   # #   # #   #   # # # #   #   # #     # #   #     #     # #     # # #   #   #   #   # #   # #   #       #     # # 
# ####### ####### # # # ### ### # # ##### # # # ### # # # ##### # # # # # ##### # # ######### # ### ##### ##### ########### # # 
#   #   # #     # #   # #     # # # #     # #   # # #   # #   #   # #   # #       #   #       # # #       #   #     #     # #   
# ### # ### ### # ##### ##### # # # # ##### ##### # # ### # # ##### # ### # ########### ####### # ######### ####### # # # # ### 
#     # #   # #   #   #   # # #   #   #   # #     # # #   # #   #   #   # #     #   #   #     # #     #   #       # # # # # # # 
# ##### # ### ##### ##### # # ##### ### ### # ### # ### ### ### # ####### ##### ### # ### # ### # ##### # ##### ### # # # # # # 
# #   #   #       #   #   #           # #   #   # #   #       # # #       #     #   #   # # #   #     # #     # #   # # #   # # 
# ### ##### ######### # ### # ##### # # # # ##### ### ######### # # ####### ##### ##### # # # ####### # ##### # # ##### ##### # 
#   #   #       #     # #   # # #   #   # # #     #   #       # #   #             #     # # # #     # # #   #   # #     #   #   
### # # ####### # ##### # ### # # ####### ### ##### ### ##### # ####### ########### ####### # # ##### # ### ##### # ####### ### 
#   # # #       # #     #   #   # #     #   # #   #     #   # #         #           # #     # #       #   #     #   # #         
# ### # # ##### # # ####### ##### # ### # # # # # ######### # # # ####### ########### # ##### ### ####### # ######### # ####### 
#     # # #     # #   #   #   # # #   # # #   # #           # # # #       #           #   # #   #         # #       # #     #   
####### ### ### # ##### # ### # # ### # ### ### ####### # ### ### # ####### ####### ##### # ### ### ####### # ### # # ##### # ##
# #     #   #   # #     #   # # #   # #   # # # #     # # #   #   #   #     # #   # #   # #   #   #         # # # #     #   #   
# # ##### ### ### # ####### # # ### # ### # # # # ### # ### ### ##### # # ### # # # # ### ### ### # ##### # # # # ####### ##### 
# # #   #   # #   # #     # #     # # #   #   #   # # #     # # #     # # # #   #   #   #   # # #   #   # #     # #       #     
# # # # ### # # ### ##### # ### ### # # ##### ##### # ####### # # ####### # # ######### ### # # # ### # ######### # ####### # ##
#   # # #   # #   #     #     # #   # # #   #     # #   #     # # #       #           #   # #   # #   #         # #     #   #   
# ### # ##### ### ##### ##### ### ### # # # ##### # ### # ##### # # ########### ######### # # ### # ########### ####### ####### 
#     # #       # #   #     #   # #   #   # #     # #   #   #   # #   #       #               #   # #   #     #   #     #     # 
####### # ####### # ####### ### # # ####### # ##### # ##### # ### ### # ##### ########### ##### ### # # ### ##### # ##### ### # 
#   # # #   #     #   #   # # # # # #     # #       #   # #   #   #   # #                 #     #   # #   #     #   #   # # # # 
# # # # # # # ##### # # # # # # # # ### ### ##### ##### # # ### ### # # # ####### ####### # ##### # # ### ##### ##### # # # # # 
# #   # # #       # # # #   #   # #   #   #     # #   # #   #   # # # # # #     # #     # #  G# # # #   # #   #   # # # # #   # 
# ##### # ####### # ### ##### ### ### ### ##### ### # # # ### ### # # # # # ### # # ### # ### # # ##### # # ##### # # # # ##### 
# #     #       #   #   #   #   #   #         #   # #   # #   # #   # # # # # # # # # # # # # # #   #   # #     # #   # # #     
# # ####### ### ##### ##### ### ### ######### ### # ##### # ### ##### # # # # # # # # # # # # # ### ##### # ### # ##### # # ### 
#   #     # #   #   #     # # # #   #         #   # #     # #   #   # # # #   # # #   # #   # #   #       #   #   #   # #   #   
# ####### # ##### # ##### # # # ##### ######### ### ####### # ### ### # # ##### # ##### ### # ### ######### # # ### # # ####### 
#   #   #   #     #     #   # # #   #     #   #   #   #     #         # # #   # #     #     #         #   # # #     #   #   #   
### # # ### # ######### ##### # # # ##### # # ### ### # ####### ####### # # # # ######### ########### # ### # ##### ##### ### # 
# # # # #   # #     # #       #   # #   #   #   #   # # # #     #     # #   # # #     #   #     #       #   #     # #   #     # 
# # # # # ### # ### # # ########### # ######### ### # # # # ### # ### # ##### # # ### # ### ##### ##### # ####### # # # ####### 
#     # #   # #   #   # #           # #   #   #   #   # #   #   # #   # #     #   #   # # # #   # #   #       #   # # #   #   # 
####### # ### # # ### # # ########### # ### ##### ##### ######### ##### # ### ##### ### # # # # # # # ####### # ##### ### # # # 
#         #   # #   # #   #                           # #   #   #       # #       #   #   # # # # # #     #   # #   #   # # #   
# ##### ### ### ##### ##### ########### # ####### ### # # # # # ######### # # ### ### # ### # # # # ##### ##### # # ### # # ### 
# #   # #   #     #       #   #         #   #   # #   #   # # # #         # # #     # # #   # #   #     # #   # # #   # # # #   
# ### # # ### ##### ##### ### # ############# # # # ####### # # ############# # ##### # # ### ######### # # # ### # # # ### # # 
#     # # #   #   # #   # #   #   #           # # # #     #   #   #   #       #     # # #   # #         #   #     # # #     # # 
# ##### # ##### # # ### # # ##### # ########### # ### # ######### # # # ########### # # ### # # ################### # ####### # 
# #     #   #   #   #   # #   #   #   #   # #         #       #   # #   #     #   # # #   # # #     #   #   #       # #     # # 
# # ### ### # ####### ### ### # ##### # # # # ####### ####### # ########### # # ### # ### # # ##### # ### # # ######### ### ### 
# # # #   #   # #     #   #   # #   #   #   # # #   #   #   # #     #   #   # #     #   #                 # # # #   #   #   #   
### # ### ##### # # ### ##### # # # ######### # # # ##### # ####### # ### ### ##### ### ######### ######### # # # # # ### ### # 
#   # #   #   # # #   # #   # # # #         #     # #     #   #     #     #         # #   #     # #     #   # #   # # #   #   # 
# ### # ##### # # ### # # # # # # ######### ##### ### ####### # ############# ### # # ### # ### # # ### ### # ##### # # ### # ##
#   # #   #       #   #   # # # #     #   #     #   # #   #   #         #   #   # #   #   # #   #   # #   # #       # #   # #   
### # ### # # ############# ### ##### ### ##### ### # # # # ########### # # ##### ### # ### # ### ### ### ######### # ### ##### 
# #   # #   # #         # # #       #   #   #   #   # # #   #     # #   # #     #   # #     # #   #     #         # # # #   #   
# ##### ##### # ####### # # # ### # ### ### # ##### # # ##### ### # # ### ##### # # ######### # ##### # ######### # # # ### # ##
# # #       # #       #   # #   # # # #   # #       # #   # #   #   #   #   #   # # #         # #     # #         # #   #   #   
# # # ####### ####### ### # ### ### # ### # ####### # ### # ### ####### ### ####### # ######### # ##### ################# ##### 
# #         # #     # # # #     #   # # # # #       # #   #   # #       # # #       #   #     #   # #   #   #   #       # #     
# ######### # ##### # # # ####### ### # # # # ##### # # ##### # # ####### # # ######### # ### ##### # ### # # # # ##### # # ### 
#     #   # # #     #   #           #   #   #   #   # #       # #       #     #   #     #   #       #     #   # # #   # #   #   
##### # # # # # ### ####### # ##### ### ######### ### ######### ####### ####### # # ############### ########### # # # ######### 
#   # # #   #   # #   #     #     #     #       #         #   # # #   #         #   #     #     #       #   #   #   #           
# ### ##### ##### ### ### # ##### ####### ##### ######### # # # # # ################# ### # ### # ##### # ### ######### # ######
#             #     #   # #     #       #   # #   #     # # #   # #     # #         #   #   #   # #     # #   #         # #     
# ########### ##### ### # ##### # # ### ### # ### # ### # # ##### ##### # # # # ### ######### ##### ##### # ### ### ##### # ### 
# #       # # #     # #   #     # #   #   # #   #   #   #           #   #   # #   #     #   # #   #       # #     #     # # #   
# # ##### # # # ### # ### # ### # ##### # # ### ##### ############# # ########### ##### # # # # # # ####### ########### # # # ##
# #   # # # #   # #   #   # #   #   #   # #   #     # #   #         # #       #   # #   # # #   #   #     # #   #     # #   #   
# ### # # # ##### ### # # # # # ### # ####### # ##### # # # ####### # ### ### # ### # ##### # ####### ### # # # # ### # ####### 
#   # #   # #         # # # # # #   #   #       #   # # # #   #     # #   # # #   #   #       #   #   # #   # # # # #   #   #   
### # ##### # ####### # # # # ### ##### # ####### # # # # ### # ### # # ### # ##### ##### ##### # # ### ##### # # # ### # ### # 
#   #   # # #   #   #   # # # #   #     # #   #   #   # #     #   # #   #   #     # #     #   # # #     #     #   #     #   # # 
# ##### # # ### # # ####### # # ##### ### ### # ####### # ######### ####### ##### # ### # # # # # ##### # ########### # ### # # 
# #     # #   # # #   #     # #   #   # #   # # #     # # #           #   #     # # #   # # # # #   #   # #   #   #   # # # # # 
### ##### ### # # ### # # ####### # ### ### # # # ### # # # ######### # # ##### # # # ### # # # # ### ### # # # ### # # # # # # 
#   # #     #   #   #   # #       #     #   #   #   #   # # #     # #   #       # #   #   # #   # #   #   # # #   # # #   # # # 
# ### # ##### ##### ##### # ##### ####### ############### # ### # # ########### # ####### # ##### # ### ### ##### # # ##### # ##
#   # # #     #     #   # # #     #     # #           #   #   # #         #   # #       # #     #   #     # #     # #   #   #   
### # # # ##### ##### # ### # ##### ### # ##### # ### ### ### # ######### # # # ####### # ##### ##### ### # # ##### # # # ##### 
# # #     #   #     # #     # #   #   # #   #   #   #   # #   #   #     #   # #   #   # #     #     # #   # #     # # # #       
# # ####### # ##### # ######### # ##### ### ####### ### ### ##### # ### ##### ### # ### ##### ##### ### ### ##### # # # ########
#           #       #           #         #         #       #     #   #                                 #           # #         
