################################################################################################################################
                         #     #     #             #   #     #                 #           #       #         # #   #   #       #
 ### # ### ### ##### ### # # ### # # # # # ### ### # # # ### ####### ######### # # ### # # # ### # ####### # # # # ### # ##### #
 #   # #   #   #   # #   # #     # # # # # # # #   # # #   # #       #   #   # # #   # # #   #   #       # # #   #   #   #   # #
 # ### # ####### # # # ### ####### ### # # # # # ### # ### ### ######### ### # # ### # # ##### # ####### # # ####### ##### # # #
 #   # #   #   # #   # # # # #     #   # #   # #     #   # #   #       #     #   # # # #   #   # #     #   #   #           # # #
#### ##### # # # ##### # # # # ### # ### ##### ######### # # ### ### # ##### ### # # # ### # ##### ########### ##### ### ##### #
   #     #   # #     # # # #   #   # #   #   # #     #   # #   # #   #     #       # #   # #       #   #       #   #   #       #
 # ### ############# # # # ######### # ### # # # ### ##### ### # # ####### # # ##### ##### ######### # ### ##### # # # #########
 # #   #     #       #   #     #     #     # # # #   #     #   # # # #   # # #   #   #   # #     # # #   #   #   #   #         #
## # # # ### # ######### ##### # ########### ### # ### ##### ### # # # # # # ### # # # # # # ### # # ### ### # ##### ####### # #
   # # # #   #       #   #   # #   #       #     #   #   #   #   # #   # # # #   # # # # # #   #   # #   # # #   #   #     # # #
 ### ### # ##### ### # ##### # ### # ############### ### ### # ### ### # # ### # # # # ### ### ##### # ### # ##### ### ### ### #
     #   # #   # #   # #   # #   # # #   #     #   #   #     #   #   # # #     # # # #   #     #   # #   # #     # #   #   #   #
###### ### # # ### ### # # # ### # # # # # ### # # # ########### ### # ######### # ##### ####### # # ### # ##### # # ### ### # #
       # # # #     #   # #   #   # # # # #   #   #   #   #     #   # #   #   #   #         #     # # #   #   #   # #   # #   # #
 ####### # ######### ### ### # ### # # # ### ######### # # ##### # # ### # # # # ######### # ####### # ### ### ### ### # # #####
 # #   # #   #           #       # #   # #   #   #     # #     # # #   #   # # #   # #   #   #       #   # #   #     # # # #   #
 # # # # ### ##### # ########### # ##### # ### # # ##### ##### # # ### # ##### # # # # # ### # ######### # # ### # ### # # # # #
 #   # # #   #     # #         # # # #   #   # # #   # # #   # # #   # #     # # #   # #   # #     #   # #   #   # #   # #   # #
 ##### # # ### ##### # ####### # # # # ####### # ### # # # # # # ### # ##### # ##### # ### ####### # # # ### # ### # ### ##### #
   #   # # #   #     # #     #   # #     # #   #     # #   # #   #   #     # #     # # #   #     #   # #   #   #   #   # #   # #
## # ### # ######### # ##### ### # ##### # # ######### ######### ######### # ##### # # # ### ### ##### ### # ##### ##### # # # #
   #   # # #     #   #     # #   #     #   #     # #             #         #       # # #   # #   #     # #   #   # #   #   # # #
 ##### # # # ### # ####### # # ####### ### ##### # # ##### # ##### ### ############# # ### # # ### ##### ### # # ### # ##### # #
 #     # #   # # # # #   # #     #   #     # #   # # #     #     # #   #     #     # # #   # #     #   #   # # #   # #       # #
 # ##### ##### # # # # # # ##### # # ##### # # ### # # ### ####### # # # ### # ### # # ##### ####### # ### # # ### # ###########
   #         # # #   # # #   # #   #         # #     # #   # #   # # # #   # #   # # #   #   #       #       # #   #   #       #
###### ##### # # ##### # ### # ### ######### # ####### # # # # # # ### ### ##### # ##### # ### # ########### # ####### ### ### #
 #     #   # # #   #   #     #     #       # #         # #   # # #   #   # #   # #     #   #   # #   #       #       #     #   #
 # ##### ### # ### # ############# # ##### # ########### ##### # ### ### # # ### ##### ##### # ### ### ##### ####### ####### ###
   #         # # # #   #           #     # #   #             # #     #   # #   # #     #   # #     #   #   # #             #   #
#### ######### # # ### ##### ##### ####### # # # # ##### ### # ####### ### ### # ##### # # # ####### ##### # # # ######### ### #
   #     #   #   #   # #   #   # #     #   # #   #   #   #   # #   #     #   # # #   # # #         # #     # # #   #   #       #
 # ##### ### ### ### # # # ### # # ### # ### ######### ### # # ### ### ##### # # # # # ##### ####### # ##### # ##### # ##### ###
 # #     #   #   # #   # #   # #   # # #   # #     #   # # # #   #     #   # # #   # #   # # #       #   #     #   # #     #   #
 # # ##### ### ### ##### ### # ##### # ### # # ### # ### # # ### ##### # # # # # ### ### # # # ######### # ##### # # ##### ### #
 #         #   #   #   #   # #     #     #   #   #   # #   # #   #     # #   # # #   # # #   # #           #   # # # #     #   #
 ##### # ### ### ### ####### ##### ### ######### ##### ### ### ### ### # ##### ### ### # ##### # ########### # ### # # ####### #
 #   # #   #   # # #     #   #   #   # #       # #   #     #   #   #   # #   # #   #   #       # #   #   #   #   #   #   #   # #
 # # ##### ### # # ##### # ### # # # ### # ##### # # # # ### ########### ### # # ### ########### # # # # # ##### ####### # # # #
 # # #   # #   #         #     # # #     # #     # # # #   #           #   # #   #   #     # #   # # # #   #   # #   #     #   #
 # # # # # # ### ############### # ####### # ##### # # ### ########### ### # ##### ### ### # # ### # # ##### # # # # ######### #
   # # # # #   # #   #         # # #       # #     # #   #           #     #       #   #   #   #   #   #   # # #   #     #     #
 ##### # # ### # # # # # # ##### ### ##### # # ##### ####### ##### ######### ##### # ########### ####### # # # ######### ### ###
   #   # # #   # # #   # # #   #   #     # #       #   #   #     # #       # #     #       #   #   #     #   # #   #   #   #   #
## # ### # # ### # ##### ### # ### # ### # ########### # # ##### ### ### # ### ########### # # ##### ######### # # # # ### ### #
   # #   #       #     #   # #   # # #   #   #   #     # # #   #     #   #     # #       #   #       #       #   # # #   #     #
 ### # ############### ### # ### # ### ##### # # # ##### # # # ####### ##### ### # ##### ################# ####### # ######### #
 #   # #               #   #   # #   # #   # # #   #     #   #       #     # #   #   # #                   #   #   #         # #
 # ### # ############### ##### # ### # # # # # ##### ############### ##### # # # ### # ##### # ### ######### # # ########### # #
 # #   #   #   #       # #     #   #   # #   #   # # #     #       #       #   #           # #   # #       # #   #             #
 # ####### # # # ##### ### ####### ##### ####### # # # ### # ##### # ####################### # # ### ##### # ##### ########### #
   #   #   # # # # #   #   #   # # #     #     # # # #   #     #   # #       #   #         # # #     #   # #     # #           #
 ### # # ### # # # # ### ##### # # # # # # ##### # # ### ####### ##### ##### ### # ####### # ### ####### # ##### ### ######### #
     #   #   # # # # # #       # #   # #   # #   #   #   # #     # #   #     #   # # #   # #   # #     #   #   #     #   #     #
#### ####### # # # # # ######### ##### ##### # ####### ### # ##### # ######### ### # # # # # # # # ### ##### # ####### # # #####
   #         #   # # #   #   #   #         # #   #       # # #     #       #       #   # # # # # #   #       #       # #       #
 # ##### ######### # # # # # ### # ####### # ### # ####### # # ########### ######### ### # ### ##### ############### ######### #
 # #     #   # #   #   #   #     #       #   # #   #   #   # #     #     #       #   #   #   #     #           #   #     #     #
 # # # ### # # # # ############# ####### # ### ##### # # ### # ##### # ######### ##### # ### ##### ########### ### ##### # ### #
 # # #   # # #   #     #     #   #       # #   # #   # #     # #     #           #     #   #         #   #   #         # # # # #
 # ####### # ####### ### ### # ### ####### # ### # ########### # ################# ####### ####### # # # # # ######### # # # # #
 #         #       #     #   #   # #         #   #     #       #         #       #   #   #         #   #   # #   #     # #   # #
 ################# # ##### ##### # # # ####### ####### # ##### ######### ### ### ### # # ################### # ### ##### ##### #
 #   #               #   #       # # #         #       # #   # # #     # #   # # #   # # #     #         #   #   # #     #     #
 ### # ############### # ### ##### # ####### ### ####### ### # # # ### # # ### # ##### # # ### # ####### # ##### # ####### #####
     # #   #   #       #   # #     # #       #   #   #   #   # # #   # # #   # #   #   # # # #   #     # # #     # #   # #     #
###### # ### # # ######### ### ##### # ### ### ##### # ### ### # ### ### ### # ### # ### # # ##### ##### # # ##### # # # ##### #
         #   # #   #     #   # #   # #   # #   # #   #     #   #   #   #   # #   # #   # #   #     #     #       # # # #       #
#### ##### ### ### # ### ### # ### # ### ### ### # ######### ##### ### ### # ### # ### # ##### ##### ############# # # ####### #
   # #     #   #   # #   #   # #   #   #   #   # # #         #   #   #   #   #         #   #   #   # #   #   #   #   #   #   # #
 # # # ##### ### ### # ### ### # ##### ### ### # # # ######### # ### ### ##### ######### # # ### # # ### # # # # ####### # # # #
 # # # #     # # #   #   #   # # #       #     #         #     #   #   #   #   #       # # # #   # # #   # # # #       #   #   #
## # # # ##### # # ##### ### # # # # # ######### ####### ### ##### # ##### # # # ##### ### # # ### # # ##### # ####### ####### #
     # #       # #   #     # #   # # # #     #     #   #   # #     # #     # # #     # #   # # # #   # #   #   #     #   #     #
 ##### ######### ### # # # # ##### # ### ### ####### # ### # # ##### # ##### # ##### ### ### # # ##### # # ######### ### # ### #
 # #   #       #   # # # #         #   #   #         #   # # # #     #     # #     #   #   #   # #   #   # #   #     #   # # # #
 # # ### # ### ### # # # # ### ####### ### ############# # ### # ######### # # ####### ### # ### # # ##### # ### ##### ### # # #
 # #   # # #     # # # # # #   #     # #               # #       #   #   # # #   #   #     # # #   #       #     #   #     # # #
 # ### ### # ##### # ### ### # # ### # # ############# # ##### ### # # # # # ### # # ####### # # ##### ##### ##### # ####### # #
 #   # #   # #     # #   #   # #   # # #   #   #     # #     # #   #   #   #   # # #         #   #   #             #         # #
 ### # # ### # ##### # ### ##### ### # # ### # ##### # ##### # # ############# # # # ### # ### ### # ### ### ############### # #
     #   #   # #   # #   # #     #   #   #   #     #     # # # #     #       # #   #   # #         # # #   #             # # # #
 ######### ### ### # ### # # ##### ####### ####### ### # # # # ##### # ### ### # ##### # ### ####### # ### ### ####### # # # # #
 #   #   # # #     # # # #   #   #       # #   # # #   #   # # #     # #   #   # #     #   #   #   # #     # # #S    # #   # # #
 # # # # # # ####### # # ##### # ##### ### # # # # # # ##### # # ##### # ### ##### ####### ### # # # ####### # ##### # # ### # #
   #   #   #   #       # #     # # #   #     #   # # # #   # # # #   # #   # # #   #   # # # # # # # #   # #   #   #   # # #   #
 ########### # # # ##### # ##### # # ### ######### # # # ### # # ### ##### # # # ### # # # # # ### # # # # ### # # ##### # #####
       #     # # #   # #   #   #   #   #   #       # #   #   #   #       # # # #     # #   # #   # #   # #     # # #   #   #   #
###### ### ### # ### # ##### ######### ### # ####### ##### ### ### ##### # # # ### ### ##### ### # ##### ####### # ### # ### # #
   # #     # #     # # #     #         # # #       # #     #   #       #   # #   #   # #     #   #     #         #   # # #   # #
 # # ####### ### # # # # ### # ######### # ####### # # ##### ### ##### # ### ### ##### # ##### ### ### ############# # # # ### #
 #         #     # #     #   # #         #   # #   # # #         # #   #   #   #       #       #   # #   #       #   #   # # # #
######## # # ##### ########### # ####### ### # # ##### ##### ##### # ### # ### ################# ### ### # ### ### ##### # # # #
         # # #         #       # #   # #   # #   #     #   #     # # #   #   # #     #   #       #     #   #   #   #     # # # #
 ######### # # # ##### # ####### # # # ### # ####### ### # # ### # # # ##### # ##### # ### ####### ### ##### ### ######### # # #
 #   #   #   # # #   # #   #   #   #   # # # # #     #   #   #   #   #   #   # #   #   #   #       #   #   #   #           #   #
 # # # # ##### # # # # ### ### ######### # # # # # ### ### ############# ##### # # ### # ### # ##### ##### ### #################
 # # # #       # # #   # #   # #       # # # # # # #   #   #   #   #   # #     # #     # #   #     # #       # #   # #   #   # #
 ### # # ##### ### ##### ### # # ##### # # # # # # # ### ### # # # # # ### ##### ####### ######### # ##### ### ### # # # ### # #
   #   #     #   # #   #   #   # #     # # # #   # # # #   # #   #   #   # #     #   #   #   #     # #   # #   #   # # #       #
## ############# # # # ### ##### # ##### # # ##### # # ### # ########### # # ##### # # ### # ####### # # # # ### ### # #########
 #   #       #   #   # #       # #     #   #   #   #   #   # #       #   # # #   # # #     #   #       #   # # #   #       #   #
 ### # ##### # ####### # ##### # ##### ### ### # ####### ### ####### # ### # ### # # ######### # ########### # ### ### ##### # #
 # #   #   # #     #   #     # #     #     # #   #     # # #         #   # #     # #       #     #   #       #   #   # #     # #
 # ##### ### # ##### ####### # ### # ##### # ######### # # ######### ##### ##### # ####### # ##### # # ######### ### # # ##### #
       #     # #     #     # #   # # # #                   #       #       #   # # #       #   #   # # #   #   #         #     #
 ### # ####### # ##### ### ##### ### # # ####### # ######### ### # ######### # # # # ### ### ### ##### # # # # # ##### #########
 #   #   #     #     # # #     #   # #     #   # #           #   #     #   # #   # #G#   #   #   #   # # # # # # #   #         #
 # ##### # ### ##### # # ##### ### # # ##### # ############### ### ### ### # ##### # # ### ### ### # # ### # # ### # ######### #
 # #   #   #       #   #   # # #     # #     # #               #     #     # #     # # #     # #   # #   #   # #   # #   #     #
## # # ########### ####### # # ####### # ##### # ############### ### ####### # ##### ### ##### # # # ### ### ### ### # # # #####
   # # #                   # #   #   #     # # # #     #       #   #   #   #   #   # #   # #   # # #   #   #     # # # # #   # #
 ##### # # ####### # ### ### ### # # ##### # # ### ### # ######### # # # # # ### # # # ### # ##### ### ### ####### # # # ### # #
 #     # # #     # #   #     #   # #     #   # #   #   #         # # #   # # #   # #   # # #       # #     #   # #   # #   # # #
 # ####### # ### # ### # ##### ######### ### ### ### ########### # # ##### # ##### ##### # ######### ######### # # ### ##### # #
 # #   #   #   # # #   #     #     #   #     #   # # #   # #   #   #     # # #   #     #     #   #   # #   #   # # #     #   # #
 # # # # ##### # # # ##### # ##### ### ##### # ### # # # # # # ####### # # # # # ### # ### # # # # ### # # # ### # ##### # ### #
   # # # #     # # # #   # #     #   #   #   # #   #   # # # #   #   # # #   # # #   #     # # #   #     # # #   #   #   #     #
###### # ### ### ### # # # # ####### # # # ### ### ##### # # ### # # # # ##### # # ######### # ##### ####### # # ### # ####### #
       #   #   #     # #   # #       # # #   #   #   #   # #   #   # # #     # # # #   #   # #       #     # # #   # # #     # #
 ######### # # ####### ##### # ######### # ##### # ### ### ### ##### # # ### # # ### # # # # ##### ### ### # ### ### # # ### # #
   #       # # #         #   # #   #   #         #   #   #     #   # # #   #   #   # #   # # #   # #   # # # #   #   #     # # #
## # ####### # ######### ##### ### # # ### ######### ### ######### # # # # ####### ####### # # # # # ### # # # ### ### ##### # #
 #   # #   # # #   #   # #   #     # #   # #   #   #   # #     #   #   # #       #         #   # #       #     #   #   #   # # #
 ##### # # # # # # # # ### # ########### # # # ### ### # # ### # ####### ### ################### # ############# ### # # # ### #
         #   #   #   #     #                 #         #   #   #           #                                         #   #     #
