################################################################################################################################
# #   #         #         #       #   #   # #   #   #             #                     #         #         #   #     #   #   # 
# # # # ######### # ##### # ### # ### # # # # # # # ############# # ############### ### # ####### # # # ### ### # ##### # # # # 
#   #   #         # #   # # #   #     # # # # #   #     #   #   # # #             #   #         #   # #   #     #   #   #   #   
# ####### ########### # # # # ##### ##### # # ####### # # # # ### # # ########### ### ####### ####### ##### ##### ### ######### 
#   #   # #       #   # #   #     # #     # # # #   # #   # #       #     #     #   #   #   #   #   # #   # #     #   #     #   
# ### # # # ##### # ### # ####### # # ##### # # # # ####### # ##### ### ### ### # ##### # # ### # ### # # # # # ### ### ### # ##
#     #   # #   # # #   # # #   # #   # #   #   # #         # #   #     #   #   # #   # # #   # #   # # # #   # #   # # # #   # 
# ######### # # ### # ### # # # # # ### # # ### # ########### # # # ##### ### ##### # # # ### # ### # # # ####### ### # # ##### 
#         #   # #   #   #   # # # #       #     #     #       # # # #   #   #     # #   # #   # #   # # # #     # #   # #       
# ####### # ### # ##### ##### ### # ################# # ### ### # ### # ### ##### # ##### # ### # ### # # # ### # # ### # ######
#   #   #   #   # #   #     #   # # #     #   #       # # # #   #   # #   # #     # #   # # #   # # #   # #   # # #     #   #   
# # # # ######### # # # ### ### # # # ### # # # ####### # # # ##### # ### # ### ### # # ### # # # # ##### ### # ### ##### # # # 
# #   #     #     # # #   # #     #   #   # #   #   #   # # #   # #   #   #   # #     #     # #   #     #   # #     #     #   # 
# ######### # ####### # # # ####### ### # # ####### # ### # ### # ##### # ### # ############# ##### # ##### # ####### ######### 
#   #     # #   #     # # #   #   #   # # #         #   # #   # #     # # #   #     #               #     #   #   #   #     #   
### ##### # ### # ####### ### # ### ### # ########### ### # # # ##### # ### ####### # # ####### # ##### ####### ### # # ### # ##
# # #   # # # # #   #       # # #   #   #               #   # #     # #   #       # # # #     # # #   #             #     # #   
# # # # # # # # ### ######### # # # # ##### ### # ##### ##### ##### # ### ######### ### # ### ### # ### # # ############### ### 
#     #   #   #   #           #   # #   #   #   #     # #     #   # #   #     #     #   #   #     #   # # # #     #       # #   
# ##### ######### ################# ### # ### ### ### # ####### # # # ##### ### ##### ############### ### # # ### # ##### # # # 
# #   #   #     #   #     #   #     # # # #   #   #   #         #   # #   #     #   #       #   #   #     # # #   #     #   # # 
# # # ### # ### ### # ### # # # ### # # # ####### ################### # # ######### ####### # # # ######### # ######### ##### ##
#   #   #   # # #   #   #   # #   # # # #   #   # #   #     #   #       #   #         #   # # # #       # # #   #   # # #   #   
# ##### ### # # # ##### ##### ##### # # ### # # ### # ### # ### ### ##### # # # ####### ### # # ##### # # # ### ### # # # # ### 
# #   #   # #   # #     #   #     #   #   # # #   # #   # #     #   #   # #   #         #   # #       #   #   #   #   #   # #   
# # # ### # ##### # ####### ##### ####### # # ### # ### # ####### # # # ### ############# ### ######### ##### ### ### ##### ### 
#   #   # #   #   #       # #   # #   #   #     #   #   # #       # # #   #   #     # #   #   #     #   #   #     # # #   #   # 
### ##### ##### ######### # # ### # # # ##### # ##### ### ######### # ### # ### ### # # ##### # ### # ### ######### # # # ### # 
# # #     #     #       # # #   #   #   #   # #     # # #         # # # # # #   # #   # #     #   #   # #   #   #     # #   # # 
# # # ##### ####### ### # # # # ######### # ######### # ######### # # # # # # ### ##### # ########### # ### # ### ##### ### # # 
#   # #   # #       # # #   # # #   #     #     #     # #       #   # #   #   #   #     #   #       #       # #     #   #   # # 
# ##### # # ######### # ##### ### # # ### ##### # ##### # # ####### # ##### ### # # ######### ##### ### ##### # ##### ### ### # 
# #     #   #     #   #     #     #   #   #   # # #   # # #       # #   # #     # #     #   #   #     #     # #   #   # # #   # 
# # ######### ### ### ##### ######### # ##### # # # ### # ##### ### ### # # ##### ##### # # ### ##### ##### # # ### ### # # ### 
# #     #     #   #     #   #         # #     # # #     # #   #       # # # #   # #   #   #   #     #     #     #   #   #   #   
# ##### # ##### ### ### # ### # # # ### # ##### # # ##### ### ######### # # # # # # # ####### # ### ##### ##### # ### ####### # 
#     # # #   # #   #         # # # # # #     #   #     #         #   # #   # # # # #   #     # # #     #     # # #   #   # # # 
# ### # # ### # ############# ### # # # ##### ######### ######### # # # ####### # # ### # ##### # ##### ##### # # # ### # # # # 
#   #   #   # #       #   #   #   #   #   #           #           # # #   #     # #   # # #         #   #   #   # #     # #   # 
# ######### # ####### # # ##### ######### # ######### ### ####### # ##### ### ### ### ### ######### # ### # ### # ####### ##### 
# #       #     #   #   #     #       #   # #       #     #     # #     #   # #   #   #   #       # #   # # #   #   #   # #     
# # ### # ##### # ########### ##### # # ### # ##### # # ### ### # ##### ### # ### # ### ### ##### ##### # # # ##### # # # # ####
# #   # #     # # #     #     #     # # #   # #     # # #   #   # # #     # #     #   # #   # #   #   # # #       #   #   # #   
# ### # ### ### # # ### # ##### ##### # ### # ####### ### ### ### # # ##### # ####### # # ### # ### # # ### ##### ######### # # 
#     #   # #   # # # # #     # #     #   # # #       #   #   #   # # # #   # #   # #   #   # #     # #   # #   #         #   # 
# # ##### ### ### # # # ##### # ##### ### ### # ##### # ##### # ### # # # ##### # # ####### # ####### ### ### # # ##### # ##### 
# #     #     #   # #         #     # # #   # # #     #     # #   # #   #       # #       # # # #   #   #   # # # #     #       
# ### ########### # ############### # # ### # # # ######### # ### # ### ######### # ##### # # # # ##### # # # # # # ############
#   #             #   #             #   #   #   #   #     # # # #     # #   #   #   #   #   #         # # #   # # #     #       
### ########### ##### # ##### ######### # ### ##### # ### # # # # ##### # # # # ##### # ############# # ####### # ##### ####### 
# #     #     # #     # #   # #   #   # #   # #   # # #   # # #   #     # # # #     # # #   #     #   # #     # #     #       # 
# # # # # ### # # ### ### # # # # # # ##### # # # ### # ##### ### # ##### ### ##### # # ### # ### # # # # ### # ##### ##### # # 
# # # # #   # # # #   #   # #   #   #     # # # #     #     #     #   # # #   #   #   # #   # # #   # # #   #   #       # # # # 
# ### ##### # ### # # # ### ### ######### # # # ########### ##### ### # # # ##### ##### # # # # ##### # ### ##### ### # # # ### 
#   # #     # #   # # #   #   #     #   # # # #     #     #   #     # #   # #     #   #   # #   #   # #   # # #   #   #   #     
### # # ##### # ### ##### ### # ##### # ### # ##### ### # ### ##### # # ### # ####### ##### ##### ### ### # # # # ##### ########
# #   # #   #   #   #     # # # #     #   # #     #   # #   #     # #   #   # # #       # # #       # #   # # # # #   #         
# ### # ### ##### ### ##### # ### ####### # ##### ### # ######### # # ### ### # # ##### # # # ##### # # ### # # # # # # # ######
#     # #     #   #   #   # #   #   #   #   #       # #               #   #   #   #   #   # #     #   #     #   #   # # # #     
####### # ### # ### ### ### ### ### # # ##### ####### ############### # ### ####### ##### # # ####### ############### # ### ### 
#       #   # #   # #       #   #   # # #       #   #     #           #     # #     #         #     # #   #   #     # #     #   
# ######### # ### # # ####### ### ##### ####### # # ##### # ######### ####### # ##### ####### # ### ### # # # # ### # ### ### # 
#         # #     # # # #   # #     #   #       # # #     #         # #   #   #     # #     # #   # #   # # # # #   #   # #   # 
######### ### ##### # # # # # ##### # ### ######### # ### ########### # # # ####### # # ### # ### # # ### # # # # ##### # # ### 
#       #   # #     #   # # # #     #   #     #     # #       #         # #       # # #   #       # # #   # #   # #     # # #   
# ##### ### ### ##### ### # # # ####### ##### # ##### # # ### # ##### ########### # # ######### ##### # ### ####### ####### # # 
#   #   #   #   #     #   # # #       #     #   #     # #   # # #   # #           #     #     # #     #   #     #   #       # # 
# # # ### ### ### # # # ### # # ##### ##### ##### ####### ### # ### # # ############# ### ### # # ############# # ##### # ##### 
# # # #       # # # # #   # # #   #   #   #       #     # #   #     # #       #       #   #   # # #       #   #   #     # #     
### # # ####### # # ##### # # ##### ##### ######### ### # # ######### ####### ##### # # ### ### # # ##### ### ##### ### # ######
#   # #           # #   # #   #   #     #     #     # #   # # #   #       # #       # # #   # # # #     #   #   #   #   #       
# ### ############### # # ##### # ##### ##### # # # # ##### # # # # ##### # ### ####### # ### # # ##### ### # # # ### ######### 
# #           #     # #   #   # #     # # #   # # #   #     #   # #   # # #     #   #   #   # # #     # # #   # # #   #       # 
# ########### # ### # ##### # ####### # # # ### # ##### ######### ### # # ### ### # # ##### # # ##### # # ##### # # # # ##### # 
# #     #       # # # #     #       # # #       #     #         # #   #       #   # #   #   #   #     # #     #   # # #   #   # 
# # ### ######### # # # ########### # # ######### # # ####### ### # ########### ### ##### ##### # ##### # ### ####### ### # ### 
#   #   #     #   # # # #     #   #   #   #   #   # #       #     #       #   # #       #     # # #     # #           # # #     
##### ### ### # # # # # ##### # ######### # # ##### ########### ########### # # ####### ##### # # ### ### ##### # ##### # ######
#   #     #   # #     # #   #   #     #   # #   #   #     #   # #         # # #     #   #   #   # #   #   #     #       #   #   
# # ####### ### ####### # # # ### ### # ### ### ### # ### # # ### ####### # # ##### # ### # ### # # ### ### ### ########### # # 
# # #       #   #       # #   #   # # #     # #   # # # #   #     #     #   #   #   #     # #   #   #   # #   # #     #   # # # 
### # ####### ### ########### # ### # ####### ### # # # ########### ########### # ######### ### ##### # # ### # ##### # # # # ##
#   #   # #   #   #       #   #     #       #   # # # #   #         #         #   #     # #   #     # #   #   #       # # # #   
# # ### # # ### ####### # # # ############# ### # ### ### # ######### ####### ##### # # # ### # # # # ##### ### ##### # # # ### 
# # #   #   #   #     # #   # #     #     # #   #   # #               #             # #   # # # # #   #   # #   #   # # # #S  # 
# # # ####### ### ### # ##### ### ### # ### # ##### # ################### ##### ##### ### # # # # ##### ### # ### # # # # ### # 
# # #         #   # #   #   #     #   #       #   # #     #   #           #   # #     #     #   #       #   # #   # #   # # #   
# # ########### ### ##### ####### # ########### # # # ### # # # ########### # # # ######### ### ######### ##### ### ### # # ####
# #         #   # #       #       #       #   # # # #   # # # #   #   #   # # # # #   #                 #       # #   # # #     
# ######### # # # # ##### # ############# # # # ### ##### # ##### # # # # # # # # ### # ####### # ############### ### ### ##### 
# #         # # # #     # # # #   #     # # # #     #     #       # #   #   #   #   # #   #   # #   #           #   #   #       
# # ######### # # ##### ### # # # # # ### # ######### ### ######### ############### # ##### # # ### # # ####### ### ### # ######
# #       #   # #     #   # #   # # #     #         # #   #       # #       #   # #     #   # #   # # #   #   #     #   #       
# ####### ### # ### # ### # # ##### ############### # # ### ##### # # ##### ### # ####### ### ##### # ### # # # ##### ####### # 
# #     #   # # #   #         #   #   #     #   #   # #   # #   # #   #   #   # #   #     # #     #   #   # # #   #   #     # # 
# # ### ### # # # ### # ##### # # ### ### ### # # ### ### # # ### # ### # ### # ### # ##### ##### ##### ### # ##### ### ### # # 
# # # #   # # # # #   # #   # # #     #   #   #   # #   # #   #   #     #   #   #   #   # #       #   #   # #     # #     #   # 
# # # ### # # # ### ##### # # # ####### ### ####### ### ####### ### ### ### ##### ##### # # ####### # ### # ##### # # ##########
#   #   # # # #   #   #   #   #       #   # #         # #     # #     #   #       #     # # #       #     # #   #   #   #       
# ### ### # ### # ##### ##### ####### # ### # # ##### # # ### # # # ##### ### ##### ##### # # ######### ### # # ### ##### ##### 
# #   #   #   # # #   #     #           #   # #     # # # # #   # # #   #   # #   #   # # #   #         #   # # #   #     #     
# # ### ##### # # # # ##### ##### ##### # ####### # # # # # ##### # # ##### ### # ### # # ####### ####### ##### # # # ##### ####
# # #   #   # # #   # #     #   # #   # #       # # # #   #       # #   # #   # #   # # #         #   #   #     # # #   # #     
# # # ### # # ######### ##### # ### # # ####### ### # ##### # ### # ### # ### ##### # # ####### ### # # ### ##### # ### # ##### 
# # #   # # #         # #     #     #         #     # #   # #   # # #   #   #   #   # # #       #   #   # #   #   # # # #     # 
# # ### # # ######### ### ### ##### ##### ### ####### # ### ##### # # ### # ### # ### # # # ### # ####### ### # ### # # ### # ##
# # #   # #   #   #   #   #   #   # #   # # #     #   #     #     #   #   #   #   # # #   # #   #   #   #     # #     # #   #   
# # # ##### ### # # ### ### # # # ### # # # ##### # ####### # ##### ### ##### ##### # ### ### ##### # ### ##### ##### # # ##### 
# # #     # #   #       # # # # #   # #   #       #       # # #             #       #   # #   #   # #     #     #   # #   # #   
# # ##### # # ### # ##### # ### ### # ####### ### ####### # # ##### # ##### ####### ### # # ### # # # ####### ### # # ##### # ##
#   #   # # # #   # #   #   #   # #   #     # #     #   #   #   #   #   #   #     # # # # #     # # #     #   #   # #       # # 
##### ### # # ##### # # ##### ### ##### ### # # ### ### ### ### ##### # # ### ### # # # # ######### ##### # ### ### ##### ### # 
#   # #   #   #     # # #   # #   #   # #   # #   #         # # #   # # # #   # # #   # #       #   #   #   #   #   #   #   #   
# # # # ##### # ### # ### # # # ### # ### ### ### ######### # # # # ### # # ### # # ### # ##### # ### # ### # ### ### # ####### 
# #   #     # # #   #     # # #   # #     #     #   #     #   # # #     # # # # # # #   # #   # #     #   # #   #     #       # 
# ######### # # ########### # ### # ############### # ### ##### ########### # # # ### ### # # # ######### ##### ############# # 
#     #   # # #       #     #   # #   #         #   #   #       #     #   # # # #     #     # #     #   #   #   #           # # 
##### # # # # ##### # # ####### # ### ### ##### ####### ######### ### # # # # # ####### ####### # ### ##### # ### ####### ### # 
#   #   #   #     # # # #   #   #   #     #     #       #       #   #   #   # # #     #     #   #     #     #   # #       #   # 
# ########### # ### # # # # # ##### ####### ##### ####### ##### ### ######### # # ######### # ######### ### ### # ######### ### 
# #       #   # #   # # # #   #   # #       #   #   #     #   #   # #   #       #         # #     #   # #     # # #       #   # 
# # ### # ### ### ### # # ####### # # ######### ### # ##### # ### # # # # ##### ######### # ##### # # # ####### # # ##### ### # 
# # #   # #   #   #   #   #   #   # #   #     # #   # #     #     # # # # #         #   #       #   # #         # # #   #   # # 
# # # ### # ### ############# # ### ### # ### # # # # ##### ####### # # # # ####### # # ### ####### # ########### # # ##### # # 
# # # # # #   #         #     # #   # # # #   #   # #    G# #       # # # #   # #   # # #   #     # #     #       #   #   # # # 
# # # # # ########### # # ##### # ### # # # ############# # ##### ### # # ### # # ### # ### # ### ##### # # ### # ##### # # # # 
#   #   #             #               #   #               #       #   #     #   #     #     #   #       #   #   #       #   #   
