################################################################################################################################
################################################################################################################################
               #                 #         #     #     #   #   # #   #       #   #   #           #   #                     #   #
 ############# # ################# ####### # ### # ### # # # # # # # # ##### # # ### ### ####### # # # ##### # ########### # # #
 #   #   #   # # #   # #           #   #   # # # # #   # # # #   # #   #   #   #   #   # #   #   # #   #     #   #   #   #   # #
 # ### # ### # # # # # # ############# # ### # # # # ### # ### ### ##### ######### ### # # # ##### ####### # ##### # # # ##### #
 #   # #     # #   #   #             # # # #   # # # #   #   # #           #   # #     #   #     # #       # #     # # #       #
 ### # ##### # ####### ############# # # # ##### ### # ##### # # ####### # ### # ############### # # ### ##### ##### # ####### #
   # #     # #     # # #   #   #   # # # #     #   # #   #   #       # # # #   #   #   #     # #   #   #   #   #   #   #     # #
## # ##### # ##### # # # # # # # ### # # ##### ### # ### # ##### ### # # # # ##### # # # ### # ##### # ### # ### # ##### ### # #
   #       #     # #     #   # #   #   #   # # # # #   # # #   # # # #   # # #   # # # # #   #       #   # #   # #   # # # # # #
 ############### # ########### ### ####### # # # # ### # # ### # # # ##### # ### # # # # ### ### ######### ### # ### # # # # # #
         #     # #   #   #     #   #   #   #     #   # # #     # # #   #   # #   #   # #   #   # #         # # # #   # #   # # #
 ####### # ### # ### # # ### ##### # ### ##### ##### # # ####### # ### # # # # ### ### ### ### # # ####### # # # ##### ### # # #
       # # # # #   #   #   # #   # # #   #   # #     # #   #     #     # #         # #   #   #   #       # # # #         # # # #
 ### ### # # # # ######### # # # # # # ### # # # ##### ### ### ######### ####### ### ### ### ########### ### # ####### ### # # #
   #   #     # # #       # #   #     # #   #   #   #   # #   # # #   #   #     #     #   #   #   # #     #   # #   #   #   # # #
###### ####### # # ##### # ######### # ####### ### ### # ### # # # # ##### ### ##### # ### ##### # # ##### ### ### # ### ### # #
     # #       #       #   #   #   # # #     #   #   # #   # #     #     #   #     # #   #         #         #   # #   # # #   #
 ### ### ##### ####### ##### # # # # # # ### ### ### # ### # ##### ##### ### ##### # ### ####### ############# # # ### # # #####
   #     #     #   #   #     #   #       #   #   #   #   # #     #     # #   # #   #   #       # #       #   # # # #   # #     #
 # ############# # # ### ### ##### ####### ### ### ##### # ##### ##### ### ### # ##### ####### # # ##### # # ### # # ### ##### #
 # #   #         # #     #   #   # #     # #   #             #   #   # #   # #   #           # # # #   # # #     # # #   #     #
 # # # ########### ########### # ### ### # # # # ############# ### # # # ### ############### # ### # # # # ####### # # ### ### #
 #   #           # #           #   # #   #   # #   #     #   # # # # # # #                 # #     # # # #   #           # #   #
 ############### # # ############# # # ####### ### # ### # # # # # ### # # ##### ######### # ######### # ### ##### ##### ### # #
   #     #   # #   # #   #     #   # #       # # # #   #   # # # #   # # # #     #   #   # # #   #     #   #     # #   # #   # #
 # # ### # # # ##### # # # ### # ### ####### # # # # ######### # ### # # ### ##### # ### # # ### # # ##### ##### ### # # # ### #
 # #   #   #   #     # #   # # #   # # #     #       #       # #     # # #   #   # #   # # #     # #     #     #     # #   #   #
 # ### ######### ####### ### # ### # # # ######### ### ##### # ##### # # # ##### ##### # # # ##### ########### ####### ##### ###
 #     #       #       #     #   #   #   #       #   # #   # #     #   #   #         # # # #             #     #     # #   #   #
 ####### ##### ### ### ##### ### ##### ##### # # ### # # ### ##### ### ##### # ### ### # # # ########### # ##### ##### ### ### #
     #   #   #   # #   #   # # # #     #     # # # # # # #   # #   #   #   # #   #       # #     #     # #   #       #     # # #
 ##### ### # ### ### ### # # # # # ########### # # # # # # # # # ### # # ### ### ######### # ### # ### ##### ####### ####### # #
     #     #   #     # # # # #   #   #       # # #     # # #   #   # # #   #   #     #     # #   #   #     #       #   #       #
#### ######### ####### # # # ####### # ##### # # ##### # # # ##### # # ### ### ##### # ##### # ##### ### # ####### ### # #######
           #   #         # # #       #     #   #     # #   #   #   # # #     #   # # # #     #   #     # # #     #   #   #     #
 ##### ### # ### ########### # ##################### # ####### # ##### # ####### # # # # # ##### # ##### # ##### ### # ### # # #
 #   # # # # #           #   #     #   #   # #         #     # # #     # # #     # # # # #     #   #     #     # #   #   # # # #
 # # # # # # ########### # ####### ### # # # # ####### # ### ### # # # # # # ##### # # ####### ##### # ####### # # ##### # # # #
 # # #   # #   #     # # #       #   #   # # # #     #   #   #   # # # # # #       #   #   # #     # # #     # # # #   # # # # #
 # # ##### ### ##### # # ####### ### ##### # # # ### ######### ##### # # # ####### ##### # # ### ### ### ### # # # ### # ### # #
 # # #       #     #     #   #     #   #       # # #     #     #     # # #               # #     #   #   #   #   #     #     # #
 ### # ########### ### ### # # ####### # ####### # ##### # ##### # ### # # ####### ####### ####### ### ### ################### #
 #   #   #   #   #   #     #     #     #   #   #   #   #   #     #   #     #     # #     #       #   # #   #         #       # #
 # ### # ### # ##### ##### ##### # ####### # # ### # ############### ### ### ### # # ### ##### # ### # # ### ### ##### # ##### #
 #   # #   # #   # #     # #   # #     #   # # # # #           #     #   #   #   #   # #     # #   #   #       #     # #       #
 ### # ### # ### # ##### ### # # ##### # ### # # # ### # ##### # ####### # ### ### ### # ### # ### ################# # #########
   # #   # # #     #   # #   # #   # #       #   #   # # #     # #     # # # #   #   # # #   #   # #         #       #         #
## # # # # # # ##### # # # ### ### # ### ########### # # ### ### ##### # # # ### ### # ### ### # # # ####### # ##### ######### #
 # # # # #   # #     # #   #   #         #     #   # # #   #     #     # #   # # #   #   # # # # #   #     # # #     #     #   #
 # # # # ##### # ##### ##### ########### # ### # # # # ### ####### ##### ##### # # ##### # # # # ##### ### # # ### ### ### # ###
 #   # #       #   #   #   #     #     # #   #   # # #   #     #   #       #   # #     #   #   #     #   #   # #   #   # #   # #
 ########### # ### ##### # ##### # ### # ### ##### # # ####### # ######### # # # # ### ############# ### ##### # ### ### ##### #
   #       # #   # #     #   #   # #   #         # # # #   #   #   #     #   #G# # #   #         #   #   #     #   # #         #
 # # ##### # ### # # ####### # ### # ########### ### ### # # ##### # ### ####### # # ########### # ### ##### # ##### # # ##### #
 # #   # # #   # #   #     #   #   #     #     #   #     # #       #   #       # # #           # #   #     # #       # # #   # #
 # ### # # ### # ##### # ####### ####### # ### ### ####### ########### ####### # # ########### # ######### # ######### # # # ###
 #   #   #     #     # #       #   # #   # #             #       #     #     # # #       #     #           #         # #   #   #
 ### ########### # ### ##### # ### # # ### ######### ### ####### # ##### # # # # # ####### ################# ### ### # ####### #
 #   #           #     #     #   #   #     #   #     #   #       # #   # # # #   #   #   #     #   #   #   #   #   #   #     # #
 # ##### # ############# ####### ########### # # ##### # # ####### # ### # ####### # # # ##### # # ### # ### ##### # ### # ### #
 #     # #     #       #   #   #     #     # # # #     # # #     # # #   #         # # #     #   #   #       #     #     # #   #
 ##### # ##### # ### ##### ### ##### # ### # # # # ##### # # ##### # # ##### # # ### # ##### ####### ######### ##### ##### # ###
   #         #   # #     #   # #     #   #   # # # #   # # #           #     # #   # #   # #   #     #   #   #   #       # #   #
## # ##### ####### ##### ### # # # ########### # # # # # # ##### ####### ##### ### ##### # ### ####### # # # ### # ####### ### #
   # #   #             #   # #   # #   #     # # # # # #   #   #   #   #   #     #       #   #     #   #   # #   # # #       # #
 ##### # ### ######### ### # ####### # # ### # ### # # # ### # # # # # ### ##### ########### ##### ######### # ### # # ##### # #
 #     #   #   #     # #   #     #   # #   # #     # # #     # # # # #   #   #   #   # #     #   #         # # #   # # #     # #
 # ####### ### # ### ### ####### # ####### # ####### # ####### # # # ### ### # ### # # # ####### ######### # # # # # # # ##### #
   #       #   # # #   #   #     # #     # #       # # #     # # # #   #     # #   #   # #       #     #   #   # # # # # #     #
#### ##### ##### # ### # # # ##### # ### # ####### # # # ### # # # ########### # ####### ### ##### ### # ####### # # # # # #####
     #     #     #     # # #     #   #   #   #   # # # #   #     #       #   # #   #       #   #   # #   #       #   # # #     #
 ########### ############# ########### ##### # ### ### # # ############# # ### ### # ##### # # # ### ##### ##### ##### ####### #
 #         # #   #   #       #       #       #     #     # #       #   # #     #     #       # # #   #     #     # #   #     # #
 # ####### # # ### # ### ### # ##### ######### ##### ####### ##### # ### ### ######### # ####### # ### # ### # # # # ### ##### #
     #     # #     #     #   # #   # #   #   # # #         #   # # #   # # # #       # # #     # #   # #   # # #   #   #       #
###### ##### ############### # # ### ### # # # # # ####### ### # # ### # # # # ##### ### # ### # ### # ### # ######### #########
   #   #   #     #     #   # # #   #       # # # #   #   #     #   #   # # # # #   # #   #   #   #   # #   #       # # #       #
 # # # # # ##### # ### # # ### # # # ######### # ### ### ########### ### # # # # ### # ##### ##### ### # ######### # # # ### ###
 #   # # #     # #   # # #     # #   #     #   #   #     #       # #     #   # #     #   # #   #   #   #         # # # # # #   #
 ##### # ##### # ### # # ####### ##### ### # ### # # ##### ##### # ##### ##### ######### # ### # ### ########### # # # # # ### #
 #     #     # #   # #   #     # #   # #   # #   #   #     #     # #     #   # #           # # # #   # #   #     #   # # #   # #
 ########### ##### # ##### # ### # ### # ### ##### ### ##### ##### # ##### # # # ### ##### # # # # ### # # # ####### # # ### # #
     #  S    #   #   # #   #     #   # #     #   #   #   # #     #   #     #   #   # #   #   #   #   #   # # #     # # # #   # #
 ### # ####### # ##### # ########### # ####### # ### ### # ##### ##### ########### ### # ### ##### # ##### # ##### ### # # ### #
   #   # #     #       # #           #   #     #   #   #   #   #       #         #   # #     #     #     # #       #   # #     #
 # ##### # ############# # ### ##### ### ##### ### ### ### # # ######### ########### # ##### ### # ##### # ######### ### #######
 # #     #     #     #   #   #     # # #       #   # #     # # #   #   # #     #   # # #   #   # #   # #   #       #     #   # #
 # # ######### ##### # ####### ### # # ######### ### # ### # ### # ### # # ### # # # # # ##### # # # # ##### ##### ######### # #
 #   #       # #     #       #   # #       #   #   #   #     #   #   # # # #     #   # #       # # #         #         #   # # #
 ##### # ##### # ### ####### ##### ####### ### ### ##### # ### ##### # # # # ######### # ##### # # ##### ### # ####### # # # # #
       #     # #   #       #       #     #   #   # #   # # #   # #   # #   # #   #     # #   # # #     #   # # #     # # #   # #
## # # ##### # # # ####### ########### ##### ### # # # ### # ### # ### ##### # # # ####### # # # ##### ### # # ##### # # ##### #
   # # #     # # #     #   #         #     # # # #   # #   # #   #   # #   # # # #         # #   #     #   # #     # #   # #   #
 ### # ####### # ####### # # ####### # ##### # # ##### # ### # ##### # # # # # # ##### ##### ########### ######### # # ### # # #
 #   #     #   #     #   #   #     # #     # #     #   #   # #       #   # # # # #   #     #           #     #   #   #       # #
 ######### # ### ##### ####### ### # ### # # # ##### ##### # ########### ### # ### # # ############### # ### ### ##### ####### #
     #   # # #       # #       #   #   # # # #   #   #     #     #     #     #     # #   #     # #     #   #   #     # #       #
 ### # # # # ####### # # ####### ##### # ### ### # ####### ##### # ### ##### ####### ### # ### # # ##### # ### ### # # # ##### #
 #   # # # #     #   #   #     # #   # #         # #     # #     # # # #   # #     # #   # # # # # #     #   #   # #   # #   # #
 # ### ### ##### ######### ### # # ### ### ##### # ##### # # ##### # # # # # # ### # ### # # # # # ######### ### ####### # # # #
 # #           #   #     # # # # #   #   #   #   #   #   # # #     # # # #   # #   #   # # # #   #     #   #   # #       # #   #
 # ######### # ### # ### # # # # # # ### ### # # ### # ### # # ##### # ####### # ##### # # # ##### ### # ##### # # #############
 #   #       #   #   # # # # #   # #   # #   # #   # #       # #     #     #   #       # # # #   # #   #       # #     #   #   #
 ### # # ##### ####### # # # ##### ##### # ### ### # ### ### # # ######### # ########### # # # # # # ######### # ##### # # # # #
 # # # #   #       #   # # #       #   #   #   # # #   # #   # #         #   #   #       # #   #   #   #   #   #     # # #   # #
 # # # ### # # ### # ### # ##### ### # # ### ### # ### ### # # ######### ##### # ### # # # ####### ### # # # # ##### # # ##### #
   # # # # # # # #   #   #     # #   # # #   #       # #   # #   #         #   # #   # # # #     #   # # #   #   #   # # #     #
#### # # # ### # ##### ####### # # ### # # # ####### # # ### ### ####### # # # # # ### # # ### ##### # # ####### # ##### # #####
     #   #   #   #   #       # # # #   # # # #   # # # #   #   #   #     #   # #   #   # #   #       # #   #     #       #     #
 ##### ##### ### # # ####### # # # ##### # ### # # # # ##### # ### # ####### # ##### ### ### ####### # ### # ### ############# #
   #     # #   # # #       #   # # #     #   # # # # # #   # #     # #   #   # #   # # # # #     #   #   # #   #     #     #   #
## ##### # ### # # ####### ##### # # ### ### # # # # # # # # ####### ### # ### ### # # # # ##### # ##### # ### # ##### ### # # #
 #     #   #   # # #     #   #   #   #     #   # # #   # # #       # #   #   #   # #   # #   # # # #     # # # # #   # # #   # #
 ### # ##### ##### ##### ### # # ##### # # ##### # # # ### # ##### # # ##### ### # ##### ### # # ### ##### # # # # # # # ##### #
   # #     #     #     #   # # #     # # #     # # # #     # #     #   #   #   #   #   #     # #   # #   #   # # # # # #   #   #
## # ##### # ### ##### # # # ####### # # ##### # # ######### # ######### # ### ##### # ##### # ### # # # # ### ### # # ### # # #
   #   #   #   #     # # # #   #       #   #   # #       # # # #   #     #     #     #     # #   # #   # #   #   # # # #   # # #
 ### # # ### ### ### # ### ### ########### # ### ####### # # # # ### ########### ######### # ### # # ### ##### # # # # # ### # #
 #   # #   # #   #   #     #   #   #     # #   # #       # # # #   #       #     #         #     # # #   #   # #   # # #   # # #
 ######### # # ########### # ### # # ### # ### # # ####### # # ### ####### # ##### ######### ##### # # ### # ####### # ### ### #
 #         # #   #     # # #     #   #   #   # #   #       # #   #         # #     #   #       #   # # #   # #     # #   #     #
 # ######### ### # ### # # ################# # ##### ##### # ### ####### ### # ####### # ##### # ##### ##### # ##### ### ##### #
 # #   #   #   #   # #   # #               # # #   # #     #   #     #   #   # # #   #   #     #     #   # # #         # #     #
 # # ### ### # ##### ##### ##### ######### # # # # # # ####### ##### ##### ### # # # ##### ### ##### ### # # ########### # #####
   #         #           #       #           #   #   #             #       #   #   #       #       #     #               #     #
################################################################################################################################
