################################################################################################################################
################################################################################################################################
     #   #     #                   #                           #                     #         #     #   #         #           #
#### # # # ##### ##### ####### # ### ####### # ### ####### ##### ################### # ####### # ##### # # ### ##### # # ##### #
     # # # #     #   #     #   #     #     # #   #       # #   #       #       #   # # #   #   #   #   # # # # #     # #     # #
 ##### # # # ##### # ####### ######### ##### ### ####### # # # ####### # ##### # ### # # # # ### ### ### # # # # ##### ##### ###
 #     #   # #   # # #     # #       #     #   #   #     # # # #     # # #   # #   #   # # # #   #     #     #   #     #   #   #
 # ######### # # # # # ### # # ##### ##### ### ### # ##### # # ##### # # # ### ### ##### # # # # # ######### ##### ##### # ### #
       #     # #   # # # # # # #     #   #     #   #   #   # #   # # # #   #   #   #   # #     #    S#     # #     #     #     #
###### # ##### ##### # # # # ### ##### # ####### ##### ### # ### # # # ### # ### ### # # ############# ### ### ############### #
   #       #   #   # # # # #     #     #       #     # #   # # # # # #     #     # # #       #         # #   #   #         #   #
 # ####### # # # # # # # # ######### # ####### ### # # # ### # # # # ############# # ######### ######### ### ### # ####### # ###
 #     # # # # # # #   # # #       # #   #         # # # #   #   #         #       # #         #   #     # #   # # #       #   #
 ##### # # # ### # ##### # ### ### ##### ########### # ### ########### # ### ####### # ########### # ##### ### ### # ###########
 # #   # # #   # # #     #   #   #     # #   #   #   #     # #       # #     #       # #         # # #   #   #     #   #       #
 # # ### # ### ### # ####### ### ##### # # # # # ### ####### # ##### # ##### # ####### ######### # # # ### # ####### ### ##### #
   # #       #     #       # # #   #   #   # # #     #     #   #   # #     # # #     #           #   #     #   #     #   #     #
#### ##### ######### ##### # # ##### ####### # ####### # # ##### ### # ### # # ##### ############# ########### # ##### ### #####
         #   #   # # # #   # #       #   #   #         # #       #   #   # # #     #           #   #   #   #   # #   # #   #   #
######## ### # # # # # # ### # ####### # # ############# # ####### ### ### ####### # # ####### # ### # # # # # # # # ### ### # #
   #     #   # #   # # #     # #       #   #           # #         #     # #     #   #       # #     #   #   #   # #     # # # #
 # ##### # ####### # # ####### # # ####### # ######### # ######### # ### # # ####### ####### # ####### ######### # ####### # ###
 #     # #         #   #     # # #   #     # #   #   # #     #   #   #   # #             #   #       # #       # #   #         #
 ##### # ##### ####### # ### # ##### ####### # ### # # ##### # # ####### ####### # # ##### ##### # # # # ##### # ### # ####### #
     # #   #   #   #   #   #       # #     # #   # # #     # # #   #   # #       # #     #     # # #   # #     #     #   #   # #
#### # ### # ### # # ############# # # ### # # # # ####### # # ### # # ### ### ### ##### ####### # ##### # ######### ##### # # #
   # # #         #     #         #   # #   # # #   #       # # # #   #     # # #   #   #   #     # #   # #   #     #       #   #
 # ### # ############### ####### # ### # ### # ##### ######### # ########### # # ### ### # # ##### # # # ### # ### ########### #
 #     #   #   #       #   #   # # #   # #   #   #   #         # #   #     #   #     #   # #   #   # # #   # # #       #     # #
 ######### # # # ##### ### # # # ### ### # ##### # ### ######### # # ### # ### ####### ### ### # ### ##### # # ####### ##### # #
 #   #   # # #   #   #   #   # #     #   #   #   # # # #       #   # #   # #         #   #   # #   # #     # #     # # #   #   #
 # # # # # # ##### # ### ##### ####### ##### # ### # # # ##### # ##### ### ### ##### ### ##### ### # # ##### ##### # # # # ### #
 # # # #   #   #   #   #       #       #     #   # # # #     # # #     # #   # #   #   # #       #   # #           # #   #     #
 # # ### ##### # # ############# ### ### ####### # # # ##### ### # ##### ### ### # # ### # ########### ############# ######### #
   #   #         # #         #   # # #   #     # #   # #   # #   #     # # #     # # #   # #     #   #         #   #   #     # #
###### ########### # ####### # ### # # ####### # ##### # ### # ####### # # ####### # # ### # ### ### ######### # # # # ### ### #
     #           # # #   #   #   #   #   #   # # #   # #         #     #         # # #   #   # #   #   #     #   # # #   # #   #
 ############### # # ### # ### # ####### # # # # # # # ######### # ############# # # ### ##### ### # ### ### ##### # ### # # ###
 #   #       #   # #   # #   # #         # #       # # #       # # # #   #     # #     #     #   #   #   #   #     # # #   #   #
 # # # ####### ### ### # ### ######### ### ######### # # ##### # # # # # # # # # ### ##### # # ####### ### ######### # ### ### #
   #   #     #       # #   #         #     #     #   # # #     # # #   # # # # #   # #     # # #     #   # #     #   #       # #
###### # ### # ##### # # ########### # ### # ### ##### # # ##### # # ### # # ##### # # ##### # # ####### # ### # ########### # #
     # # # #   #   #   #   #       # # #   #   # #     # #   # #   #   # # #     # # # #       #   #     #   # #         #   # #
 ### # # # ##### # # ##### # ####### # # ##### # # ######### # ####### ### ####### # # ####### ### # ####### # ######### # ### #
   # # #   #     # #       #         # #   #   #   #         #                   #   # #     #   # #   #     #   #       #   # #
#### # ### # ##### # ### ############# ##### ##### # ########### # ############# ### # # ### # ### ### ### ##### ######### # # #
 #   #   # # #     #   # #   #   #     #     #     # #         # #   #     #   #     # # # # # #   # #   #     #   #       #   #
 # ##### # # ######### # # ### # ####### ##### ##### # ### # # # ### # ### # # ####### # # # ### ### ### ##### ### ####### #####
 # #     # #       # # #   #   #   #   # #   # #     # # # # # # #   #   #   #       #     #           # #   #   #   #     #   #
 # ##### # ####### # # ##### ##### # # # # # ### ##### # # # # ### # ### ########### ######### ##### ### # # ### ### # ##### # #
 #     #     #   # #   #   # #       # #   #     #     # # # #   # #   #   #       # #       # #   # #   # #   #   #       # # #
 ##### ##### # ### ### # # # ######### ############### # # # ### # # # ### # ### # # # ##### ### # ### ### ### ### # ####### # #
             #   # #   # # #     #                     #   #   # # # #   # # #   # #   #   #     # #   #   #   #     #       # #
 ########### ### # ##### # ##### # # # ### ################### # # ##### # ### ### ##### # ####### # ### ##### # ##### ####### #
 #         #     #     # #     # # # # # # #   #   #           # #   #   #   # #     # # #       #   #     #       #     #   # #
 # ####### ##### ##### # ####### # ### # # ### # # # ########### # # # ##### ### ### # # ### ############# # ##### # ##### # # #
 # # #   #       #   # #     #   #   #   #     # # #       # #   # # # #   #   # # # #   #   #     #     # #   #   # #     # # #
 # # # # ####### # # # ##### # ##### ########### # ####### # # ##### # # # ### # # # # ### ### ### ##### # ##### # # # ##### # #
 #   # # #       # #       #   #         # #     # #       # #       # # #   # #   # #   #   #   #     #   #   # #   # #     # #
 ##### # ####### # ############# ####### # # ##### ######### ######### # ##### ##### # # ### ### ##### ##### # ##### # ####### #
     # #         # #       #     #   #   # # #   #   #   #     #       #       #       #   #   #     # #     #     # #   #     #
###### ######### # # ##### # # # # # # ### # # # ### ### # ### # ##### ######### ### ##### ### ##### # # ######### # ### #######
     # #   #       # #   # # # # # # #     #   # #     #   #     #       #         #     #   #     # # # #         #   #   #   #
 ### # # # # ### ### # # ### # # # # # ######### ##### ########### ##### # # ### # # ####### ##### # # # ### ##### ### ### # # #
 #   #   # #   #     # #     # #   # # #     # #     #   #       #     #   #   # # # #     #     # # #   #   #   #     # # # # #
 ############### ##### ####### ##### # ##### # ##### ### # ##### ##### # ##### # # ### ### ##### # # ##### ### # ##### # # # ###
         #     #       #       #   # #             # # # # #   # #     #   #   # #       #   # # # # #   # #   #     #     #   #
######## # ### ################# # # # ########### # # # # # ### # ##### # # ### ########### # # ### # # ### ####### ##### ### #
     #   # # #   #             # # # #     #     # #   #   #   # #     # # #   # # #   #     # # #   # #   # #   #   #   # # # #
 ### # ### # ### # ########### ### # ### # # ### ########### # # # ### ### ### # # # ### ##### # # ### ### # # # # ### # # # # #
   #   #   #     #           #   #   #   # #   #       #   # #   # # #   # # # #   #     #   # # # # # #   # # # # #   # #     #
## ####### # ############### ### ############# ####### # ### ##### # ### # # # ########### ### # # # # # ### # # # # ### ##### #
 # #       # # #   #   #     # #   #     #   #       # #   # #     #   # #   # #         #       #   # #   # # #   #   #     # #
 # ##### ### # # # # # # ##### ### # ### # # ####### # ### # # ####### # ##### # ####### ############# ### ### ############# # #
   #     # # # # # # # # #   #   #   # #   # #       # #   # #       # #   #   #   #     #     #       # #     #         #   # #
 ### ##### # # # ### # # # # # ####### ##### # ####### # ### # ##### # ### # # ##### ##### ### # ####### ####### ####### # ### #
   # #   # # #       # # # # #   #     #   # # # #     #     #   # # # #   # #   #   # #   #   #           #         # #   #   #
## # # ### # ######### # ### ### # ### # # # # # # ##### ##### # # # # # ### ##### ### # ### ##### ##### # # ### ### # ##### ###
 #   #   # #       #   #   # #   #   # # # #   # # #   #   #   #   #   # #   #         #   #     #   #   #     #   #   #   # # #
 ####### # ####### # # ### # # ##### # ### ##### # # ##### ### ######### ##### ##### ##### ##### # # ############# # ### # # # #
 #     # # #   #   # #             # #   # #   # # #     #   # #   #   #       #   # #   # #       #     #     #   #     # # # #
 # ### # # ### # ### ##### ####### ##### # # # # # # # ##### # # # # # # ####### # # # # ### ########### # ### # ### # # ### # #
 # # # #   #   #   #     #   #   #   #   #   # # # # #       # # # # # # #       # # # # #   #     #   #   #   # #   # # #   # #
 # # # ### # ##### ##### ### # # ### # ####### # # # ######### # ### # ### ####### ### # # ### ### # # # ####### # # # ### ### #
   # #   #   #   #   #     # # #   # # #     # # # #   #   #   #     # #   #   #     # #   #   # # # # # #   #   # # # #   #   #
 ### ### # ### ##### ####### # ### # # # ### # # # ### # # ########### # ### # ##### ##### # ### # # # ### # # ##### ### ##### #
     #   #   #   # #         #   #   #   #   #   #   # # #         #   #     #     #     # #   # # # # #   # # #   #     #     #
#### ##### # ### # ############# ### ##### ##### ### # # ######### # ################### # ### # # # # # ### # # # # ##### # ###
     #   # # #       #           #   #   # # #   #   # #   #       # #         #         #   # # #   #   #   #   # # #     #   #
 ##### # # ### ####### # # # ##### ### # # # # ### ### ### # ####### # ####### # ######### ### # ######### ####### # # # # ### #
       # #   # # #     # # #   #   #   # # #   # # #   #   # #     # #       #           #     #     # #   #       #   # # #   #
## ##### ### # # # ##### # ### ### # ##### # ### # ### # ### # ### # # ##### ######### # # ######### # # ### ########### # # ###
   #   #     # # # #   # #   #   #   #           #   # #   # #   #     #   # #   # #   # # # #   #   # # #   #   #       # # # #
 ### # ##### # # # ### # ### ### ##### ######### ### # ### # ##### ##### # ### # # # ### # # # ### ### # # ### # ########### # #
   # # #   #     # #   #   # # #       # #     #   # #   # # #   # #     #     # # # #   # #   #   #   # #     #           #   #
## # ### # ##### # # ### # # # ######### # ### ##### ### # # # # # # ########### # # # ### # ### ### # # ####### ######### ### #
 # #     #   #   #   #   # # # #       # # #   #   #   # # #   #     #         # #   #               # # #     #         #   # #
 # ######### # # ####### # # # # ####### # ### # # ### # # ##### ##### ####### # ##################### # ##### ### ######### # #
     #       # #   #   # # # # #   #     #   #   #     # # #     #       #     #     #   #       #   # #     #   #   #       # #
###### ######### ### # # # # # ### # ####### ########### ### ##### ####### ######### # # # ##### # # # ##### ### ### # ####### #
   #   #         #   # # # # #   # # # #     #     #   #     #     #       #       #   #   #     # #   # #   #   # # #     #   #
 # # ### # ####### ### ### # ### # # # # ####### # # # ##### # ############# ##### ######### ##### # ### # ### ### # ##### # # #
 # # # # # #   #     # #   #     #   # # #       #   #             #       # #   # #   #   # #     # #   # #   #     #     # # #
 # # # # ### # # ##### # # ####### ### # # ################### ##### ##### # # # # # # # ### # # # ### ### # ######### ####### #
 #   # # #   #   #   # # # #       #   # #   #     #       #   #   # #   # #   # #   # # #   # # #     #   # #       # #       #
 ##### # # ####### # # # # # ####### ### ##### ### # ##### # # # # # ### # ########### # # ### ######### ### # ##### # ### #####
   #     # #     # #   # #             #   #     # # #     # # # # #     #             # #   #     #   #   #   #   #   #   #   #
## # ##### # ### ####### ####### # ####### # ##### ### ####### # # ##### ############### ### # ### # # ### ##### # ##### ### ###
   #     #   # #   #       #     #   #   #   # #   #   #         #     # #   #     #   #     #   #   #   # #     #   #     #   #
 ####### ##### ### ### ### # ##### # # # ##### # ### ######### ######### # # ### # # ######### ######### # # ####### # # # ### #
 #   #           #   # #   # #     # # #     # # #   #   #   # #       #   # #   # #   #       #     #   # # #   # #   # #   # #
 # # ### # # ### ### ### ### ####### # ##### # # # ### # # # # # ##### ##### # ### ### ### ### # ### ##### # # # # ##### ### # #
 # # #   # #   #   #   #   # #     # #   # #   #   #   #   # # #   #   #     #   #   #   #   # #   #     # #   #   #       # # #
 # # # ### ### ### ### ### # # ### ##### # ######### ####### # ### # ### ##### # ### ### ### # ### ##### # ############### # # #
 # # # #   #   #     #     #   # #       # # #       #       #   # #     #     #   #   #     #   # #   #   # #   #     #   #   #
 # # # ##### ### ### ####### ### ######### # # ####### ####### ### ######### # ### ### ####### # # # # ##### # # ### # # # #####
 # #   #     #   #           #   #     #     # #     #   #   #   # #   #   # # #   #           # #   # #     # # #   # # # #   #
 # ### # # ####### ######### # ### # # # ##### # ####### # # # # # # ### # ### # ##### # ### ######### ##### # ### ### # # # # #
 # #   # # #       #         # #   # #   #   # #     #   # # # # # #     #   # # # #   #   #     #     #   # #     # #   #   # #
 # ##### # # ####### ### # ### # ### ##### # # # ### # ### # # # # ######### # # # # ########### # ##### # # ####### ##### ### #
   #     # #     #     # #     # #   #   # #   # #   #   # # # # # #       # # #   #   #         # #     #     #       #     # #
#### ##### ##### ### # ######### ##### # ####### # ##### # # # # # # ##### # # ######### ######### # # ####### ### # # ### ### #
     #   #     # #   #       #     #   #       # # #     # # # # # #     #     #         #   #     # #       #     # #   # #   #
 ##### # ####### # ######### # ### # ######### # # # ##### ### ### ########### # ######### # # ##### ######### ##### ### ### ###
     # # #   #   # #   #   #   # # # #       #   #   #         #   #   #   #   #   #  G    # #   # #   #     # #   #   #   #   #
#### # ### # # ### # # # # ##### # # # ############### ######### ### # # # ######### ####### ### # ### # ### ### # ### ### ### #
     #     #   #     #   #       #                               #   #   #           #           #     #   #     #     #       #
################################################################################################################################
