################################################################################################################################
################################################################################################################################
   #         #       #     #   #   #   #           #       #   #     #   #       #   #       #     #     #                   # #
## # ######### ##### # # # # ### # # ### # ####### ##### # # # # # # # # # ##### # # # ##### # ### # ### # ### # ##### ##### # #
   #       #   #       # # #     # #     # #             #   # # # #   # # # #   # #   #     # #   #   # # #   #     # #   #   #
 ######### # ### ####### # ### ### ##### # # ####### ######### # # ##### # # # ### ####### ### ######### # # ### ##### # # #####
         #   #     #   # #     #     #   # # #   #   #     # #   #     # # # #   #   #     #   #     #   # #   # #     # #     #
#### ### ##### ##### # ####### # ### ### # ### # # # # ### # # ####### # # # ### ### # ### # ### ### # ### ### ### ##### ##### #
     #         #     #         #   #     #   # # # # #   #   # #     # # # #   #  G# #   # # #   # #       #   #   #       #   #
 ##### ### # # # ################# # ####### # # ### ### ####### ### ### # ### ### ##### # # # # # ### ##### ### ### ####### # #
     #   # # # #   #     #   #   # # #       # #   # #   #   #   # # #   # #   # #       # # # # #     #   #   #   # #   #   # #
#### ##### # # ### ##### ### # ### # # ### ### ### ### ### ### ### # # ### # ### ### ##### # ### # ##### # ### ##### # # # ### #
     #     # #   #       #   # #   # # #   #     #   # #   #   #     #   #   # #     #     #   # # #     #   #       # #   #   #
 ##### ### # # ########### ### # # ### ### # ####### # ### # ####### ### ##### ##### # ### ### # # # ####### ######### ##### # #
 #   #   # # #   #             # # #   #   # #       #     #   #   # #               # #         # #     # #       #   #     # #
 ### ### ### # # # ####### # ### # # ### ### # ########### ### # # # # # # ####### # # ########### ##### # ####### # ### # #####
     #   #   # #   #   #   # #   # # #   #   # #       #   # #   # #   # #   # #   # #       #     #   # # #   #   # #   #     #
#### # ### ### ##### # # ##### ### # ##### ### # ##### # ### ##### ##### ### # # ### ######### ### # # # # # # # ### # ####### #
   # #   #   # #   # #   #   # #   #       # #   # #   #   #   #   #   #   # # #   # #       #   # # #   #   #   #   #   # #   #
 # # ##### # ### ### ### # # # # ########### ##### # # ### # # # ### # ##### # ### # # ##### ### # # ############### # # # # ###
 # # #   # #   #   # #   # #   # #       #         # #   # # # #     #   #   # #   # #   # #   # # #           # #   # #   # # #
 # # # # ##### ### # # # # ##### # ##### # ######### ##### # ########### # ### # ####### # ### ### ########### # # ######### # #
 # # # #       #   # # # #   #     # #   #   # #   #       #         #   #     # #     # #   #     #   # #     # # #       #   #
 # ### ######### ### # # ### ### ### # ##### # # # ################# # ######### # ##### ### ##### # # # # ##### # # ##### # ###
 #   #   # #   #     # #   #   #   # # #   #   # #           #     # #   #     # #     # #       # # #   #   #     # #     # # #
 ### ### # # # ########### ### # ### # # # ### # ########### # # ### ##### ### # ##### # ### # ### # ####### ####### # ##### # #
   # #   #   #   #   #   #   # # #   # # #     # # #       #   #   # # #   # #   #     #   # #     # #   # #         # #       #
## # # ####### # # # # # # # # # # ### # ####### # # ##### ####### # # # ### ### # ####### # ####### # # # ########### ####### #
 # #   #       #   #   # # # # # #     # #       # #   # #   #   #     # #       #   #     # #         # # #   #     #       # #
 # ##### ######### ##### ### # # ####### # ####### ### # ##### # ####### ##### # ### # ##### # # ####### # ### # ### ####### ###
 #   #   #   # #   #   #     # #                     # # #   # # #       #   # #   #   # #   # #       #           #       #   #
 ### # # # # # # ### # ##### # # ### # ######### # ### # # # # # # ####### # # ######### # ### ####### # ####### # ##### ##### #
 #   # #   # #   #   #   #   # #   # #   #     # # #     # #   #   #   #   #   #       #   #   #   #   #   #   # #     # #     #
 # ### ##### ##### ##### # ### # ### # ### ### # # # ##### ######### # # ####### ##### # ### ### # ######### # ####### # # #####
 # #     # #       #     # #   # #   # #   # # # # #   #   # #     # #   #     # #   # # # # #   #         # #   # #   # # #   #
 # # ### # ######### ##### # ### # ##### ### # # ##### # ### # ##### ##### ### # ### # # # # # ########### # ### # # ##### # ###
   #   #         # #   #   # #   #           # # #     # #   # #     #     # # # #   # # #   # #         #   #   #   #     #   #
###### ####### # # ### ##### # # ############# # # ##### # ### # # ### ##### # # # ### # ### # # ####### ##### ####### ####### #
 #   #   #   # # # # # #   # # #   # #       # # # # #   #   #   # #   #     # # # #   #   # # #       #     #         #   #   #
 # # ### # # # # # # # # # # # ### # # ##### # # # # # ##### ##### # ####### # # # # ##### # # ####### ##### ####### ### # # # #
 # #   #   # # #     # # # # # #   # # #     # #     # #       #   #   #   # #   # # #   #   #     # # #   #   #   #     # # # #
 # ### ##### # ####### ### # ### ### # # ##### # ##### # ##### # # ### # # # ##### # # # ### ##### # # # # ##### # ####### # # #
   # #       #     #   #   #   #   # # # #     #   #   #     # # # #   # # #   # #   # #     #     # #   # #     # #     # # # #
#### ######### # ### ### ##### # # # # # ### ##### # ### ### # ### # ### # ### # ##### ####### ##### ##### # ##### # ### # # # #
 #             #   #     # #   # #   # #   # #     # #     # #     #     # #   #       #       #   # #     #     # # # # # # # #
 # ######### ### # ####### # ######### ### # # ### # ### ### ############# # ### ####### ####### # # # ######### # # # # # # # #
 #   #       #   #   #   # #   #   #   # #   # #   #   #   #   #   #     # #     #   #   #       # #       #   # #   # # # # # #
 ### # ######### # ### # # ### # # # ### ##### # # ### ### ### ### # ### # # ##### # # ########### ####### ### # ##### # # ### #
 #   #   #       #     #   # # # # # #         # #   #   #   # #   # # #   # #     # # #         #   #   #     # #   # # #   # #
 # ##### # # # ############# # # ### ##### # ### ### ### # ### # ### # ##### # ##### # ### ##### ### # # ### ### # # # # ### # #
 # #     # # #     #       # # #   #   #   # #   #   #   #   #   #   #       # # #   #     #     #     # #   #S  # # # #   # # #
 # # ##### ####### # ##### # # ### ### # ### ### # ### ### # ##### ### ####### # # ######### ########### # ### ##### # ### # # #
   # #           # #     # # #   #     # #   #   #   # #   # #   # #   #       #   #     #   #         # #   #     #     # #   #
#### # ########### ####### # ### ####### # ### ####### ### # ### # ### # ########### ### # ### ####### # # ####### # ##### #####
     # #         #     #   #   # #       #   #   #     #   #     #   #   #   #   # #   # #   # #                 # #     # #   #
 ##### # ####### ### ### ### ### # # # ##### ##### ##### ########### ### # # # # # ### ##### # # ####### ##### ### # ### # # # #
     # # # #   # #   #   # # #   # # #     #     #   #             #   #   # # # #     #     # #   #   # #   # #   #   # #   # #
#### ### # # ### # ### ### # # ### # ##### ##### ### # ####### # # ### ##### # # # ### # ####### ### # ### # # # ##### ####### #
   #     # #     #     # #   # #   #     #     #   # # #   #   # # #   #       #   #   # #       #   #     # # #     #   # #   #
 # ####### ####### ##### # ### # ####### ########### # # # # ### ### ### ########### # # ####### # ######### # ##### ### # # ###
 #       #             #   #   #       #   #       # # # # # # # #   #     #         # #     #   # #     #   #   #   # # # # # #
 ### ### ##### # # ##### ### ############# # ##### # # ### # # # # ####### # ######### ##### # ### # ##### ##### # ### # # # # #
   # #         # # #   # # #   #       #   #   #   # #     # #   #       # #     #   #   #   # #   #   #   #   # # #   # # #   #
#### # ####### # ### # # # ### # ##### # ##### # ### # ##### ########### ####### # # ### # ### # ##### # ##### # # # ### # #####
   # # #       #     #   # #   # #       #   # # #   # #     #       #   #     # # #           # #   #   #   #   # #     # #   #
 # # # ##### ####### ##### # ### ########### # # ### # # ##### ##### # ### ### # # ########### # # ####### # ##### # ##### # # #
 # # #   #   #     #       # #     #     #   # #     # #   # #     # # #   #     # #             #       # #       #   #   # # #
 ### ### ##### ### ##### ### # # # # ### # ### ########### # ##### # # # # ######### ########### ####### # ########### ### # # #
       #     #   #     # #   # # #     #     #     #     # # #   # # #   # #   #   # # #   #   #         # #         #   # # # #
###### ##### ### ##### ### ### # ################# # ### # # # # # # ##### # # # # # # # # # # ######### # ##### ### ### # # # #
     # #   #   #     #     #   #     #       #     #   #   # # #   #     # # #   # # # # #   #     #   # #     #   #       # # #
 ### # # ### # ##### ####### ##### # # ##### # ####### ##### # ######### ### ##### # # # ######### # # # ##### ####### ##### # #
   # #   #   #     #     #   #   # # # #   # # #     #     # # #     # #     #   #   # # #     #     # # #   #     #   #   # # #
## # ##### ### # # ##### ##### # ### # ### # # # ### # ### # # ##### # ####### ####### # # ### # ##### # # ####### # ### # # # #
   # #     # # # # #   # #     # #   #   #   # #   # #   # # #     # #     #   #       #   #   # #   #     #     # #     # # # #
 ##### ##### # # # # # # # ##### # ##### ##### # ### ##### # ##### # ##### # ### ### # ##### ##### ##### ### ### # # ####### ###
       #   #   # # # # #   #   # #     #   # #   #   #   #       #   #           #   #     #       #     #   # #   #       #   #
######## # ##### # # # ##### ### ##### ### # ##### ### # ####### ##### ############################# ##### ### ########### ### #
       # #       #   #       #   #     #   #     # #   # #   #   #       #           #   #       # # #   # # #     #       #   #
 # # # # # # ### ######### ### ### ##### ####### # # ### # # # ### ##### # ######### # # # ##### # # # # # # # ### ### ##### ###
 # # #   # # #         # #   #   #     #       #   #   # # # #     #   # #     #     # # #     # #   # #   # # #     #   #     #
 # # ####### # # ##### # ### ### ##### ####### ### ### # # # # ##### # ####### # ##### # ####### # ### ##### # ##### ### # #####
 # #     #   # #   # #   #   #   #     #   # #   #   # # # # # #     #         #     # #   #     #   # #       #   #       #   #
 # ##### # ### # # # ##### ### ### ##### # # ### ##### # ### ### ################### # ### # ##### # # ######### # ##### ### # #
 #     # # #   # #   #   # #   #   #     # #   # #     #   #   #     #   #   #     #   # #   #   # # #     #   # #   # # #   # #
 ##### # # ### ### ##### # # ####### ##### # # # # ####### ### ##### # # # # # ### ##### ####### # ####### # # ##### # # # #####
     # # #   #   #       # # # #   # #     # #           #     #   # # #   # #   #                         # #   # # #         #
###### # ### ### ### ### # # # # # # # ##### ####### ### ####### ### # ##### ### ######### ##### # ############# # # ######### #
       #   # # #   #   # # #   # #   #   #     #   #   #       #     #   #   #   #   #   #     # #   #       #   # #   #   # # #
 ####### # # # # # # # # # ##### ####### # ### # # # # ### # ### ##### # # ### ### ### # ##### # ### # ##### # ### ### # # # # #
 # #     # # # # # # # # #   # #   # #     #   # # # #   # #           # #     #     # #   #   #   # #   # #   #     #   # #   #
 # # ####### # ### ### # ### # ### # # ######### # ####### ####### # ### # ##### ### # ##### ### # # ### # ##### ### ##### # ###
   # # #   # #     #   # # #   #   #       #     #     #   #     # # #   #     #   #   #     #   # # #   #         #       # # #
 ### # # # # ####### ### # ##### ### # ### # ######### # ### ### # # # ### # # ### ##### ######### # # ### ### # ########### # #
   #   # #   #       #   #     # #   #   #     #     # #   #   # # # # # # # #   #   # #       #   #   #     # #       #   # # #
 ####### ##### # ##### ####### # ####### ##### # # ### ### # ### # # # # # # ### ### # ####### # ### ### ### # ### ##### # # # #
       # #     #   #   #   #   #       #     #   #   #   # # #   # # # #   #   #   # #   #     # #       #   # #   #     #   # #
 ##### # ### ##### # ### # # ############### ####### ### # # # ### ### ##### ##### # ### # ##### ######### ### # ### ######### #
     # #   #     # #     #   #     # #     #       #   # #   # # #   #     #     #       #     #       # # #   # #   #       # #
#### # ### ##### # ####### ####### # # ### ####### # ### ##### # ### ##### ################### # ##### # # # ### # ### ### ### #
 #   #   #   # # #       #   #       # # #       # # #   #   # #   #   #   #   #         #     #     # # # #   # # #   # # #   #
 # # # ##### # # ####### # # # ####### # ####### # ### ##### # ### ### # ### # # ####### # ##### ##### # # ### # # # ### # # ###
 # # #   # # #         # # #   #   #   #     # #   #   # #   #   # #   # #   #   #   #   #   #     #   #   #   #   #   # #   # #
 # # ### # # ######### # ### ##### # ####### # ##### ### # ##### # # ### # ######### # ##### # ### # # ######### ##### # ##### #
   #   #   #   #   #   #   #       #     #   #       #   #   #   #   #   #   #   #   # #   # #   # # # #     #       #   #     #
###### ####### # # ####### ### # ##### ### ########### # ### # ####### # ### # # # # # ### # ##### # ### ### # # ### ### # #####
       #     #   # #     #   # #     #     #         # # #   #   #   # # #   # #   # # #   #   #   #     # # # #   #     # #   #
 ####### ### ##### # ### ### # ##### ############### # ### ##### # # # # # ######### # # ### # # ######### # # ### # ##### # # #
   #     #   #   # # #       # #   #               # #     #   # # # # #   #         # #   # # #           # #   # #         # #
## # ######### # # # ######### # # ### ### ##### ### # ##### # # # # ####### ##### ### ### ### ### # ####### ### # # ### ##### #
   #     #     #   #     #       #   #   #     #   # #       # #   #   #   #     # #     # #   #   #   #   # #   # #   # #     #
 ####### # ############# ########### # ####### ### # # ####### ####### ### ####### # ##### # ### # ##### # # # ### ### # #######
 #   #   #     #     #   #   #       # #     #   #   # #         #   #   #     #   # #     # #   # #   # #   #   # #   #       #
 # # # ####### # # # # ### # # ####### # ####### # ### # ##### # # # ### ##### # # # # ##### ### # # # ########### # ### ##### #
   #   #   #   # # # #     # # #       #     #   #     #   #   #   #   # #       # #   #     #   # # # #   #       #   # #     #
######## # # ### # # # ##### # ##### # ##### # ### ####### # ######### # # ####### ##### ### # ##### # # # ########### ### ### #
   #     #   #   # # # # #   # #   # #     # # # #   # #   #     #     # #   #   #   #   #   #   #   #   #   #         #   #   #
 # # ######### # # # # # # ### # # # ##### # # # ### # # ####### # ### # ##### # ### # # # ##### # ######### ### # ##### #######
 # # #   #     # # # # # #   #   # #   # # #   #     # #     #   # #   #       #   #   # #   #   #   #     #   # #     #       #
 # # ### ####### # # # # ### ##### ### # # ########### ##### ##### # ############# ##### ### ####### # ### ### # ##### ####### #
 # #   # #   #   # # # # #   # #   #   #     # #     # #   #   #   # #   #   # #   #   #   #         # # #     # #     #   # # #
 ##### # # # ##### # # # # ### # ########### # # ### # # # ### # ##### # # # # # ### # ####### ####### # ####### # # ### # # # #
 #     #   #   #   # #   # #   #     #     #   #   # #   #   # #     # # # #   # # # #   #   #     #   # #       # # #   # # # #
 # ########### # ### ##### # ####### # ### ######### ####### # ##### ### # ### # # # ### # # ##### # ### ######### ### ### # # #
 #         #   #   #   #   #   #   #   # #           #     # #   #   #   #   # # #   # # # # #   # # # # #   #   #     #   #   #
 ######### # ##### ### # ##### # # ##### ############# ### # ### # ### ####### # ##### # # ### # ### # # # # # # ####### ##### #
           #       #     #       #                     #         #             #         #     #     #     #   #         #     #
################################################################################################################################
