################################################################################################################################
################################################################################################################################
#           #   #   #                 #     #     #   #   #         #   # #   #       #     #         #   #   #             #   
# ### ####### # ### # # # ####### ### # ##### ### ### # # # ####### ### # # # ### ### # ### # ##### # # # ### # ### # ####### # 
#   # #   #   # #   # # # #       #   # #     # # #     # #   # #   #     # #   #   #   # #   #   # # # # #   # # # #         # 
##### # # # ### # ##### # # ####### # # ### ### # # ######### # # ### ##### ### ### ##### ##### ### # # # # ### # # ##### ##### 
#     # # # #   #       # # # #     # #     # # # #   #   # # #   #       # # # # #     #   #   #   #   #         #     #     # 
# ##### ### # ########### # # # ##### ####### # # # # # # # # # ### ##### # # # # ##### ### # ### ########### ######### # # ### 
#     #     #   #     #   # # #     #   #     # # # #   #   # #   # #   # # #   #     # #   # # # #   #     # #     #   # # #   
##### ######### # ### # ### # ##### ### ### ### # # ######### ### # # # # # # ### ### # # ### # # # # # ### # # ### # ##### # ##
#   #   # #   # # # #   #     # #   #     #     # #     #   #   # # # # # # #   #   # # #     # #   # #   # # #   # # #     #   
### ### # # # # # # ####### ### # ####### # ##### # ##### # ##### # # # ### ### ### ### # ##### ######### # ##### # # ##### ### 
#   #   #   # #   #   #         #       # # #     # #     #   #   #   # #   # #   # #   #       #         #     # # #   # #   # 
# ### ##### ######### ### # ### ####### # # # ##### # ##### # # ####### # ### ### # # ### ####### # ########### # # # # # ### # 
#   # #   #     #   #     # #       #   # # #     #   #     # #     #   #     #   # #   #   #     # #         #   # # # #     # 
### # # # ### # # # ####### ####### # ### # ##### # ### ########### # ######### ### ### # # # ##### # ####### ##### ### ####### 
# # #   #     # # # #           #   #   #       # #   # #       #   #         # #       # # #   #   #     #   #   #   # #     # 
# # ########### ### # ### # ### ####### ####### # ### # # ### # # ### ####### # # ####### ##### ######### # ### # ### ### ### # 
#             # #   #   # #   #     # # # #   # # #   # # #   # # #   #     #       #   #     #       #   # #   #   #     # # # 
# ### ####### # # ##### # # # ##### # # # # # # # # ### # # ##### # ### # ######### # # # # ######### # ##### ### ######### # # 
# #   #   #   # #       # # #     #   #   # # # # # #   # # #   # #     # #       #   #   #   #     #     #   #               # 
# # ### # # ### ######### # ##### ######### # # # # ##### ### # # # ####### ##### ####### ### # ### ####### ##### ############# 
# #     # #   #           # #   #   #   #   # # # #       #   #   # #       #   #   #   #   # # # # #   #   #   #     #     #   
# ########### ########### # # # ### # # # ### # # ####### # ####### # ####### # ### # # ### # # # # # # # ### # # ##### ### # ##
# #                       # # #     # # # # # # #               #           # #   #   #   # # #   #   # # #   # #   #     # #   
# # ######### # # # ####### ####### # # # # # # ######### ##### # # ####### # ### ####### # # ### ####### # ### # # # ##### ### 
# #     #     # # #   #   #   #     # # # # #   #         #   #   #       # #   # #     # # #     #       # #   # #   # #   #   
# ####### # ### # ### ### ### # ##### # # # ### ### ##### # # ##### ##### ####### # ### # # ####### ####### # ##### ### # ######
# #       # #   #   #     #   #   #   #   #         #   # # # #     #   #     #   #   #   #   #   # #       # #   #   #   #     
# # ##### ### ### # ####### # ##### ######### ####### # # # # # ### # # ##### # ### # ##### # ### # # ####### # # # # ##### ### 
# # #     #   #   #       # # #     # #   #   #   #   #   # # # #   # # #     #   # # #     #     # # #     # # # # # #     #   
### # ##### ### ##### ##### ### ##### # ### ### # # ####### # # # ### # ######### # # ####### ##### # # ##### # # ### ####### ##
#   #   #   # # #   # #     #   #   # #     #   # #   #   # #   #   # #           # #       # # #   # # #   #   #   #       # # 
# ##### # ### # # # # # ##### ##### # ### ### ### # # # # # ####### # ##################### # # # ### # # # ####### # ##### # # 
# #   # #   #   # #   #     # #   # #     #   # # # # # # #       # #     #   #       #   # #   #     #   # #       # #   #   # 
# # # ##### ##### ########### # # # # # ### ### # ### # # ####### # ##### # # # ##### # ### ############# # # ######### # # ### 
#   #     #   #   #   # #     # # #   #   #     # #   # # #     # #     #   # # #   #   #   #   #       # # # #       # # #     
####### # ### ### # # # # ##### # ############### # ##### # ### # ##### ##### # # # ##### ### # # ##### # # # # ##### # # # # ##
# #     #   #   #   #   #   #   # #               #       #   #   #       #   #   #       #   #   #   # # # # #     # # # # #   
# # ##### ##### ####### ### # ### # ############# ####################### # ############### ####### # # # # # ##### # # # # ### 
#   #   #     #       #   #   #   #   #         # #       #   #     #   # # #         #     #       # # # # #   #   #   # #   # 
##### # # ### ####### # ####### ### ### ####### ### ##### # # # ### # # # # # ####### # ####### ####### # # ### # ####### ### # 
#     #   #   #     # #   #   #     #   #     #   # #   #   # #   # # #   # #       # #   #   # #     # # #   #   #   #   #   # 
# # # ### # ### ### # # # # # ####### ### ### ### # # # ##### ##### # ### # ####### ##### ### # # ### # # ######### # # ####### 
# # #   # #       # # # # # #   #   #   #   #   #   # # #   # #     #   #         # #     #     #   # # #       #   #   #     # 
# # ### # ######### # # # ##### # ##### ### ######### # # # # # ########### ### ### # ##### ####### # # # ##### # ####### ### # 
# # #   # #         # # #       #   #   # # #     #   #   # # #     #     # # # #   #   #   #   #   #   # #     #   #   # #   # 
# # # ### # ######### # ######### # # ### # # ### # ######### ##### # ### # # # # ##### ### # # # ####### # ### ### # # # # ### 
# # # #   #         # # #         # # #   # #   # #           #   # # #   # #   #     #   # # #   #     # #   #   #   # # # #   
# ### # ############# # # ##### ##### # ### ### # ############# # # ### ### ######### ### # # ##### # # ##### ### ##### # # # ##
# #   #         #     #   #   # #     #     #   #             # #   #   #   #   #     # # #   #     # # #   #   #   # # # # # # 
### ######### ### ##### ### # ### ##### ##### ##### ##### # ### ##### ### ### # # ##### # # ### ### # # # # ####### # # ### # # 
#   # #     # #   #     #   # #   #     #   # # #   #   # #     # #   #     # #   #   # # # #   #   # #   #   #   #   #   # #   
# # # # ### ### ####### # ### # ####### # # # # # ### # ##### ### # ### # # # ##### ### # # # ##### # ####### # # ### ### # # ##
# # #   # #   #       # # #   #   #   # # #     #     # #   # #   # # # # # #   #     # # # # #   # # # #   # # #       #   #   
# ####### ### ####### ### ####### # # # # ############# # # # # # # # # # ##### # ### # # # ### # ### # # # # # ####### ##### # 
# #           # #   #     #   # #   #     #           # # # #   #       #       # #   # # #     # #   #   # # # #     #       # 
# # ########### # ######### # # ##### ##### ######### ### # ################# ### ##### # ####### # ### ### # # # ### ### ##### 
#   #   #   #     #   #   # # #       #     #   #   # #   #     #   #       #         # #   #       # # # #   # # # # #   #     
# ### # # # # ##### # # # ### # ####### ##### # # # # # ####### # # # ##### ### ##### # ### ######### # # ####### # # # ####### 
#     #   #   #   # # # # #   # #       #   # #   # #     #   #   # # #   #   #   # #   # #     #       #       # # #   # #   # 
# ############# # # # # # # ### # ####### # ####### ##### # # ##### # # # ### ### # ##### ##### ####### ### ### # # ##### # # # 
#       #       #   #   # #       #       # #   # # #   # # # #   # # # #     #   #     # #   #       #   # # #   #   #     # # 
######### ############### # ##### # ####### # # # # # # ### # # # # # ### ##### ####### # ### ####### ### # # ##### ### ####### 
#         #   #         # # #   # #     # #   # # # # #     #   #   #   #   #           #   # #     #   # # # #     #   #     # 
# ########### # # # ### # # # # ####### # ##### # # # ############# ### ### # ##### ####### # # ####### # # # # ##### ##### # # 
# #   #     #   # #   #     # #       # #     # # #   #       #       # # # # #   # #     # # #       # #   #     #   #   # #   
# ### # ### # ######### ### # ##### ### # ### # # ### # ##### # ### # # # # ### # # # # ### # ####### # ######### # ### # # ### 
#   # # #   # #       #   #   #     #   #   # # #     #   #   #   # # # #   #   # #   #     # #     # # #       # #     # # #   
# # # # ####### ##### # # ### # ##### ##### # # ##### ##### ####### ### # ### ### # ######### # ### # # # ##### # ####### # # ##
# # # #         # #   # #   # #   #   #     # # #   #   #   #   #   #   #   # # # #             #   # # #   #   #       #   #   
# # # ########### # ### ### # ### # ### ##### # # # # ### ### # # ### ##### # # # # ### # ########### # ### # ### ############# 
# # #     # #     #   # #   #   #   # # # #   # # #   #   #   #   #   # #   #   # # #   #           # #   # # #   #             
# # ##### # # ####### # # ####### ### # # # # # ##### # ########### ### # ####### # # ### ######### # ### # # # ### # ##### ### 
# #           #   #   # # #     #       #   # #     # #   #         # # #     #   # #   #       #   # # # # # #     # #     # # 
# ############# # ### # ### ### ### ####### ####### # ### # ######### # ##### # ####### # ### # # ### # # # # ######### ##### # 
#       #       #   #   #   # # #   #     # #   #   #   #   #   #       #   # # #     # #   # # # #   # # # #       #   # #   # 
### ##### ######### ### # ### # ### # ### ### # ####### ##### # # # ##### ### # ### # # ##### # # # ### # ######### # ### # ### 
# #     # # #     #     # #   #   # # # #     #   #   #       #   #       #   #   # #   #     # #   #   #     #   # # #   #     
# ##### # # # ### ##### # ### ### # # # ######### # # ######### ########### ##### ####### ### ##### # ####### ### # # # ####### 
# #     #   # # # #   # #     #   # # #     #     # #         # #       #   #   #     #   #   #   #         #   # # # #         
# # ### ##### # # # # # # ##### ### # # ##### ##### ######### ### ##### # ### ####### # ##### # # ####### ##### # # # ####### # 
# # #     # #   #   # # # #   #   # # #     #     # #       #         #       #     # # #     # # #     # #     # #   #   #   # 
# # # # # # ### ##### # # # # ### ### # ### ##### # # ##### # ################# # ### # ### ### # # ### # # ##### ##### # # ### 
#   # # # #   # # #   #   # # #   #   # #   #     # # # #   # #           #     #     #   # #   # # # # # # #   # #     #   # # 
####### # ### # # # ##### # # ##### ### # ### ##### # # # ##### ######### # ############# # # ### # # # # # ### # # ######### # 
#       #   # # # #     # # # #   # #   # #       # #   #     # #       #   #         #   # # # #   # # # #     # # #       #   
# # ####### # # # ##### # # # # # ### ### # ####### ### ##### # ####### ##### ####### ### ### # ##### # ######### # ##### ##### 
# #       #   # #     # # # # # #     #   # # #     # # #     #               #     #   # #   # #     #     #   #   #   #       
# ############# # ##### # # # # ####### ### # # ##### # ####################### ####### ### ### ##### ##### # # ##### # ### # # 
# #     #       #     # #   #   #     # #     #   #   # #         #   #   #       #   #   #   # #       #   # #     # #   # # # 
# # # ### ########### # # ####### ### # # ####### # # # # ####### # ### ### ##### # # ### ### # # ### ### ### ##### # ### ### ##
# # #   #     #   #   # # #       # # #   #     #   # # # # #G  # # #   #   #   #   #   # # # # #   # #   #   #   #     #   #   
# # ### ##### ### # # # # # ####### # ##### ### ##### # # # # # # # # ### ##### ######### # # # ### # # ### ##### ######### ### 
# #   #   #   #   # # # # #   #     #       #   # #   #   # # #   # #   # #       #     #   # #   # # # # #       #   #   #   # 
# ### ### # ### ##### # # ### ### ########### # # # ####### # ##### ### # ####### # ### ### # ### # # # # ####### # ### ##### # 
#   #   # #   #       # #   #   #   #     #   #   #   #   #   #         #   #     #   #     #   #   # #   #     # #   #   #   # 
# ##### # ### ### ##### ### ### ### # ### # ### ##### # # # ####### ####### # ####### ######### ##### ##### ##### ### ### # ### 
#       #   # #   #     # #   # #     #   #   #     # # # #       #       # # # #     #       # #     #   # #   # #     #   #   
# ####### ### # # # ##### ### # ####### # ### ####### # # ####### # ##### # # # # ##### ##### # # ### # ### # # # ##### ##### # 
# #     #   # # # # #       # # #     # #   #       # # #   #       #   # # #   # #   #   # # # # # # #       # #           # # 
### ### ### # ### # ####### # # # ### # ### ####### # # # ### ####### # # # ### # # # ### # # # # # # ##### ### ########### # # 
#   # # # # #     #     #   # #   #   #   # #       #   # #   #   #   # # #   #     #   # # # #   # # #     #             #   # 
# ### # # # ##### ##### # ### ##### ####### # ########### # ##### # ### ##### ### ##### # # # ##### # ##### # ##### # ### ##### 
#     #   #     #   #   # #     # #         # #   # #     # #   # #   # #   #     #   #   # #   #   #     # # #     # #     #   
##### ##### # # ### ##### # # # # ######### ### # # # ##### # # # ### # # ####### # # ##### ### # ####### ### # ##### ##### # # 
#   #       # #   #   #   # # #       #   #   # #   # #   #   # # # # #   #       # # #     #     #     #   # #     #     #   # 
# # ######### ####### # ### # ####### # # ### # ### # ### ##### # # # ##### # ##### # # ### # ### # ####### ####### ########### 
# #       #   #   #   #     # #       # # #   # #   #   #     # #   #       # #   # # #   #   #   # #     #   #       #   #     
### ##### # # # # # ######### # ##### # ### ### # ##### ##### # ### ##### ##### # ### ######### # # # ####### # ####### # # ### 
#   #       #   # #       #   # #   #     #     #     #   #   #           #     #     #         #       #   #   #       # #   # 
# ### ########### ####### # ### # # ##### ########### ### ### ##### # ### # ########### ############# ### ##### # ####### ### # 
#   #   #       #       #   # # # # #     #       # # # #           #   # #       #     #   #       #   #   #   #     #   #   # 
### ##### ##### ####### ##### # ### # ### ### ### # # # ####### ######### ####### # ##### # # ##### # # ### # ####### # ### ### 
#   #   #   # #       #       #   # #   # #   #     #   #       #         #   #   # #   # #   #     # #   # #       # #   #   # 
# ### # ### # ####### # # # ##### # ### # # ### ####### # ### # # ####### # ### ### # ### ########### ### # # # ### # ### ### # 
# # # #   # #       # # # # #   #   #   # # #   #   #   # #   # #       # #   #     # #   #       #     # # # #   # # # #   # # 
# # # ### # # ##### # # # # # # ##### ### # # ### # # ### ### # ####### ##### ####### # ### ##### ##### # # # ### ### # ##### # 
#   # # #   #     # # # # #   #   #   # #   #   # # #     #   #       #     #     # # #     #   #   #   # # #   #   #   #     # 
# ### # ##### ### # # ### ######### ### ####### # # ####### ######### ##### ##### # # ######### ### # ### # ####### ### ### ####
#   #   #       # # #   #     #     #   #     # # #   #   # #   #   #     #   #   #   #   #       # # #   #           #   #     
### ##### ##### # ##### ##### # ### # ### ##### # ### # ### # # # # ### # # ### ### ### # # ####### # ############# ##### ##### 
#   #     #   # # #   #   #   #   # # #   #     # #   # #   # # # #   # # #     # #     #   #       #   #         #     # #     
# ### ### # # ### # # ### # ##### ### # ### ##### ##### # ### # # ### # # ####### # ######### ######### # ########### # # # ####
# #     #S  # #   # # # #   #   #   # #   #   # # #   #   #   #   #   # #           # #   # #   #       #       #   # # # #     
# # ######### # ##### # ##### # ### # ### ### # # # # ### # ########### ##### # ##### # # # ### ##### # ####### # # # # # ##### 
#   #         #               #   #   #             #     #             #     #         #     #       #           #   # #       
################################################################################################################################
