################################################################################################################################
   #                       #     #   #               #   #           #       #   #     # #     #       #         #     #     # #
 ### ####### # ##### ##### # ### # # # # ##### ### # ### # ##### ### ####### # # # ### # # ### # ##### # ####### ### # # ### # #
 #   #   #   # #     # #   #   #   #   # #   #   # #     #     #   #         # # # #   #   #   # #   # #     #   #   # # #   # #
 # ### # # ### # ##### # ##### ######### ### ### # ####### ### ### ############# # # ####### ### # # # # ### # ### ### # # ### #
 # #   #   # # # #   #     #   #   #   #   #     #         #   #       #         # #   #   # # # # #   # #   #     # #   # #   #
 # # ####### # # # # # ##### ##### # ##### ####### ### ##### ####### # # # # ##### ### # # # # # # ####### ######### ##### # ###
   # #   #     #   # # # #   #   #       #   #   # # #   #   #     # #   # # #   # #   # #   #   #   #     #   # #   #     #   #
#### # # # ########### # # ### # ### ### ### ### # # ### # ### ### # ##### # # # # # ### ####### ##### ####### # # # # ####### #
   #   # # #     #   #   #   # #     #   #   #   # #     #     #   #     # # # #   # #   #     #   #   #         # #   #   #   #
 # ##### ### # ### # ### ### ######### # ##### ### ############# ##### # # # # ##### # ### ### ### # ### # ### ### ####### # ###
 #     #   # # #   # #     #           # #   #   #   #           #     # # # #   #   # #   # #   # # #   #   # #               #
 ##### # # # # # ### # ### ############# # # ### ### # # # ####### ####### # ### # ### # ### ### # # # ##### # # ############# #
   # # # #   # #   #   #   #   #   #     # #   #     # # #     #   #   #   # #   # #   #     #   #   # #     # # # #       # # #
## # # # ######### ##### ##### ### # ##### ### ####### # ##### # # # # # ##### ### # ######### ####### ####### # # # ##### # # #
   #   # # #       # #   #         # # #   # # #       #     # # # # # #     # # #   #   #     #   #   #     # # # #   #   #   #
 ### ### # # ####### # ### # ####### # # # # # # # ########### # # # # ##### # # ##### ### ##### # ### # ### ### # ##### ##### #
 #   # #   # #       # #   # #   #     # # # # # #   #         # # # #   #   # #   #       #     #     #   #     #   #   #     #
 # ### # ### ####### # ##### # # # ##### ### # # ##### ######### # ##### # ### ### # ######### ####### ### ####### # # ##### # #
 # #       #     #   #       # # #   #   #   # # #     #   #     #       #   # # # # #   #   #   #   # #           # #   #   # #
 # # ####### ### # # ####### # ##### # ### ### ### ##### # ####### ######### # # # # # ### # ### # ### # ########### ### # #####
 # # #     #  G# # #       # #   # # #     # #   #   #   #       #     #   #   #           #   # #   #   #       #     # #     #
 # ### ### # ### # ### ### # ### # # ####### ### ##### ######### # ##### # ##### ##### ####### # ### # ### ##### # ##### ##### #
 #   #   # #   # #   #   #     #   #       #   #       #       # #     # #           # #   #   #     # #   #   #   #     #   # #
 ### ### # ### # # # ##### ### ### ####### ### ######### ##### # # ### # ####### ### # # ### ########### ### ##### # ##### # # #
 # # #   # #   # # # # #   #                   #         #       #   #   # #   #   # # #     #         # #     #   #       # # #
 # # # ### ##### # # # # ### ##### ##### ##### ##### # ####### ########### # # ### # # ############### # # ### # ########### ###
 # #   # #       # #   #   #   #   #     #   #       # #                 # # #   # # #   #       #     # #   # # #   #     #   #
 # ##### ######### ######### # # ### ### # # ########### ##### ######### # # ### ### # ### ### # # ##### ### # # # # # # # ### #
 # # #       #       #     # # # # # #   # # #         # #   # #   #   # #   #       #     #   # # #   # #   #   # #   # #   # #
 # # # ####### ### # # ### ### # # # ### # # # ####### # # # # # # # ### ############# ##### ##### # # ### ####### ##### ##### #
   # # #   #   #   # #   # #   #   #   # # # #     # # # # #   # # #     #   #   #   #     #       # #     #     #     #       #
#### # # # # # # ######### # ######### ### # ##### # # ### # ### # ####### # # # ### # # # ############### # ### ##### #########
   # #   #   # #     # #   # #     #   #   # #     #       #     #     #   #   #   #   # #     #       # # #   # #   # #       #
 # # ######### ##### # # ### # ### ### # ### # ##### ####### ######### # ######### ##### ### # # ##### # # ### # # # # # # #####
 #   #         #   #   # #   #   #   # # # # #     # #     #   #   #   #     #   #   #     # # # #   # #     # #   #   # # #   #
 ########### # # # ##### ### ### ### ### # # ##### # # ### ### # # ####### ### # ### ##### # ### # # # # ##### ########### # # #
             # # # #   #   #   # #   #   #     #   # # #   #     # #       #   #   # #     #   # # #   #       #     #   #   # #
############## ### # ##### ##### # ### ####### # # ### # ######### # ####### ##### # # ####### # # ####### ##### ### # # # #####
         #         #     # #     # #   #     #   # #   # #   #     # #   #   #   # # #     #   # # #     # #   # # # # # #     #
 ### ### ### # ######### # # ##### # # # ### ##### # ### ### # ##### # # # ### # # # ##### # ### # # ### # ### # # # ### ##### #
   #   #     #       #   #   #   # # #   # # # #   # #   #   #   #   # #   #   # #   # #   #   # # #   # #   # # #   #   # #   #
## ### ##### ##### ### ####### # # # ##### # # # # # # ### ### ### ### ##### ######### # # ### # # ##### ### # # ##### ### # ###
   # # #   #     #   #   # #   #   # #   #   #   # # #     #       #   #             #   #   #   #     # #   # # #   #   #     #
 ### # # ##### # ### ### # # ####### # # ########### ####### ##### ################# ##### # ######### # # ### # # # ### ##### #
     # #       # # #     # # #     # # #           # #     #     # #       #               #         #   # # # #   # # #     # #
 ##### ######### # ####### # ### # ### # ######### # # ##### ### ### ##### ### ########### # ### # # ##### # # ##### # ##### # #
 #     #           #       #     #     # #   #               # # #   #   #   # #   #     # # # # # #       # #   #   #       # #
## ######### ############# ############### # # ####### ####### # # ##### ### # # # # ### ### # # # ######### ### # ######### # #
   #       # #   #       #     #     #   # # # #     #     #   #     #   #   # # #   #       #   #               #         #   #
 ### # ### # # # # ##### # ##### ### # # # # # # ### ### # ### ####### ### ### # ################# ### # ################# ### #
 #   # # # # # #   #   # # #   #   # # # # #   # #   #   #       #   #     #   #     #   # #     #   # #       #   #     #     #
 ##### # # # # ##### ### # # # ### # # # # ### # ########### ##### # ############### # # # # ##### # # ####### ### # ### ##### #
   #   #     # #           # #   # # # #   # # #       #   #   #   # #     #         # # #   #   # # #       #     #   #   # # #
 # # ########### ########### ### # ### ##### # ####### # # ##### ##### ### # ####### # # # ### # ### # ##### ### ##### # # # # #
 # # #         # #           # # #   # #     #     #   # #     #     # # # # #   #   # # #     #     #   # #   #       # #   # #
 # # # ####### # # ########### # ### # ##### ##### # ### ##### ##### # # # # # # ##### # ############# # # ### # ####### ##### #
 # #   #     #   #   #     #   #   #   #   #     # # #   #   #   # #   # # # # #   #   # #             #   # # #   #     #     #
## ##### ### ### ### # # ### ##### ### # # ##### # # ### # ##### # ##### # ### ### # ### ### # ##### ####### # ### # ### # #####
   #   #   #   # #   # # #   #   #   # # # #     # # #  S#   # # # #     #   # # #   #   #   # #   # #       # #   # #   # #   #
 ### # # # ### # # ### # # ### ##### ### # # ##### # # ##### # # # # ####### # # ##### ### # # # # # # ##### # ### # ##### # # #
 #   # # #   # # # #   # #   # #   #     # #       #   #       # #   #     #   #     # #   # #   # #   # #   #   # #   #   # # #
 # ### ##### # ### # ### ### # # # ####### # ########### ### ### # ### # ######### ### # # # ##### ##### # ##### ##### # ### ###
 #   #       #   # # #   #       # #       # #       #   #   #   # #   #     #   #   # # # #     #       #     #   #   #   #   #
 ### ########### # # # ### ### ##### ####### # ####### # # ### ### # ##### # ### ### # ### ##### # # ### ### ##### ####### ### #
 #   #         #   # #     #   #     #     # #   #     # #   # #   #   #   #         #   #     # # #   # #   #     #       # # #
 # ### ##### ############### # # ######### # ### # # ### ### # ### ### # ############### ##### # # ### # # ### ### # ####### # #
 #   # #     #   #         # # #       #   #   # # # #   #   #   #   # #                 #     # # # # # #   # #   #     #   # #
#### ### ### # ### ####### # # ####### # ##### # ### # ##### ### # # # ################### ####### # # ##### # # # ##### # ### #
     #   #       # # #   #   #   #   # #       #     # #           #   #           #       #   #   # #     # # # # #   # # #   #
 ##### # ####### # # # # # ### # # # # # ############# # ############# # ######### # # # # # # # ### # # ### # ### # # # # # ###
   #   # #     #   #   #   #   #   # # #             # #         #   # # # #   #   # # # #   # # #   # # #   #   #   # # #     #
## ##### # ### # ########### ####### # ############# # ########### # # # # # # # ### # ####### # # ### # # ##### ##### # ##### #
 #     # #   # # #     #   #   # #   # #           #   #       #   # #     # #   #   #       # # #   # # #     #   #   #   # # #
 ##### # ### # ### ### # # ### # # ### # # # ##### ### # ##### # ### # ##### ##### # ### ##### # ### ### ##### ### ####### # # #
 #     #   # # #   #     #   # #   # # # # #     #     # # #   # #   #   #   #   # # #   #   # #   #     #   #   #         # # #
 # ######### # # ########### ### ### # ### ####### ##### # # ##### ##### # ### # # # # ### # # ### ### ### # # ############# # #
 # # #     # # # #     #             #   # #     #   #   #   #     #     # #   #   # # #   # #   #   # #   # #             #   #
 # # # ### # # ### ### # ############### ### ### ##### ### ### ##### ##### ########### # ### ### ### # # ### ##### ### ### # ###
 # # # # # # #   # #         #   #   # #     # # #     #   #           # #       #     # # # #   #   # # #     #   # #   #   # #
 # # # # # ##### # # ######### # # # # ####### # # ##### ### # ##### # # ####### # ##### # # ##### ### # ##### # ### ### # ### #
 # # #   #       # # # #       #   #   #       # # #   # #   # #   # # #       # # #   # # #   #   # # #   # #   # #     #     #
 # # ### ########### # # ############### # # ### # # ### # ##### # # # ####### # # ### # # ### # ### # ### # ##### ######### ###
   #   #           #   #       #   #     # #   # # # #   #   #   # # #   #   # # #     #   # # # #       # #     #   #     #   #
###### ########### ### ####### # # # ##### ##### # # # ##### # ### # ### # # # # ########### # # # ##### # ##### # ### ### ### #
 #   # #   #     # #     #   # # #   #     #   #   # # #     # #   #   #   #   #     #     #   # # #   # #     # #   #   #   # #
 # ### # # # ### # # ### ### # # ########### # ##### # # ##### ####### ########### # # ### # ### ### # ####### # ### ### ##### #
   #   # #   #   # #   #           #   #   # #   #   # # #     #     #           # # # #   # #       # #   #   # #   #   #     #
 ### ### ######### ### ########### # # # # ### ### ### # # ##### ### ##### ##### # # ### ### ### ####### # # ### # ### ### ### #
       #   #     #   # #         #   #   #     #   #   # #     #   # #   # #     # #       # #   #   #   #   #       #     #   #
 ######### # ### ### # # ####### ####### ####### ### ### ### ### ### # # ### ##### ######### # # # # # ############# ### ##### #
           #   # # # # # #   #         #           # #     # #   #   # #   # #   #     #     # # # # # #         #       #   # #
 ############# # # # # # # # ### ##### # ########### # ##### # ### ### ### # # # ### ### ##### # ### # ######### # ####### # # #
 #     #     # #   # # # # #     #   #           #   #       #   #   #   # #   #   # #   #     #   # #       #   # #       # # #
 # ### # ### # ### # ### ######### # ### ######### ##### ####### ### ### # ####### # # ##### ### # # ####### ### # # ####### ###
 # # # # #   #   #       #     #   #     #       # #   # #     #   # #   # #     # # #     #   # # #   #   #   # # #     # #   #
 # # # # # ##### # ####### ### # ####### # ##### # # # # # ### ### # ##### # ##### ####### ### # # # ### # ### # # ##### # ### #
   # #   #   #   # #       # #   #     #       #   # # # # # #   # #       # #   #       # #   # #   #   # #   #   #     #   # #
#### ####### # ##### ##### # ### # ### ####### ##### # # # # ### # ######### # # ####### # # ######### ### # ####### ##### # # #
   # #     #   #   #     # # # # #   #   #     #     #   # #   # #   #     #   #   #   #   #             # # #   #   #     # # #
 # # ### # ### # # ##### ### # # ### ### ### ########### # ### # ### # ### ##### # # ####### ############# # ### # ### # ##### #
 # #     #     # #     #   # #   #   # #   # #           #   # #   # #   # #   # # #         #       #     #   #   #   # #     #
 # ### ######### ##### # # # ### # ### ### # ### ########### # ### # ### ### # # ######### # # ##### # ####### ##### ##### #####
 #     #       #   # # # #   #   #   # # # #     #       #   #     # #       # #           #   # #   #     #     #   #     #   #
 # ### # ##### # # # # ######### ### # # # # ##### ##### # ######### ######### ########### ##### # ####### # ##### # # ##### # #
 #   # #     # # # #       #   #   #   #     #     #   #   #       #   #     # #             # #   # #   # #       #   #     # #
 ##### ##### # # # # ##### # # ########### ### ##### # ##### ##### ### # ### # # ########### # ##### # # # ############# #######
   #       # # # # # #   #   #   #         #   #     # #       #       #   # # # # #         # #     # #       #               #
 # # ####### # ### # # # ####### # ####### # ####### # # # ### # # ####### # # # # # ##### ### # ##### ### ##### ### # ####### #
 # #     #   #     # # # #   # # # #   # # #       # #   # #   # #   #     # # #   # #     #   # #     #           # #     # # #
 # ##### # ######### # # # # # # # ### # # ####### ####### # # # ### # ##### # ##### ####### ### # ##### ######### # # ### # # #
 # #   # #       #   # #   # #   #   #           #   #   # # # #   # # #   # #     #       # #   # #     #     #   # #   # #   #
 ### # # ####### ##### ##### # ##### ##### ### # ### # # ### # ##### # ### # ##### ####### # # ### # # ### ### ##### ##### ### #
     # #       #       #   # # #     #   # #   # # #   #     # # #   # #   #         #   #     #   # #   #   #     #   #   #   #
 ##### # # ### ########### # # # ##### # # # ### # ########### # # ### # ########### # # ####### ####### ### ##### ### # ##### #
 #     # #   #   #   # #   # # #     # #   # #   #               #   #   #       #   # #       # #       #   #   #     # #   # #
 # ##### # # ##### # # # ### # ##### # ##### # ### ##### # ######### # ### ##### # ### ####### # # ####### ### # ####### ### # #
 #     # # #   #   #   #   # #       #     # #     #   # #     #   # # #   #   # # #   # #   #   #   #   # #   # #         # # #
###### # # ### # ######### # ####### ##### # ####### # # ##### # # # ### ### ### # ### # # # ####### # # # # ### ### # ### # # #
     # # #   #       #     #   #       #   #       # # #     #   # #   # #   #   #     #   #       #   # #   # #   # #   #   # #
 ### ### ### ######### ####### ####### # ########### # # # ####### ### # # ### ################### ##### ##### ### ########### #
 # # #   # #   #     #         #       #     #   #   #   #       #   #     #   # #   #           # #   #   #     #           # #
 # # # ### # ### ### ########### ##### ####### # # ########### # ####### ### ### # # # # ####### # # # ### # # ############# # #
   # #   # # #   #           #   #       #     #   #           # #     # #   #     #   # #   #   #   #   # # #   #     #     # #
#### ### # # # ############# ########### # # ####### ############# ### ### ############# # # # ######### # # ### # ### # ##### #
     #   # # #           # #     #   #   # # #     # #     #   #   #   #   #             # # # # #       #   #   # # # #   # # #
 ##### ### # ########### # ##### # # ##### # # ### ### ### # # # ### ### ### # ############# # # # ########### # # # # ### # # #
       #               #   #       #       # #   #     #     #   #       #   #               #                 # #   #     #   #
