################################################################################################################################
             #     #   #           #       #           #   #         #   #   #     #       # #           #   #       #         #
 ##### ##### # ### # # # ######### ##### # ####### ### ### ######### # # # # ##### # # ### # # ### ### # # # ####### # ####### #
 #   #     #     # # #   #     #   #   # #         # #   #   #       # # # #     # # # # # # # # # #   # # #       # #   #   # #
 ### ######### # ### ##### ### # ### # # ########### ### ### # ######### # ##### # # # # # # # # # ####### ####### # ### # # # #
     #   #   # # #   #   # #   #     # # #   #     #   # #   #   #   #   # #     # # # # #       #     #   #       #     # #   #
 ##### ### # # ### ### # ### # ######### # # ##### ### # # ##### # # # ### ####### # # # ####### ##### # ### ############# #####
         # # # #   #   #   # #           # #           # #         #     #       #   #   #       #   # #   # #   #       # #   #
 ####### # # # # ######### # # ########### ############# # ##### ############### ######### ##### # # ####### ### # ##### # ### #
     #   # # # #       #     # #       #           #   # # #   # #   #     #   # #   #     # #   # # #       #   #   # # # #   #
#### ##### # # ####### ####### # ##### # ########### # # # # # ### # # # # ### # # # # ##### # ### # # ####### ##### # # # # ###
   #     # #       # #         # # #         #       #   #   #     #   # #     #   # #   #     # # #   #     #   #   #   # #   #
 # ##### # ##### # # ########### # # ####### # ########### ############# ########### ### # ##### # ##### ##### # # ### ### ### #
 #     # #   #   #             # # #   #   # #   #   #   # #           # #         # # # #   #   # #   #   #   # # #   # # # # #
 ##### ##### # ############### # # ### # # ##### # # # ### ##### ### # # # ####### # # # ### # ### ### # # # ### ### ### # # # #
   # #       # #   #   #   # #   #       # #     # #           # #   # #   # #   #   #   #       #   #   #   # #         # #   #
## # ####### # # # # # # # # ##### ##### ### ################# # ########### # # ######### ### # ### # ####### ######### # # ###
 # # #       #   #   # # #         #   #   #               #   #             # #         #   # # #   # #           #   #       #
 # # # ##### ######### # ######### # # ### ############### # ### ##### ##### ########### # # ### # ### # ########### # ####### #
 # #   #             # # #   #   # # #     #     #       # # #     #   #   #             # #   # #   #       #     # # #     # #
 # ##### ########### # ### # # # # # ##### # ### # ### ### # # ##### ### # ####### ####### ### # ### # ##### # ### # # # ### ###
 #   #   #   #       # #   # # #   #   #   #   # #   # #   # # #   #   # # #     # # #   # #   # #   # #   # #   # # # #   #   #
 ### # ### # # ##### # # ### # ####### # ##### # ### # # ### # # # ### ### # ### # # # # # # ##### ### # # # ### # # # # ##### #
 #   #   # #   #     #   # # #       # #     # # # # #   #     # #   #     # #   # #   # # # #     #     # #   # #   #   #   # #
 # ##### ####### # # ##### # ######### ##### # # # # ####### ### ### # ##### # ### ##### # ### ##### ##### ### # ######### # # #
 # #   #   #     # #     # #   #       #   #   # # #   #   # #   # # #     # # # #   #   #     #     #   #   # #     #     # # #
 # ### ### ### ### ####### # # # ####### # ##### # ### # # # # ### # ####### # # # # # ### ##### ##### # ### # # ##### ####### #
 #     #   #   #     #     # # #   #   # #     # #       #   # #   # #     # # #   #         #   #     #   # # # #     #       #
 ####### ### ####### # ####### ### # # # ##### # # ######### # ### # # ### # # ########### # # ########### # ### # ##### #######
   #     #   #     # #   #   # #   # # # # #   #   #     #   #   # # # #   # # #     #   # #   #           # #   #       #     #
 # # ##### # # ### # ### # # # # ### # # # # ####### ### # ##### # # # # ### # # ### # # # ##### ########### # ########### ### #
 # # #     #   #   #   #   #   # #   #   # #     #   # #   #   # # # # #   # # #   # # # #           #   #   #       # #     # #
 # # # ######### ##### ######### # ####### ##### # ### # ### # # # # # ### # ##### # # # # ######### # # # ######### # # ##### #
 #   # #       # #   #         # # #   #     # # #   #   #   #   # # # #   #   #   #   # #         #   # #         # # # # #   #
 ##### # ##### ### # ########### # # # ##### # # ### ### # ####### # # # ##### # ####### # ####### ##### ### # ##### # # # # ###
     # #     # #   #       #     #   #     # # #   # #   #   #   # #   # #   # #     #   #       # #   # #   # #     #   #   # #
#### # ##### ### ######### # ############# # # ### # # # ### ### # ##### # # # ##### # ### ### ### # # # # ##### ##### ####### #
   # # #   #     #   #   # # #       #   # #   # #G# # #   #     #   #   # # #       #   #   # #   # # # #   #   #     #       #
 # # # # # ####### ### ### # # ### # # # # ### # # ### ### ####### ### ### # ########### ### # # ### ### ### # ####### ####### #
 # # #   #         #   #   # # #   # # # #   #   # #   # #       #     #   #   #     #   #   # #   #     # # #   #   #     #   #
 # # ####### # ##### ### ### # # # ### ##### # ### # ### ####### # ########### # ### # ### ### ### ##### # # ### # # ##### # # #
 # #   #   # # #   # #   #     # # #   #   # #     #   #     #   # #           # # # # #     #   # #   #   # #   # # #   # # # #
 ##### # ### # # # # # ### ##### ### ### # # # ####### # ### # ### # ########### # # # # ### ### # # # ##### # ##### # ### # # #
       #     #   #   # #   #   #   #     #   #   #   # #   #       # #           #   # #   # #   #   #     #   #         #   # #
############## ####### # ### # # # ############# # # # ######### ### # ####### ####### ##### # ########### ##### ####### ##### #
         #       #   # # #   # # #       #   #   # # # #       #       #   # # #       #     #   #     #     #   #     #     # #
## ##### ##### # ### # ### ### ######### # # # ### # # # ##### # ##### # # # # # ####### # ####### ### ##### # # # ### # ### # #
   #   #       #     #   #   #         # # # # #   #   # #     # #   # # # #   # # #   # # #       # # #   # # # # # # #   #   #
 ##### ######### ####### ### ######### # ### # ######### # ##### # # # # # ### # # # # # # # ####### # # # # # ### # # ### #####
 # #   #     #         #     # #     # #     #   #       #       # # # # # #   # #   #   # # # #   # # # # #   #   # #   #     #
 # # # # ### # ####### ####### # # # # # ####### # ######### ##### # ### # ##### ### ####### # # # # # # # # ### ### ### # ### #
 #   #   # #   #     # #     #   # # # #   #   # #   #       #     #   # # #     #   #     # #   #   # # # #   # # #     #   # #
 ######### ### # ### # ##### # ### ### ### # # # ### # ##### # ####### # # # ##### ### ### # # ####### # # ##### # ######### # #
 #   #   #   # #   #   #     #   #   #   #   # # #   #     # #   #   # # #   #       #   #   #       #   #       #           # #
 # # ### ### # ### ### # ####### ### ### # ### # # ####### # ### # # # # ####### ### ### ########### ############### ####### # #
 # #   #     #   # # # # #   #     # # # #   # #   #   #   #       # # #   #   # #   #   #       # #   #             #     # # #
 # ### # ##### ### # # # ### # ##### # # ##### ##### # ######### ### ##### # # ### ### ### ##### # ### # ##### ####### ### # # #
     # #   #   #   #   #   # #   #   # #     #     # #   #   #   #   #     # #     #   #   #   # # # # #     #   #     #   # # #
 ##### ### # # # ######### # ### # ### ##### ##### # ### # # # ### # # ####### ##### ### ##### # # # # ##### ### # ######### # #
 #     #     # #           #     #     #   # #     # #   # # # #   # #   #   # #     #   #     # #   #     # #   # #         # #
 # ########### ############# ############# # ####### # ### # ### ### # ### # ### ##### ### ### # ### ##### ### ### # ######### #
 # #     #   #             # #   # #       #         #     #   #   #   #   #     #   # #   #   # #     # #     # #   #    S    #
 # # ### # # ##### # ##### # # # # # ### ##################### ####### # ########### # ### # # ### ### # ####### ### # #########
 # # # #   #     # # #   # # # #   #   #                 #     #       # #         # #   # # # #   #                 # #     # #
## # # ######### ### # # ### # ####### ####### ####### # # ##### ##### # ##### ### # ### ### # # ### ##### ######### # # ### # #
   # # #     # #   #   #     #         #     #       # # #       #     #     #   #     # #   # # #   #   # #         # #   #   #
 ### # # ### # ### ##### ##### ######### ### ######### # ########### ####### # # # ### # # ### # # ### # # # ######### ### #####
 #   #   # #   # #     #               #   #           #     #     #     #   # # # #   #   # #   # #   # # # #       #         #
 # ### ### ##### ##### # ### ##### # # ### ################### ### ##### # ##### ### # ##### ##### # ### ### # ##### ######### #
 # # # # # #   #   # # #   #   # # # #   #     #           #   # # #   # # #   # #   #             #   #     # #     # #     # #
 # # # # # ### ### # # ### ### # # # ### ####### ######### # ### # # ### # ### ### ######### # ### ### ####### # ##### # ### # #
   # # # #   #     # # #   # # #   #   #     #   #     # # #   #   #     #   # #   #         # #   #   #   #   # #     # #   # #
 ### # # ### ### ### # # ### # ####### # ##### ### ### # # ### # ####### ### # # # # ##### ### # # # ##### # ### # ##### # #####
   #   #   #   #     # #     # # #   # # #     # #   #   # #   #       # #   #   # #     # #   # # # #   #   # #   #     #     #
 # # ### ##### ##### # ##### # # # # # # # ##### # # ##### ##### ##### # # ############# # # ### ### # # ##### # ### # ####### #
 # # #       #     # #     # # #   #   # # #   #   #     #   #   #   #   #           #   # #   # #   # #       # #   # #     # #
 # # # ##### ##### # ##### # # ######### # ### # ####### ### ##### # ### ########### # ### ##### # ### ### ##### # ##### ### # #
 # # # #   # #   #     # # # #       #   #     # #     #   #       # # # #   #   #   # #     #   #   # # #       #   #   #   # #
 ### # # # # # # ##### # # # ####### ########### ##### # # ######### # # # # # ### ### # ##### ##### # # ########### # ### ### #
     #   # #   #   #   # # #   #   #                 # # #     # #   # #   # # #   #   # #   #     #   # #         # #   #   # #
 ######### ####### # ### # ##### # ############# # # # # ### # # # ### ### ### # ####### # # ######### # # ######### ### ### # #
           # #   #       #       #     #         # # #   #   # # #   #         #       # # #   #     #     #     #   #   #   # #
 ### ####### # # ##### ############### # ######### # ######### # ### ##### ########### # # ### # ### ####### ### # ### ####### #
   #         # #     # #     #         # #   #     #       #   #   # #   #   #       # # # # # #   # #       #   #   # #       #
 # ####### ### ##### ### ### # ######### # # # ### ####### # ##### # # # ### # ##### # ### # # ### # # ##### # # ### # # #######
 #       #   # #   #     #   # #         # #   #     #   # #       # # # #   #     # #   # # #   # #   #   # # #   #   # #     #
 ####### ### # # ########### # ##### ### # ######### # # # # ####### # # # # ##### # ### # # ### # ##### # ### ######### ### ###
 #     # #   # #   #   #   # #     # #   #     #   # # #   #   #     # # # #     # #   #   #     #   # # #   #         #   #   #
 # ### # ##### ### # ### # ##### # ### ####### # # ### ##### # # ##### # ####### # ######### ### ### # # ### ######### ### ### #
   # # # #   #   # # #   #     # #   #       # # #   # #   # # # #     #   #     #       #   #   # # # # #   #     #     #   # #
 ### # # # # ### # # # ####### ##### ####### # # ### # # # # # # # ####### # ### ####### # ### # # # # # ##### ### # ####### # #
   #   #   #     #   #       #     # #   #   # #   #   # #   # #   #     #   #             #   #   # # #     # # # #   #     # #
 ################# ####### # ##### # # # # ####### ### ############# ### ##### ############# ##### # # ##### # # # ### # ##### #
         #     #   #     # # #   #   # # # #     #   # #   #     #     #     # #   #         #   #   # #     # # #   # # #     #
 ####### ### ### ### ### ### # ####### ### ##### # # # # # # # ### ####### # # ### # ######### # ### # # ##### # ### ### # #####
 #     #   # #   # #   #     #           #       # # # # # # #       #   # # # #   #   #       #   #   #   #   #   #     #     #
 # ### ### # # ### ### ################# ######### # ### # # ######### # ### # # ####### ######### # ##### # ### ############# #
   # #   # # #   # # # #       #             #   # #     #   #   #   # # #   #   #     #   # #     #       #   #   #   #     # #
 ### ### # # ### # # # # # # # # ##### ##### # ### ########### # # # # # # ####### ### ### # # ##### ######### ### # # # # ### #
     #   # #   # #   # # # # #   #   # #   # #       #       # # # # # # #   #   #   #   # #   #       #     #   #   #   #     #
 # # # ### ### # ### # ### # ####### # # # # ##### # # # ### # ### # # # # ### # ### ##### # ##### ### # # ##### # ########### #
 # # #   # #         #   # #       #   # # #   #   #   #   # #     #   # # #   #   # #   # # #   #   #   # #     # #         # #
 # ##### # # ####### ### ######### ##### # # # # ### ##### ############# ### ##### # # # ### # # # # ####### ##### # ####### # #
 # #   # # #   #   #   #         # #   # # # #   #       #       #     #     #         #     # # # #   #   #   #   # # #   # # #
 # # # # # ##### # # ########### # # # # # # ##### ######### ### # ### ####### ##### ########### # ### # # ### # ### # # # # # #
 #   # # #     # # #         #   #   # # # # #     # #     #   # # # #       # #   #             #   # # #   # #   #   # #   # #
###### # ##### ### # ### # # # ### ### # ### # ### # # ####### ### # ####### # # # ####### # # # ### # # ### # # # ##### ##### #
       #     #     #   # # # # #   #   #   # #   #   #         #   #   # #   #   #   #     # # #     #     # # # #     #   # # #
 ####### # # ######### # ### # ##### ##### # # # ############# # ### # # # ### ##### ####### # # ######### # # # ##### ### # # #
       # # #       #   #   # #     #     #   # #     #     #   #     # #   #       #   #     # # #     #   #   # #       # # # #
 ####### # # ####### ##### ####### ######### ######### ### # ######### ##### ######### ####### ### ### # # ##### # ### # # # # #
 #       # #             #       #   #     # #         # # # #   #     #     #     #   #     #   # # # # # #   # #   # # # #   #
 # ############# ########### # # ### # ### ### ######### # # # # # ##### # ### ### ##### ### # # # # # # # ### # ### ### # #####
 # # #         #   #         # #   #   # #     #     #   # #   # #   #   # #   # #     #   # # #   # # # #         #   # #     #
## # # ### ### ##### ######### # # ##### ########### # ### # ### ### ### ### # # ##### ### # # ##### # # ####### # ### ####### #
   # # #   # #   #   #     #   # #         #       # #   # # #     #   # #   # #   #       # #     #   #       # #   #     #   #
 ### # # ### ### # ### ### # # # ##### ### # # ### # # ### # # ####### # # ####### ##### ### ############# ### ##### ### ### ###
 #   # # #   #   #   # #   # # #     #   #   #   #       # # #     # # # #       #     # #   #     #     #   # #   #   #   #   #
 # ### # # # # ##### # ##### ####### # # ####### # ##### # # ##### # # # ##### ####### # # ### ### # ### ### # # # ### ### ### #
 #     # # #     #   #     # #   #   # #     #   # #   # # #   # #   #       #     #   # #   # #   # #   #   # # #   #   #     #
 ##### # ####### # ####### # # ### ### ####### ##### # ### # # # ##### ##### ##### # ### ### # # ### ######### # ### ####### ###
     # #       #   #     # #   #   # #   #   #       # #   # #   #   # #   #     #   # #   #   #   #           # # #       #   #
#### # ####### ##### ### # # ### ### ### # # ##### ### # ### # ### # ### # ##### ##### ### ####### ####### ##### # ####### ### #
   # # #   #   #     #   # # #   # #     # # #   #   # # #   # #   #     # #         #       #     #     # #   # #         # # #
 ### # # # # ### ##### ### ### ### ##### # ### # ##### # ### ### ######### # ####### ####### # ##### ### ### # # # ######### # #
     # # #   #   #   #   #     # #       #     #     # #   #   # #       # # #     # #   #   #     #   #     # # #   #     # # #
######## ##### ### # ### ####### ####### ########### ##### ### # ####### # # # ### # # ### # ##### ### ####### ##### # ### # # #
         #         #   #                           #       #   #         #   #   #         #     #           #       #   #     #
