################################################################################################################################
################################################################################################################################
#   #   #       #         #       #   #   #   #     #   #       #         #   #               # #   #     #         #     #   # 
# # # # # ##### # # ### # # ##### # # # ### # ### # ### # # ##### ####### # # ### ### # # ### # # # # ### # ######### ### # # # 
# # # # # #       #   # #   # #   # # #   # #     # #   # # #     #     # # # #   #   # #   # #   # # # # #           #   # # # 
### # ### ### ##### # # ##### # ### # ### # ####### # ### # # ##### ### ### # # # # ####### # # ##### # # ########### ##### # # 
#   #     #   #   # # # #   # #     #   #   #       #     #         #   #   # # # #   #   # # # #   # # #   #   #   #     # #   
# ######### ### # ### # ### # # ##### ####### ##################### ##### ### # # ### # # ### # # # # # ### # # # # # ### # ####
# #         #   #     #     #   #     #     # #           #       #   # # # #   # #   # #   #     # #   # # # # # # #   # #   # 
# # ### # ### ##### ############# ### # ##### # ######### # ##### ### # # # # ##### ### ### ##### # ##### # ### ### # # # ### # 
#   #   #   #     # #   #       #   # # #     # # #     #   # #   #   # #   # #     #   #       # #       #   # #     # #   # # 
##### # ### ##### ### ### ##### ### # # # ##### # # ### ##### # ### ### ##### # ##### ######### # ### ####### # # ##### ##### # 
#     #   #     #   # #   #     #   # # #   # # # #   # #   #   # #         # #     #       # # # #   #       #   #   #     #   
# ##### # ### ##### # # ### ##### ### # ### # # # ### # # # ##### ######### # ##### ####### # # # # ### ####### ### # # ### ### 
#   #   #   #     # # # #   #   # #             #     # # #         # #   # #     # #     #   # # #   #       # #   # #   #     
### ##### # ##### # # # # ### # # ########### ######### ######### # # # ### ### # # ##### ##### # ########### # # ### ### ######
# #   #   #   #   #   # #   # # # #   #     #   #     # #       # #   #   #     # #       #   # #               # # # #         
# ### # ##### # # ##### ##### # ### # # ### # ### ### # # ##### # ### ### ####### ######### # # ####### ####### # # # ##########
# #   #   #   # #     #       #   # # #   # # #   # # #   #     # # #                     # # #   #   # #   #   # # #           
# # ##### # ### ##### ########### # # ### # # # ### # ######### # # # ####### # # ######### # ### # # ### # # ### # ########### 
#   #     #   #   # #   #         # #   # #   # # #   #       # # # #   #     # #   # #     # # #   #     # #   # #     #       
############# ### # # # # ######### ### # # ### # ##### ##### # # # ### # ### # ### # # ##### # ########### # ### # ### ########
#         #   #   # # # # #         #     # #         # #   # # #   #   # #   #   #   # #   # # #     #   #   #   #   #         
# ####### # # # ### ### # ### ####### ##### # ######### # ### # ##### # # ####### ##### # # # # # ### # ##### # ### # ######### 
#   #   # # # # # #     # #   #   #   #   #     #       #     #       # #     #   #   # # # # # # #   #   #   # #   # #     #   
### ### # # # # # # ##### # ### # # ### # ##### # ##################### ##### # ### # # # # # # # # ##### # ### ##### # ### ### 
# #     # # # # # # #     #   # # #   # #   #   #   #     #                 # # #   # # # #   #   #     #     #       #   #     
# ##### ### ### # # # ######### # ### # ### # ##### # ### ####### # ##### # # # # ### # # ############# # ### ####### ### ##### 
#     #     #   #   #   #     # # #   #   # # #   # #   #     #   #   #   # # #   #   # # #   #       # # #   #       # #   #   
# ### ##### # # ####### # ### # # ####### # # # # # ### ##### ####### # ##### ##### # # # ### # ##### # # # # # # ##### ### # ##
# #     #   # # #   #     # #   #         # # # # #   # #     #     # # #         # # # #   # #     #     # #   #         # # # 
### ### # # # ### # ####### ####### ####### # # # ### # # ##### ### ### # ####### # # # ### # # ####### ### ############### # # 
#   #     # # #   # #   # # #   #   #   # #     #     # # #   # #   #   # #     # # # #   #   # # #     #   #         #     # # 
# ########### # ### # # # # # # # ### # # ### ######### # ### # ##### ### ### # # # ##### ##### # # ##### ### ####### # ##### # 
#   #         # # # # # # # # # # #   # #     #         # #   #       #   #   #   #   # #   #     # #   #   #     #   #   #     
##### ####### # # # # # # # # # # # ### ##### # ######### # ########### ### ##### ### # ### ### ### # ##### ##### # ##### ##### 
#     #     # #   #   # # #   #   #   #     # # #       #   #       #   # # #       # # # #   # # # #   # #     # #   # #     # 
# ##### ##### ######### # ##### ########### # # # ########### ##### # ### # ####### # # # ### # # # ### # ##### # ### # ####### 
#   #   #       #       #   #   #     #     #     #   #   # # #   #   # # #    G#   #       # #   #           # #   # #   #   # 
### # ### ####### ######### # ### ### # ##### ### # # # # # # # # ##### # ##### # ######### # ############# # # ### # ### # # # 
#   #   #   #     #       #   #   #   # #       # # #   # #   # #       #   #   #   #   #   # #   #     #   # #   # #   # # # # 
# ##### ### # ######### # # ### ### # # # ##### # # ##### ##### # ######### # ##### # # ### # # # # ### ##### ### ##### # # # # 
# #         # #         # # #   #   # # #     # # #     #   # # #         #   #     # #   # #   # #   #     #   #         # # # 
# ########### # ######### ### ### ##### # ### # # ##### ### # # ############### # ### ### ####### ### ##### ##### ######### # # 
#     #     # # #       #   # # #     # #   # # # #     # # #       #           #   # # #       # #   #   #     # #         # # 
##### # ### # # # ######### # # ##### # ### # # ### ##### # ####### # ### ##### ##### # ####### # # ##### ##### ### ######### # 
#     # #   #   # #   #   # # #     #   # # # # #   #     #   #   # #   # #     # #   #       # #   #         #   # #     # #   
# ### # # # ##### # # # # # # ##### ##### # # # # ### ####### ### # ### ### ##### # ##### ### # ##### ####### ### # # ### # ### 
#   # # # #       # # # # # # #           # # # # # # #   #   #         #   #     #     #   #   #     #     #   #   #   #   # # 
# # ### # ####### ### # ### # # ##### ##### # ### # # # # # ### ######### ### ######### ### ######### ##### ### ##### # # ### # 
# #     #   #     #   #             #       #   #   #   # # #       #     #   # #       #   #       #       #       # # #   # # 
# ######### # ##### ####### ####### ########### ### ##### # # ##### # ##### ### # ####### ### ##### ##### ### ##### # # ### # # 
#     #   # #       #     #   #   #   # #   #   #   #   #   # #     # #     # # # #       #   #   #     # # # #   # # #   #   # 
### # # # # ### ##### ### # # # # ### # # # # ### ##### ##### # ##### # ##### # # ### ####### # # ##### # # # ### # # ### # ### 
#   # # # #   # #   # #   # #   # #   #   #   #   #         # # # #   #     #   #   #         # # #     #   #   #   # # # #   # 
# ##### # ### ### # # ##### ##### # ########### ### ##### # # # # # ####### # ##### ########### ### ##### ##### # ### # # ##### 
# #     #   #     # #         #   #         #   #   #   # #   # # #       #S#   #   #         #   # #   # #     # # #   #       
# # ####### ####### ######### # ########### # ### ##### # ##### # ### ##### ### # ######### ##### # # # # # ##### # ### ####### 
# # #   #     #   #     #   # # #   #     # # #       # #   #   #   # #   # #   # #         #   # # # # # # #                 # 
# # # ### # ### # ##### # # # ### # # ### # # # # ### # ### # ##### # # # # # ### # ######### # # # ### ### ########### ##### # 
#     #   # #   #     # # #   #   #   # # # # # #   #   #   #       #   #     #   #           #   # #   #   #     #   # #   # # 
####### ### # ### # ### # ##### ####### # ### # ######### # ################### ############# ##### # ### # # ### # # # # # # ##
#   #   #       # # #   # #   # #     # #     # # #     # #               #     #       #   #   #   #     # # # #   # # # # #   
# # # ########### # # ### # # # # # # # ####### # # ### # ####### # ### ### ##### ##### # # ### # ####### ### # ##### # # # ### 
# #   # #       # # #   #   #   # # #             # #   # #     # #   #   #   #   #     # #   # #     #   #   #   #   # # #   # 
# ##### # ##### # ##### ########### ############### ##### ##### # ### # # ### ##### ######### # ##### ##### ##### # ### # ### ##
# #       #     # #     #       #   #   #         #     #   #     #   # #   #     #       #         # #   #       #     #   #   
# ######### ##### # ##### ####### # # # # ####### ##### # # ####### ############# ####### # ######### # # ############# ####### 
# #   #   #       # #   # #       # # #   #     #       # #   #   # #         #   #         #   #   #   #     #   #     # #     
# # # # # ####### # # # # # ####### # ##### ############# ### # # # # ##### # # ### ######### # # # ######### ### # ##### # ####
# # #   #   #     # # # #   #       # #       #   #       #   # # #   #     # #   # #   #     #   #         #   #     # # #     
# # ####### ####### # # ##### # ##### # ##### # # ######### ### # ########### ### # # # # ############# # # ### ##### # # ##### 
# #   #   #       # # #       # #     # #   #   #   #     #   # #     #     #   # #   # #   #     #     # # # # #   #         # 
# ### ### ####### # # ########### ##### ### ####### # ### # # # ##### # ### ### # # ####### # ### # ####### # # # # # ######### 
#   #           # # #           #     #   #       #     # # #   #     #   # #   # #       # #   # #   #   #   #   # #         # 
### ########### ### ######### # ##### ### # ##### ####### ####### ### ### # ##### # ####### ##### ### # # ######### # ####### # 
#           #   #   #   #   # # #   #   #   #     #   #   #       #   #   #       #   #   #     # # #   # #       # # # #   #   
# ######### # ### ### # # # # # # # ### ##### ##### # # ### ####### # # ############# # # ##### # # ##### # ##### # # # # # ### 
#   #     # #     # # #   # # #   # #   # #   #   # #   #   #   # # # #   #     #       #       #       # # #     # # # # #   # 
# # # ### ######### # ##### ######### ### # ##### # ####### # # # # ##### ##### ######### ########### # # # # ##### # # # ### # 
# #   # #       #     # #   #       # # #   #     #   #     # #   #     #       #       # #         # # # # #   #   #   # #   # 
# ##### ### ##### ##### # ### ##### # # # ### ####### ### ### ####### # ######### ##### # ####### # ### # # ### # ### ### # ### 
#         #       #   # #     #   #   #   #     #   #   #   #         #         # #   # # #       # #   #   #   # #       # # # 
### ##### ######### ### ######### ##### ### ##### # ### ### ##### ############### # # # # # # ##### # ####### ### # ####### # # 
#   #       #       #   #   #     #     #   #   # #   # #   #   # #       #       # # # #   # #   #       # #       #     # #   
# ### ### ### ### ### ##### # ##### ##### ### # # ### # ##### # ### ##### # ####### # # ####### # # ##### # ####### ##### # ### 
#   #   #     #   #   #     #     #   #       # # # # #       #     #     # #   #   # # #   #   # # #   #     #   # #     #   # 
### # # # ##### ### ####### ##### ### # ####### # # # ############### ####### # # ### # # # # ### # # # ####### # # # ####### # 
#   # # #     # #   # #     #     #   #       # # # #       #       #         # # # # # # # # # #   # # #   #   # # # #       # 
# ##### # # ### # ### # ##### ##### ######### # # # # # # # # ##### ####### ### # # # # # # # # # ### # # # # ### ### # ### ### 
# #     # #   # #   # #   #   #   # #   #     #     # # # #   #   #   #   #   # #   # # # #   # # #   # # # #   #   # #   # #   
# # # ####### # ### # ### # ### # # # # # ##### ##### # ####### # # ### # ### # # ### # # ##### # # ### # # # ##### # ##### # ##
# # # #   #   #     # #   #   # #     #   #   #   #   # #     # #   #   # #   #   #   #   #     # # # #   #   #     # #     #   
# ### # # ### ####### # ##### # # ######### # ##### ##### ### # ### # ### ######### ####### ##### # # ######### ##### # ####### 
# #   # #   #             #   # #     #   # #     #       # # #   # # #   #         #       #     #   #     # # #       #   # # 
# # ### ### ##### ######### ##### ### # # # ##### ######### # ### ### # ### ########### ##### ####### # ### # # ######### # # # 
# # # # # #     # #   #   # #   #   #   #     #   #       #   #   #   # #   #           #   #       # # # # # #           # #   
# # # # # ##### ### # # # # # # ### ######### # ##### ### ##### # # ### # ### ##### ##### # # ####### # # # # ############# ### 
# #   # # #     #   # # #   # #   #   #     # #   #   #         # #   # # #     #   #     #   #       # # # #         #     #   
# # ### # # ##### ### # ##### ### ### # ### ##### # ##### ##### # ##### # # ### ##### ######### ####### # # ######### # ##### ##
# # #   # #     #   # #   # # # # #   # # #       #     #   #   # #   # # #   #     #     #   # #     # # #       #   # #   #   
# ### ### ##### ### # ### # # # # # ### # ### ######### ### # ##### # # # ### ##### ##### ### # # ##### # ### ##### ### # # ####
#     #   #   # #   #     # #   # #   # #     #     #     # #     # #   #   # #   #     #   # # #     # #   #     #   #   #     
# ####### # # # # ######### ##### # # # ####### ### # ##### ##### # ####### # # # ### # ### # # ##### # # ####### ### ######### 
#           # # #   #   #         # # #         #   # #   # #   # #         # # #     #   #   # #     # #       #     #   # #   
### ### # ### # ### # # # ######### # # ######### ### ### # ### # ########### # # ####### # ### # ##### # ##### ####### # # # ##
#   #   # #   #   # # # # #     #   # #         # #       #     #         #   # # #     # # #   #   #         #       # #   # # 
# ####### # ##### # # # # # ### # ### # ####### # # # ############### ##### # # # # ### ### # ##### # ####### # ####### ##### # 
#       # #     #   # # # # #     #   #   #   # # # #     #       # #       # # # # # #   # # #   # # # #   # #       # #     # 
####### ####### ##### # # ### ########### # ### # ####### # ### # # ######### # ### # ### # # ### # # # # # ######### # ### ### 
#     #       #       # # #   #     #     #     #   #     # #   #   #       # #     #   #   #   # # #   # #   #     # #   # #   
# ########### # # # ##### # ### ### # ############# # ##### # ### ### # # ### # ####### ####### # # # ### ### # ##### ### # # ##
#   #   #     # # #       #     #   #   #           #       # #       # # #   #   #   # #     # #     #   # # #     #   #   #   
### # ### ##### # ######### ##### ####### ##### ############# # ####### ### ### # ### # ### ### ##### # ### # ##### # ######### 
#   #     #     #               #     #   #     #   #     #   #     #   #   # # # #   #     #   #   # #     #   # # #           
# ######### # # ############### ##### # ### # ### # # ##### ####### # # # ### # # # ### ##### ### # # ##### ### # # ### # ### ##
#           # # # #   #         #   # # #   # #   # #       #       # # # #     #   #   #   #   # # #     #   # #   #   #   #   
##### ##### # # # # # # # ####### # # # ####### ### ######### # ##### # # ####### ### ### # ### ### # ####### # ### # ### ##### 
#     #   # # # #   #   # #     # # # #       #   # #   #     #     # # #     #         # #   #   #   #   #   #   #   #   #   # 
# ##### # # # # ######### # ### ### # ### ### ##### # ### ########### # ##### # ######### # ##### ### # # # ##### ##### ### # # 
# #     # # # #   #       # #   #   #   #   #   #   # #   #   #       #     # #       #   #     # #   # # # #   #   #   #   # # 
# # ####### ##### # ### # # ##### ##### ######### ### # # # # # ####### ### # ##### ### ####### # # ### # # # ##### # ### ##### 
# # #     #     # #   # # #   # #     #         # # # # # # #   #     # #   #     # #   #     #   #     # # # #     #   # #     
# # # ### # # # # ### # ##### # # ### ######### # # # # # # ##### ### # # ####### # # ####### ##### ##### # # # ####### # ### # 
# #   # # # # # #   # #     # # #   #         #   #     # #   #   # #   #       # # # #       #     #   # #   # #     # #   # # 
# ##### # ### # ### ######### # ### ######################### # ### ########### # ### # ####### ##### # # ### # # ### # ### # # 
#       #     #   #           #                               #     #           #                     # #     #   #   #   #   # 
################################################################################################################################
