################################################################################################################################
#   #     #   #       #   #   #   #   # #     #       #   #         #   #   #   #       #           #         # #   #   #   #   
### ##### # # # ##### # # # ### # # # # # ### # ##### ### # ### ##### ### # ### # ### # ### ### # # # # ##### # # # # # ### # # 
#   #   #   # #     # # #   #   #   #   # # #   # #   #   # #   #     #   #   #   #   #     #   # #   # #   # #   #   #     # # 
# ### # # ######### # ##### # ########### # ##### # ### ### ##### ##### ##### ##### ### ##### # # ### # # # # # ############### 
#   # # # #   #     #     # # #   #       #     #   # # #   #   # #     #   #       #   #     # # # # # # #   #     #           
### ### # # # # ######### # # # # # ####### ### # ### # ### # # # ##### # ######### ##### ### ### # # # # ######### ### ### # ##
# #       # # # #     #     #   # # #     #   # #   #       # #   #     #           #   # # # #   #   # #     #   #   # #   # # 
# ##### ### ### # ### # ######### # # ### # # # ### ####### # ##### ############### # # # # # # ##### # ##### # ##### # ##### # 
#       #   #   #   # #   #       #   #   # # # # #         #       # #             # # # #   # # #   #   #   # #       #   #   
# ####### ### ##### ##### # ####### ### ##### # # ######### ######### # ####### # # # ### ##### # # ##### ### # # ####### # ####
#     # #     #   #     # # #   #     # #     #   #     # # #       #   #       # # #     #   # #   #   #   # # #   #   # # #   
##### # ####### # ##### # # # # ####### ######### ### # # # ####### ##### ##### # ######### # # ##### # ### # # ### # # ### # # 
#   #   #       #       # #   #       #   #     #     # #                 #     # #   #   # # # #     #     # #   # # #     # # 
# # ### # ##### ######### ########### ### ##### ####### # ########### # ### ### # # # ### # # # # ########### ### # # ####### ##
# #     # # #   #         #         # #   #   #           #           #   #   # #   #   # # # # #   #       #   #   # #     #   
# ####### # # # # ######### # # ### # # ### # # # ######### ############# ### ######### # # ### ### # ##### ### ### # ##### ### 
# #       #   # # #         # # # # # # #   #   # #       # #       #   # #   #     # # # #   # #   # #   # #   #           #   
# # ########### # # ######### # # # # # # # ##### # ##### # # ### ### # # ##### ### # # # ### # # ##### # # # ### # ######### ##
# # #   #   #   #   # #       # #   #   # # #   # #   #   # #   # #   # #       # #   #   #   # #       # #     # # #   #   # # 
# # # # # # ######### # # # # # ### ##### # # # # ### # ### ### # # ### ######### ######### ### ######### ##### # # # # # # # # 
# # # #   #    G    #   # # # #   #       # # # #   # #   # #   #     #           #       #     #   #   # #   #   #   #   #   # 
# # # ############# ##### # ##### ########### # ### # ### # ##### ########### # ### # ########### # ### # # # ##### ####### ### 
#   # #     #       #     #     # #       #   #   # # #   # #   #   #       # # #   # #       #   #   #   # # #   # #     #     
# ### # ##### ####### # # ### # # # ##### # ##### ### # ### # # ### # ##### # # # ### # # ### # ##### ##### # # # # # ### # # ##
#   #   #     #   #   # # # # # # #     # #     # #   # #   # # #   #   #     # # #   # #   # # #     #     #   #   # #   # #   
# # ##### ##### # ##### # # # ### ### ### ##### # # ### # # # # # ##### ####### # # ### ### # # ####### ########### # ##### # # 
# #     #       #     # #   #   #     #       # # #   # # # # # #     # #   #   # #     #   # #     #   #           #   #   # # 
# ##### ############# # ##### # ####### ##### # ##### # ### ### # ### # # # # ### ####### ### ##### ### ####### ### ### ####### 
# #   #     #   #       #   # #       #   # # #   #   #     #   #   # # # # # #   #   #   #       # #   #   #   #     #   #     
# # # ##### # ### ####### # # # # # ##### # # ### # ######### ### # ### ### # # ##### # ########### # ### # ##### ### ### # ####
#   # #   # #     #       # # # # # #   # #     #   #           # #   # #   # #   #   # #         # # # # #     # # #   # # #   
##### # # ####### # ####### ### # ### # # ########### # # # ### # ### # # ### ### # ### # ####### # # # # ##### # # ### # # # # 
# #   # #         #   #     #   # #   # #   #         # # #   #     # #   # # #       #   #   #   # #   # #   #   #     # # # # 
# # ### # ##### ##### # ##### ### # ### ### # ##### ### # ### ##### # ##### # # ##### ##### # # ### # ### ### ### ### ### # # ##
# #     # #   # #   # # #     #   # # #   #   #     #   #   # #   # # #       # #   # #   # # # #   #   # #       #   #   # #   
# ### ##### # ### # ### # ##### ### # ### ##### # ######### # # # ### ######### # # # # # # # # # ####### # ####### # # ####### 
#     #     # #   #     # #   #     #   #     # # #     # # #   #   #           # # # # #   #   #         #   #   # # # # #     
# ### # ####### ######### # # ##### ### # ##### ### ### # # # ##### # ############# ### ################# ##### # # # # # # ####
# #   #       #   #   #   # # #   #   # # #   #   # # # # # # #   # #   #           #   #     #   #   #   #     #   #   # # #   
# # # ####### ### # # # ### # # # ##### # # # ### # # # # # ### # # ### # ########### ### ##### # # # # ### # ######### # # # # 
# # # #   #   # #   # # #   #   #   #   # # # #   # #   #   #   #   # # #       #     #   # #   #   # #   # # #       #       # 
### ### # # ### ##### # # ######### # ### # # # ### ######### ####### # ####### # ##### ### # ####### ### # # # ##### # ##### ##
#   #   #   #   # #   # #   #   #   #     # #   #   #       # #     #         #   #         #     #   #   # # # #   # # #   #   
# ### ####### ### # ### ### ### # ### ##### ##### ### ##### # # ### ### # ### ##### ### ### ##### ######### # # # # # ### # ### 
#   #   #   # #   # # #   #   #   #   #   # #   #     #     #   #   #   #   #         #   # #   #       #   # # # #       #   # 
####### # # # ### # # # # ### ##### ### # # # # ####### ######### ### ##### ### # ### ### # # ######### # ##### ############# # 
#     # # # #     # #   #   #   # #   # # # # # #     # #         #       #   # #   #   # # #       # #   #     #         #   # 
# ##### # # ##### # ##### ##### # # ### # ### # # ### # # ########### ### ### # ####### # ######### # ##### ### # ####### # ### 
#   #   # #     # #     #     # #   #   #     # #   # # # #         #   # #   #       # #           #   #   #   #   #   # # #   
### # ### ####### ##### ####### ##### ######### # # ### # # ####### ##### # ######### # ######### ##### # ##### ### # ### # # # 
#   # #   #           #       #     # #       #   # #   # #   #   # #     # #   #   # #         #       #   #   # # #     #   # 
# ### # ### # ##### # ####### ##### # ### ### # ##### ### # ### ### # ##### # # # # # # ####### # ######### # ### # ### ####### 
#   # #     # #     # #           # #   #   #   #     #   # #   #   #   #   # # # #   #   #     #   #     # #     #   #       # 
### # ######### ##### # ####### # # ### ### ##### ##### ### # ### ### # # ### # ####### # # ##### ### ### # ######### ####### # 
#   #       #   #   #   #     # # #     #   #   # #   #     #     #   # #     #       # # #   #   #   #   #       # # # #     # 
# ######### # ##### ### # ### ### ####### ### # # # ################### ############# # # ### # ### ### ######### # # # # ##### 
# #   # #   # #     #   # #   #       #   #   # # # #   #               #             # #   # #   # #   #     #   # # # #   #   
# # # # # ### # # # # ### # ### ##### # ### ### # # # ### # ############# ############# ### # ### ### ### ### # ### # # ### ### 
#   #   #     # # #   #   # #   #   #   #   # #   #       #   #           #   #         #   #   #   #   #   # #   # #   # #   # 
# ##### ####### # ##### ### # ### # ### # ### ########### ### ############# # # # # ##### ##### # # ### ##### ### # ##### ### # 
# #   #   #     #   #   #   # #   #     # #   #         #   #     #   #     #   # #   #   #   # # #   # #   # #   #       # # # 
# # # # # # ####### # ### ##### ####### # # # # ####### # ####### ### # ### ##### ### # ##### # ##### # # # # # ### ##### # # # 
# # # # #   #       #   #     # #   #   # # #   #     # # #     # #   # #   #       # #     # #     #   # #   #     #   #   # # 
# # ### # ### ##### ### ##### ### # # ### ####### ### # ### ### # # ##### ### # ##### ##### # ##### ##### ########### # ##### # 
# #     # #   #       # #   #   # # #   #       # #   #     # #   #       # # # #   #     #       #                 # #       # 
# ####### # ########### # # ### ### ### ####### ### # ####### ############# # # # # ##### ######################### # ######### 
#   #   # #   #       #   #   #   #   #     #   #   #   #           #       # # # # # #   #                   #     #   # #     
### # # ####### ##### ####### ### ### ##### # ### ##### # ####### # # ####### # # # # # ### ################# ##### ### # # ####
# # # #         #     #     # # # # #   #   # #   #   # #   # #   # #     #   # # #   #   #   #         #   #   #   #   # # #   
# # # ########### ##### ### # # # # ### # ### # # # # # # # # # ### ##### # # # # ########### # ######### # ### ### # ### # # # 
#   # #     #   # #   # #   # #   # #   #   # # #   # # # #   # #   #       # # #     # #     # #         # # #   # # # # #   # 
### # # ### ### # # # # ##### ##### # ##### # ######### # ##### # ### # ####### ##### # # ##### # ######### # ### # # # # ##### 
#   #   # #     # # # # #     #     # # #   #   #   #   # #     #     #   #   # #       #     # # #     #   # #   # # #   #   # 
# # ##### ####### # # # # ######### # # # ##### ### # ##### ####### ####### # # # ########### # # # ### # ### # ##### # ### ### 
# #     # #     #   # #   #       #           #   #         #     # #     # # #   #           # # #   # #   # # #     #   #   # 
# ### ### # ######### ### ### ### ##### ######### ########### ### # # ### # # # ### ########### # ### # ### # # # ##### ##### # 
#   #   # #         #   #     # #       #         #         #   # # # #   # # #   #         #     # # # #   # # # #     #   # # 
# # ### # ######### ### ####### ####### # ######### ####### ### # ### ##### # # ########### # ##### # # # ### # # # ##### # # # 
# #   #   # #       #   #             # #   #   # #     # #     #   #   # # # #     #       # #   #   # # #   #   #       #   # 
# # ####### # ####### ### ####### ### # ### # # # ##### # ######### ### # # # ### # # ####### # ### ##### # ####### ########### 
# #         #   #   #   #   #   #   #   #   # # #   #         #   #     # # # #   # # #       # #   #     #           #   #     
# ######### ### # ##### ##### # ### ##### ### # ### # ######### # ##### # # # ##### # ##### ### # ### ##### ######### # # # ####
#       # #     #     #   #   #     #     #   #     # # #     # # #   #   # # #   # #     #   #   # #   #   #       # # # #     
# ### # # ####### ####### # ##### ### ####### ### ### # # ### # # # # ##### # # # ####### ### ### # ### # ######### # # # ##### 
#   # # # #   #     #   #   #     #   #       #   #   # # #   # # # # #   # #   # #       # #   #     # #       # # #   # #   # 
# ### # # # # ##### # # ##### ### # ### # ####### # ### # ##### # # # # # # ##### # ####### ### ##### # ####### # # ##### # # # 
# #   #   # #   #   # # #   # #   # #   # #     # #   # #       # # # # # #   # # #       # #   #     #       # # # #   #   # # 
# # ####### ### # ### # # # ### # # # ### # ### # ### # ######### # ### # # ### # ####### # # ### ##### ##### # # # # ######### 
# #   #     #   #     # # #   # #     #   # # #             # #   #     #   #   #   #     #   #   #   # #     #     #   #   #   
# ### # ##### ### ####### ### ##### ##### # # ##### ##### # # # ########### # ##### # ##### ### ### # ### ##### ### ### # # # ##
#   #   # #   # # #   #   #       # #   # #   #     #     # # #             #       #     #   # #   # #   #   #   #     # # # # 
# ####### # ### # ### # ######### ### # ############# ##### # ### # ####### ############# ### # # ##### ### # # # # ##### # # # 
#       #   #   #   # #       # #     #         #   #     #       # #   #     #         # #     #       #   #   # #   #   #   # 
### ### ##### ##### # ####### # # ############# # # # ### ##### ### # # # # ### ####### # ##### ######### ####### ##### ####### 
#   #               #     #   #   #   #       #   # # # # #     # # # #   #     #     # #   # #   #     #   #   # #     #   #   
# ################# # # # # ####### # # # ### ##### # # # # ##### # ##### ####### ### # ### # ### ##### # # # # ### ####### # ##
#       #         #   # # # #       # # #   #     # #   # #     # # #   # #       #   #   # #     #     # #   #     #     # #   
####### # ####### # ### # # # ####### # ### ####### ##### ##### # # # # # # # ### ######### # ##### ##### ####### ####### # ### 
#       #   #   # #   # # #   # #     #   #   #     #   #   # #   # # # #   #   # #     #   # #     #     #     #       # #   # 
# ######### # ### ### # ####### # ####### ### # ##### # ### # ##### # # # ##### ### ##### ### ##### # ##### ### ####### # ### # 
# #       # # #   #   #     #   # #     # #   #     # #   # #     #   # # #   #     #   #   #   #   #   # #   #       # #   #   
# # ### ### # # ##### ##### # # # ##### # # ####### # ### # ### ####### # ### ####### # ### ### # # ### # ### ####### # ### ### 
#     #       #     # #   #   # #       # #       #   # # #   # #     # #         #   #   #   # # # # #   # #   #   # #   # #   
################### # # # ############### ####### ##### # # # # # # ### # ######### ##### ### # ### # ### # ### # # # ### # # # 
#                   #   # #         #     #     #       # # # #   # #   # #       #   # #   # #   # #   # #   # # # # #   #   # 
# ######### ############### ### ##### ##### ########### # ### # ##### ##### ##### ### # ### # ### # # # # # ### # # # # ####### 
# #     #   #   #       #   #   #     #     #       #   #     #     #       # #     #     #   # # #   # #   #   # # # #       # 
# # ### # ### # # ##### # ### ### ##### ### # ####### ############# ######### # # ####### ##### # ##### # ### ### # # ##### # # 
# # #   #   # #   #   #   # #     #   # # # #     #   #     #   # # #       # # # #       # #   # #       #   #   # #     # # # 
# ### ##### # ####### ##### ####### ### # # ##### # ##### # ### # # ##### # # # ### ####### # # # ####### # ### ######### ### # 
#   # #     # # #             #   #   # #   #   #   #     #   #   # #     # # #   #   #   #   # #       # # #   #       #   #   
### # ### # # # # ######### # ### # # ### ### ############### ### # # ##### # ### ### # # ##### ####### # # # ### ### ##### # ##
#   #     # # #   # #   #   #   # # # #   #       #         #   # #   # #       #   # # #     #     #   # # #     #   #  S  #   
# ########### # ### # # ##### # # # # # ### ### # # # # ####### # ##### # ######### # # ##### ##### # ### # ######### # ##### # 
# #   #       # #   # # #   # #   # #         # #   # #       # # #     # #         # # #   #       # #   #   #   #   # #     # 
# # # # ####### # # # # # # ### ### ########### ##### # ### ### # # ##### # ####### # # ### ######### # ##### # # # # # ####### 
# # # # # #       # # #   #   #     # #   #     #   # # # #   # # # #     #   #   # # #   #   # #     # #     # #   # #   #     
# # # # # # # ####### ####### # ##### # # ####### # # # # ### # # # # ####### # ### # ### # # # # ##### # ##### ##### ### ### ##
# # #   #   # #       # #   # #       # #   #   # # # # # #   # #     #     # #   # # # # # # # # #     #   #   #       #   #   
# # ##### ### # ####### # # # ##### ### ### # # # # # # # # ### ### ### ### # ### # # # # # # # # # ####### # ### ######### ### 
#   #   #   # #   #   #   # #     #   #   # # #   #   #   #   #   #     # # # #   # # #     #   # #       #   #   #   #     # # 
# ### # # # ##### ### ##### ##### ### ### # # ####### ########### # ##### # # ### # # # ######### # ########### ### ### ##### # 
#     # # #   #   #   #     #   # # #   # # #       # #   #       #       # #   #   # #   #       #   #         #   #   #   #   
# # ### # ### # ### ### ##### # # # ### # # ### ### ### # # ####### ##### # ### ##### # # # ####### # # ######### ### ### # ### 
# #   # #   #   #   #   # #   #   #     # #   #   #     #   #   #       # #   #       # # # #   #   #   #     #   #     # #     
# ### ##### ##### ### ### # ############# ### ### ############# # ##### # ### ######### ### ### # ########### # ####### # ### ##
#   #                     #               #   #                   #     #   #                                 #         #   #   
