################################################################################################################################
################################################################################################################################
#               #     # #         #         #             #     # #   #       #         #     #   #       #               #     
######### ####### ### # # ####### ##### ### # ########### ##### # # # # ##### ### # ### # # ### # # ##### # ########### # # # ##
#       # # #     # # # # #     #     #   # #     #     #           # # #   #   # #   # # #     # #   #   # #         # #   #   
# ##### # # # ##### # # # # ### ##### ##### # ### # ### # ############# ### ### ####### # ### ### ##### ### # ####### # ####### 
#   #   #   #   # #   # # # # # #   # #     #   #   #   #   #   #     #     # #   #   #     #   #   #   #   #     #   #       # 
### # ##### ### # ##### # # # # ### # # ##### # ########### ### # ### ##### # ### # # ### # ######### ### # ##### # ######### # 
# # # #       # #   #   # # # #     # # #     # #         #     #   #     # #     # #   # # #     #   #   #     # #   #   #   # 
# # # ### ##### ### ### # # # ####### # # ####### ####### ### ##### ### # # ########### # # # ### # ### ####### # ### # # ##### 
#   # #   #   #   #     # #     #     #       #   # #   #   # #   #   # # # #           # # # # #   #   #   #   #   #   # #   # 
# ##### # # # ### # ##### ##### # ##### ####### ### # ##### ### # ### # # # # ########### # # # ##### ### # # ##### ##### # # ##
# #     # # #     #   #   # #   #   #   #     # #         # #   # #   # # # # #           # # #       #   #     # # #   #   #   
# # ##### # ####### # # ### # ##### # # # ### # # ####### # # ### # ### ### # # # ####### ### ##### ########### # # ### ####### 
#   #   #   #       # #     # #     # # #   #   # #   #   #   # #   # #     # # # #     # #   #   # #   #     #   #     #     # 
##### # # ### # # ######### # # ##### ##### ####### # ### ##### ##### ####### # ### ### # # ### # # # # # ### ### ####### ### # 
#     #       # #       #   #   # #         #       #   #     #     # #   #   #   #   # # # # # # # # # # #     #       #   # # 
# ##### ##### # ####### # ####### # ############# ##### ##### ### # # # ### ### # ### # # # # # # # # # # ##### ####### # # ### 
# #   # #   # # #     #   #       #     #   #   # #   # #   #   # #   # #   #   #   # # # # #   # # # # #   #   #     # # # #   
# # # # # # ### # ### # ##### ######### # # # # # ### # # # ### # ### # # ####### ### # # # ##### ### # ### # ### ### # # ### ##
# # #   # #   # # # # # #   #         # # # # # #   # #   #   #   #   # #       # #   # # # #         #     #   # #   # #   # # 
### # ### ### # # # # # ### ######### # ### # # ### # ####### ####### # ####### ### ### # # ################### # ##### ### # # 
#   # #   # # #     # #   #     #   # #   # # #   #   #     #       # # #   # #     #   # #     #       #     # #   #   #   # # 
# ### # ### # # ##### # # ##### # # # ### # # ### ##### ### ####### # # # # # ####### ### ##### # ##### # # ### ### # ### ### # 
# #   # # #   # #     # # #   #   # #     # # # # #     # # #   #   #   # #   #   #   # # #   # # #     # # #   #   #     #   # 
### ### # ####### # ##### # # ##### # ##### # # # # ##### # # # ### ### # ##### # # ### # # # # # # ####### # ##### # ##### ### 
#   # #         # # #   #   #         #     # #   # #   #   # #   #   #   #     # #   #     # # # # #     # # #   #   #     # # 
# ### ######### # ### # # ######### ### ##### ##### # # ######### ### # ### ######### ##### ### ### ### # # # # # # ### ##### # 
# #   #   #     # #   # #   #     #         #     # # #   #                   #       #   #   #   # #   # #   # # # #   # #   # 
# ### # # # ##### # ### ### # ### ### # # ####### # ### # # ### ############### ####### # # # ### # # ### # ##### # # ### # # # 
#       # # #       # #   # #   # # # # # #     # # #   #   #   #               #     # # # #   # #   #   #   #   # #   #   #   
# ####### # # # ##### ### ####### # # # # # # ### # # # ##### ### ################# # ### # # # # ##### ##### # ### ### # ######
# #   #   # # # #     # #       # #   # # # # #   # # # #   #   #     #   #       # #   # # # # #   #   #   # #   #   # #   #   
# # # ##### # # # ##### ####### # ##### # ### # ### # ### # ### ##### # # ####### ##### # # # ##### # ##### # ### # ### ### ### 
# # # #   # # #           #     # # #   #     # # # #     #   #         #         #         #   #   # #       # # #     #   #   
# # # # # # # ########### # ### # # # # ####### # # ######### ####### ######### ### ####### ### # ### # ### ### # # ##### ### ##
# # # # #   # #     #   # # #   # #   #         # #   #   #   #   #   #       #           #   #   #   #   #       # #   #   #   
# # # # ####### ### # # # # ##### ##### ######### ### # # # ### # # # # ##### ##### ##### # ####### ### # # ####### # # ### ### 
# # # #         #   # #   #     #     #     #     # # # #   #   #   # #   #   #     #     #             # #       # # #       # 
# # # ########### ############# ##### # # # ##### # # # ### # ####### ### # ### ##### ########### # ### # ##### ### # ####### # 
# # #           #         #   #     # # # #     #   # # #   #       #     # #   #   #   # #   #   #   # # #   #     #   #   # # 
# # ### # ############### # ### ##### # # # ### # ### # ############# ##### ##### ##### # # ### ### # # ### # # ##### # # # # # 
#   #   # #   #       #   #   #       # # #   #   #   # #           #   # #     #       #   #   #   # #     # #       #   # #   
# ### ##### # # ##### # ##### ######### # ### ##### ##### ######### ### # ##### ######### ### ##### # ####### ### ##### ### ####
# # # # #   # #   #   # #       #       #   #     # #     # #     # #     #   #   #     # #       # #       #   # #   # #   #   
# # # # # ### ### # ### ####### # # ##### # ####### # ##### # ##### # ##### # ### # ##### ####### ### ##### ### ### # ### ### # 
# # #   # #   #   #   #     #   # # #   # #         # # #   #       #   #   # #   #   #   #   #   #   #   #   #     #   # #   # 
# # ##### ##### ##### ##### # ##### # # # ########### # # ########### # # ##### ### ### ### # # ### ##### # # ######### ### ### 
# #     #   # #     #     # #       # #     #     #   #               # #       #   #   #   #   #   #   # # #         #   # #   
# # # ##### # ##### ### ### ######### ### ### # ### ### ############### # ####### ### ### ####### ##### # # ######### ### # # ##
#   #     #   #   #   #   # #           #     #   # # # #       #       # #     #   #   #   #   #     # #   #     #     #   # # 
# ####### ### # # ### ### # ##### ##### ####### # # # # # ##### # ### ##### ### ### ### ### # # ##### # ##### ### # ######### # 
#   #     #     #   #   #   #     #     #     # #   # # # # #   #   # #     # # #   # # #   # # # #   #   #     # #     #   # # 
# # # ##### ########### ##### ##### ##### ### # ##### # # # # ##### ### ##### # ### # # # ### # # # ##### ##### # ##### # ### # 
# # #     # # #     # # #   # #   # #S  # # # #         #   #   # #     #     #   # # # # #   #   #       #     #   #   # #   # 
# # ####### # # ### # # ### # # # # ### # # # ############# ### # ####### ####### # # # # # ##### ######### ####### # ### # ### 
# # #   #   # # # #   #   # #   # # #   #   #   #           #   #       # #       # # #   #     #         # #     #   #   # #   
# ### # # ### # # ####### # ##### # # ######### # ########### ### # ### # # ####### # ######### # ##### # # # ### ### # ### # ##
#     #   #   #     #   # #       #   #     #   # # #         #   #   # # # #   #     #       # # #   # # # #   #     #   # # # 
# ########### ##### # # # ############# # ### ### # # ######### ####### # # # # # # ### ##### ### # # # # # ##### ### ### # # # 
# #         #     # # # # #             #     # #   # #   #     #   #   #   # #   # #   #   # #   # #   #   #   # #     #   # # 
# ##### ### ### # # # ### # ################### ### # # # ##### # # # # ##### ##### # ##### # # ### ######### # # # # ####### # 
#   #   #       #     #   # #             #       # # # #     # # #   # #     #     # # #   # # #   #       # #   # #       # # 
### # ########### ##### ### # ### # ##### # ##### # ### ##### ### ##### # # ### ##### # # ### # # ### ##### # ##### ### # # # # 
#   # #           #     # # # # # # #   # # #           #   #   # #     # #   #   # #   #     # # # # #   #   #       # # # # # 
# ### # ######### # ##### # # # # ### # # # ########### ### ### # ##### ##### ### # ### ####### # # # # # ####### ### # ### # # 
#     # #         # #     # #   # #   # #   #         #     #   #     #       # #   #   #     # # #   # #         #   #   #     
##### # ##### ##### ### # # ##### # ### ##### ####### ##### ######### ######### # ### ### ### # # ##### ##### ########### ######
#   # #     # #         # #   #   #   #     # #     # #     #       #       #     #   #     # # # #   #   #   #     #   #       
# # # ##### # # ### ##### ### # ##### ##### # ##### # ##### # ##### ######### ##### ####### ### # ### ### # ### ### # # # ##### 
# #     #   #   #   #   #     # #     #   # # #   # #     #   #   # #         #   # #     # #   #   #     # #   # #   # #   #   
# ##### # ####### # # # # ##### # ##### # # ### # # ##### ### # # # ####### ### # # # # # # # ##### ######### ### ##### ##### # 
#     # # #       # # # #       #       # #     # # #   #   #   # #       #     # # # # # # # #     #   #     #   # #   #     # 
##### ### # # ####### # ################# ####### # # # ### ### ######### ### ##### ### # # # # ##### # # ##### ### # ### ##### 
# #   #   # # #     # #         #     #   #   #   # # #     #   #       # #         #   # #   # #   # #   #   # #   # #   #     
# # ### ### # # ### # ######### ##### # ### ### ### # ####### ### ##### # ### ####### ### # ### # # # ####### # # ### # ##### # 
#   #   #   # #   #   #       #     #   #     #   #           #   #     #   #       # # # # #   # # # #     # # #   #   # #   # 
##### ### # ########### ### ####### ### ##### ### # ### ####### # ##### ### ####### # # # ### ##### # # ### # # ### ##### # ### 
#     #   #   # #   #   # #     #   #   #   #         #     #   # #   #     #     #   # #   # #     #   # # # #     #   #   #   
# ##### ##### # # # # ### ##### # ####### # # ####### ##### # ##### # ####### ### ##### ### # # ##### ### # # ##### # ####### # 
# #   #     #   # # # #   #   # # #       # # #     #   #   #       #   #     #   #   #   # # #   #       # #     # #         # 
# # # ##### ##### # # # # # # # # ######### # # ### ### ############### # ########### # ### # ### ####### # # ### # ##### # # # 
# # # #     #     # #   # # # # #     #   # # #   #   #   #     #   #   #         #       #   # #   #   # # #   #         # # # 
# ### # ##### ##### ##### # # ####### # # # # ### ### ### # # ### # # ########### # ##### ##### ### # ### # ### ########### # ##
#     # # #   #   # #   #   # #         #     #   # # #   # # #   # #       #           #   #     # #     #   # # #       # #   
####### # # ### # # # # ##### # ############### ### # # ### ### ### ####### ####### ### ##### ### # ######### # # # ##### # ### 
#       # #   # #   # #       #   #                 # # #   #   # # # #   #       #   #       #   #     #     #   # # #   # #   
# ####### ### ##### ####### ### ### ##### ######### # # ### # ### # # # # ####### # ########### # ##### # ##### ### # # ### # # 
#         #   #   # #     #     #   #   #     #   # # #   # #   #   # # # #   #   #     #       #     #   #     # #   # #   # # 
# ######### ### # # # ### ##### # ### # ##### # # ### ### # ### ##### # ### # # ### ### ############# ##### ### # ##### ### # ##
# #   #   # #   # #   # #     #     # #   #   # # #   #   #           #     # # #   # # #   #     #     #   #     #   #   # #   
# ### ### # ##### ##### ##### ##### # ### # ### # # ### ############# ####### # # ### # # # # ### # ### # ### # ### # ### ##### 
#   # #   #     # #   # #   #   #   #   # #   # #   #   #   #   # #   # #   #   #   # #   # # # #   #   # #   #     #   #       
# # # # ####### # # # # # # ### # ####### ### # ##### ##### # # # # ### # # ####### # ##### # # ##### ### # ### ##### # ########
# #   #   #   #   # # # # #     # #       #   # #     #   #   # #       # #   #   # #       #   #     #   #   # # #   #   #     
# ####### # # ##### # # # ####### # ########### ### ##### ##### # ####### ##### # # ############### ### ##### # # # ##### # ### 
#   #     # #       # # #     #     #   # #   # #   #     #       #     #     # # # #   #     #     #   #   # #   # #   # #   # 
# ### ##### # # ### # # ##### # ##### # # # # # # ##### ######### # ### ##### # # # # # # ### # ##### ##### # # ### # # ### ### 
#     # #   # # #   # # #     # #   # # #   #   # #   # #       # # #     #   # # # # #   # # # #     # #   # #   # # #     #   
# ##### # ### # # ##### # ##### # # ### ######### ### # # ##### # # ####### ### # # # ##### # # # ##### # ### # # # # ####### ##
# #       #   # #   #   # #     # #     #         #   #   #       #     #   #   # # # #   # # # # #     #     # # # # #     # # 
# # ####### ######### ### # ##### ####### ######### ####### ########### # ##### # # # # # # # ### # ############# # # # ##### # 
#   # #     #       #   # #   # # # #   # #   #     # #     #   #       #       #   #   # # #   # # #     #   #   #     #   # # 
# ### # # ### ##### ### # ### # # # # ### # # # ##### # ##### ### ################# ##### # ### # # # ### # ### # ####### # # # 
#   # # # #       #     #   #   # # # #   # # #   #   #   #   #   # #     #       #   # #   # #   #   #     #   #   #     #   # 
# ### # ### ############### ### # # # # ### # ### # ##### # # # ### # ##### ##### ### # ##### ######### ##### ### ### ######### 
#     #     #   #       # # #   # # #   #   # #   #         # #     #       #   #   #   #   #   #       #   # #   #   #       # 
# ##### ##### # # ##### # # # ### # ######### # ### ############### ####### # # ### ### # # ### # ####### # # # # # ####### ### 
# #   #   #   # # #   # #         #           # #     #         # # #   #   # #   #       #     #   #     # # # # #       #     
### # ##### ### ### # # # ##### ####### ####### # ##### ####### # # # # # ### ### ### # ####### ### # ####### # # ####### # ####
#   #     # # #   # # # #     # #     # #     # # #   #       #   #   # #   # #   #   # #       #   #         # #   #   # #     
# ####### # # ### ### # # ### ### ### # ### # # # # # ####### ######### ### # ### # ### # ##### # ############# # # # ### # ### 
#   #     # # #             #     #   #  G  # #   # #   #     # #       #   #   # # #   #   #                   # # #   # #   # 
### ####### # # ############################# ### # ### # ##### # ####### ##### # # # ####### ##### ######### # # ##### # ### ##
# # #       #   #               #   # #           #   # #       #   #     #     # # #   #   # #   # #   #   # # #     # # # #   
# # # ####### ### ############# # # # # ######### ### ######### ### # ### # ##### # # ### # # # # # # ### # ### # # # # # # ### 
#   # #   #   #   #     #   #   # # #   #     #     #   #     # # #   #   # #   #   # #   # # # #   # #   #     # # # # # #     
# ### # # # ### ####### # # # ### # ##### ### ### # ### ##### # # ##### # # # # ##### # ### # # ##### # ########### ### # # ####
#   # # # #   #       # # # #     #   #   # #   # # # #   #   #         # # # # #   # # # #   # #     #     #     #   #   #     
### # # # ### ##### ### # # ##### ### # ### ### # # # ### # # # ####### # # # ### # ### # ##### # ######### # ### ### ######### 
#   #   # #   #   #     # #     #   # #   # #   # # #   #   #   #       # # #     #   #   #   #     #     # # #         #       
# ####### # ### ############# # ### # ### # # ##### ### ####### # ######### ######### ##### ######### ### # # ####### # # ######
# #       #     #       #     #     #   #   # #   #             # #   #         #     #     #   #     #   # #   #   # #   #     
# ### # ####### # ##### # ########### ##### # ### ##### ####### # # # # ####### # ####### # # # # ##### ### ### # # # ######### 
#     # #       #     # #     #       #   # #     #     #     # #   # # #   #   # #     # # # # # #   #   #   #   # # #     # # 
####### # ##### ##### ####### # ####### # # ########### # ### ####### # # # ##### ##### # # ### # ### ### ### ##### # ##### # # 
#       #     #               #         #   #           #   #         #   #               #     #     #       #     #           
################################################################################################################################
