################################################################################################################################
################################################################################################################################
           #                 #             #   #         #         #       # #   #                                     #   #   #
 # ##### # # # # ####### ### # # ####### # ### # ####### ##### ##### ##### # # ### # ####### ################# ##### ### # # # #
 # #   # #   # #       # # #   # #     # #     # #     #       #   #   #   #       # #     # #         #       #   # #   # # # #
 # # # # ##### ####### # # ### ### ### # ####### # ### ######### # ### # ########### # ##### # ####### # ####### # # # ### # ###
 #   # #   #   #     # # #     #   # # #     #     #   #   #   # #   # #           # #       #   #   # #   #     # #     # #   #
 ##### ### ### # ### # # ### ### ### # ### ### ##### ##### ### # ### # ########### # ####### ### ### # ### # ##### # ##### ### #
     #   #   # # #   # # #   #   #       #     #   #           # #   #   #   #   #   #   #     # #   #     #     #   #   # #   #
 # ##### ### ### ##### # # ### ######### # ##### # ######### ### ##### # # ### ####### # # ##### # ############# # ### # # # ###
 #     #   #   #       # #   #   #   # #   #     #         #   #     # # #   # #     # # # #     #   #   #   #   # # # #   #   #
 ######### ### ######### ####### # # # # ### ############# ######### # # ### # # ##### # # # ####### # # ### # ### # # ####### #
 #     #   # # #       # #       # # #   #   #             #     #   # #   #   #       #   #   # #   # # #   #   # #   #   #   #
## ### # # # # ####### # # ####### # ### # ### ############# ### # ####### # ##### ########### # # ### # # ##### # ##### # # ###
   # # # # # #         # #       # # #       #   #     #     #   #         # #     #     #   # # #   # # # #     #   #   # #   #
 ### # # ### ########### ######### # # ##### ##### ### # ################### # # # # ### # # # # ### # # # # ####### # ### ### #
 #   #   #   # #       # # #       # # #   #       #   # #                 #   # # #   #   #   #   # # #   # #   # # # # # #   #
 ### ### # ### # ##### # # # ######### # # ### ##### ### # ####### # # ### ### # ##### ######### ### # ##### ### # # # # # # ###
   #     #   # #   #   #   # #         # #   # #       # #   #     # #   # #   #     #   #     #     # #   #     # #   #   #   #
 # ### ##### # ### # ####### # ####### # ### ### ### ### # # # ######### # # # ### ##### ##### ### ### # # ####### ########### #
 #   #   #   #     #   #   # #   #     # # #     #   #   # # #   # #     #   #   #   # #     #   # #   # #   #   # # #       # #
 ### ##### ######### ### # # ### # ##### # ####### ### ### # ### # # ####### ### ### # ##### ### # # # # ### # # # # # ##### # #
   #       #     #   #   # #     #   #   #       # #   #   #   #   # #   #   #     #   #   #     #   # # #   # #   # # #     # #
 ########### ### # ### ### ########### ######### # # ######### ##### ### # # # # ######### ########### # # ### ##### # ####### #
   #       # #   #   # # #     #       #       #   #     #     #   #   #   # # # #       #       #     # # #     #     #       #
## # # # # ### ##### # # # ##### ##### # ##### # ####### # ### # # ### ##### # ### ##### ####### # ##### # ##### # ##### #######
   # # # #   #   #   # # #     # #   # # #   # #       #   # #   #   # #     #     #   # #   # # # #     #   #   #   #   #     #
 # # # # ### ### # ### # ##### # # # ### ### # ####### ##### # ##### # ### ########### # # # # # # # ####### ### ### # ### ### #
 # # # #   #     # #   #     # #   #     #   # # #   #     # # #     #   #             #   # # #   # #     #   #   # #   # # # #
 ### # # ######### # ### ### # ########### ### # # # # # # # # # ####### ##### ### ######### # ### # # ### ### ### # ### # # # #
     # #   #         #   #   #   #       # # # # # #   # # #   #   #   #   #   #   #       # #   # #   # #   # #   #     # #   #
###### ### # ######### ######### # ####### # # # # ##### # ### ### # ##### # # ##### ##### # # # # ##### ##### # ### ##### #####
   #   #   #     #   #   #     # #       # # #   # #   # #     #   #   # # # # #   #     # # # #       # #     # # # # #   #   #
 # # ### ####### # # # # # ##### ### ### # # ##### # # # # # # # ##### # # # ### # ####### # ####### ### # ##### # # # # ### # #
 #   #   #   #   # # # #   #   #   #   # #   #   # # # # # # # #         # #     #   #   # #     #   #   #   #         #     # #
 ##### ### # # ### # # ##### # ### ### ##### # # # ### # # # ############# # ####### # # # ##### # ### ##### # ############### #
     #   # #   #   #     #   #   # #       # # # #     # # #     #S        #     # #   #   #     # # #   # # # #     #     #   #
#### # # # ####### ####### ####### ##### # # # ######### ####### # ######### ### # ######### ##### # ### # # # # ### # # ### ###
     # # #       # #   #   #       #   # #   #   #     #     #   #         #   #           # #   #         # # #   # # # #   # #
 ##### # ####### # # # # ### ####### # ### ##### ##### ### ### ########### ### ########### # # # ### ##### # # ### # # # # ### #
     # #         #   # #   # # #   # #   # #   # #   #   # #   #   #   #   #   #   #     # # # # #   #   # # #   # #   #   #   #
#### ### ############# ### # # # # # ### # # # # # # ### # # # # # # # # ####### # # ### # # ### ##### # # # ### # ######### ###
   #   #         #       #   #   # #   # #   # #   #     # # # # # # # #   #     # #   # # #   #     # # # #     #   #         #
 ##### ### ### # # ##### ######### ##### ##### ######### # # ### ### # ##### ##### ### # ##### ##### ### # ##### ### ### ##### #
 #   #   # #   # #     # #     #   #       #   # #       # #     #   # #     #   #   # #   #   #   #   #     #   # #   #   #   #
 # # ### ### # ####### # # ### # ### ##### # ### # ####### ####### ### # ##### # ### # ### # ### # ### ### ### ### ### ### # ###
   #   # #   # #     # # # #         #   #       # #   #   # #   # #   # # #   #   # # #   # #   #   #   #   # #   #   #   #   #
 ### ### # ##### ### # # ### ######### # ### ##### ### # ### # # # # ### # # ####### # # ### # ##### ### # # # # ### ### ##### #
   # #   #       #   # #   # #         #   #       #   #   # # #   # #   # # #     #   #     #   # #     # # # # #   # #   #   #
 # # # ######### # ####### # # ########### ####### # # ### # # ##### ### # # ### # ############# # ####### ### # # ### ### # ###
 # # # #       # #         #   #     #   #       # # # # #   #     #     #       #     #         # #   # #     # # #       #   #
 # # # ####### # ########### ### ### # # ####### # ### # ######### ######### ######### # ######### # # # # ##### # # ######### #
 # # #         #               # #   # #   #   # #     #         # #       # #       # #     # #   # #       #   # # #     # # #
 # ################# ##### ### # ####### ### ### # ############# # ####### # # ##### # ##### # # ### ####### # ### # ### # # # #
 # #       #       # #   # #   #         #   #   # #   #     #   #   #   #   # #   #     #   #       #   # # # # # # #   #   # #
 # # ### ### ##### # ### # ############# # ### ### # # # # ### ##### # ##### # # # ##### # ########### # # # # # # # # ### ### #
 # # # #     #     # #   #   #     #     #     #   # # # #     #   # #       #   #   # # #             # #       # # # #   #   #
 # # # ############# # ##### # ### ##### ####### # # # # ####### ### ####### ####### # # ######### ##### # ##### # # ### ### ###
 # #       #         # #     # # # #   #         # # # # #   #   #   #             # # #           #   #   #   # # #       #   #
 ######### # ######### # ##### # # # # ##### ### # ### # ### # ### ### ####### ### # # # # # # ##### # ### # # ### ### ####### #
 #   #   #   #       # #   #   #     #   #   #   #     #     # # #   #   #   #   # # #   # # #     # #   # # # #   # # #     # #
 # # # # ##### ##### # ### ############# # ### ######### ### # # ### ### # # ### ### ##### # ##### # ### # # ### ### # # ### # #
   #   #     #     # #   #         #     #   #             # # # # # #   # # #   #   #   # # #     #   # #   #   #   # # #     #
############ ##### # ### ####### # ##### ### ### ####### # # # # # # ##### # ##### ### # # ### ######### # ### ### ### # ##### #
   #     #   #     #   #   #   # #     #   #   #       # # #       #       #     #   # #   #   #       # #             # #   # #
 # # # ### ####### ####### # # ##### # ### ### ####### # # ##### # ############# ### # ##### # # ##### # # ############# # # # #
 # # #   # #     #   #   # # # #   # # #   #   #     # # #   # # # #     #   #   #   #   #   # #     # # #     # #     #   # # #
 ### ### # ##### # ### # # # # # # ### # ####### ### # # # # # # # # ### ### # ######### # ########### # # ### # # ### # ### ###
 #   # #   #     #   # # #   # # #     #       #   #   # # # #   #   # #   # # #         #   #     #   #   #   # # #   # # #   #
 # ### ##### ##### # # ####### # ############# ### ##### # # ##### ### ### # # ############# # ### # ### ####### # # ### # ### #
 #   #   #   #     #   #     #   #     #   # # #   # #   # # # #         #   # #       #   #   #   # #         #   # #       # #
 ### # # # ### ######### # # ##### ### # # # # # ### # # # # # # ####### ##### # ##### # # ######### # ####### ##### ##### ### #
   # # # #   #   # #     # #   #   #   # #   # # # #   # # # #   #           # # #   # # #   #       # #       #   #     # #   #
## # # # ### ### # # ##### ##### # # ### ##### # # ### # # # ################# # # # # ##### # ####### # ####### # ##### # # ###
   # # #   #   #   #   #   #   # # #       #   # #     # # #     #           # # # # # #     # #   #   #         # #     # #   #
 ### # ### ### # ##### # ### # # # ######### ### ####### ### ### # ######### # # ### # # ##### ### # ############# ##### ##### #
     #   # # # # #     #   # #   #         # #         #   # #   # #     #   # # #   # # #   #   #   #     #     #     # #     #
 ######### # # # # ####### # ############# # ######### ### # # ### # ### ### # # # ### # ### ### ### # ### # ### ### # # # ### #
 #       # # # #   #       #       #       #       #   # # # #   #   # #   #   # #     #   #   #   #   #   #   #   # # #   #   #
 # ##### # # # ### ############### ############### # ### # ##### ##### ### ##### ######### # # ### # ### ### ##### ### ##### ###
   #   # #   #   # #  G        # #   #           #   # #   #             # #     #       # # # #   #   #     #   #   # #   #   #
#### # # # ##### # # ######### # ### ########### ##### ##### ### # ##### # # ##### ####### # # # ### ######### ##### # # ##### #
   # # #           #     #   #   #   #   #     #     # #     #   #   #   #   #     #       # # # #   #       #       # # #   # #
 # # ### ####### ####### # # ##### ### # # ### ##### # # # ### ##### # ####### ### # ####### ### # ### ##### ######### # # # # #
 #       #     # #       # # # #   #   # # # #       # # # #   # #   #       #   #   #       #   #     #   #     #     #   # # #
#### ##### ### # # ####### # # # ### ### # # ######### # # # # # # # ##### ### # ### # ##### # ### ##### # ##### ### ####### # #
     #   #   # # #   #     # # #     #   # #         # # # # # #   # #   #     #   #       #   #   #     # #   #   #   #       #
 ##### # ##### # ### # ##### # ####### ### ######### # # # ### ##### # # ######### ##### # ##### ### # ##### # ### ### #########
     # # #     #   # # #     #   #   #   #     #   # # # # #   #       #         #     # #       # # #       #   #   # #       #
#### # ### ##### ### ### ##### ### # ### ##### ### # # ### # ### ### ######### ####### ####### ### # ######### # ### ### ##### #
 #   # #   #         #   #     #   # #   #   #   # # #     # #     #       # # #     #   #   #     # #   #     #   #     # #   #
 # ### # ### ##### ### ####### # ##### ### # ### # # ####### ##### # ##### # # # # ##### # # ### # # ### # ##### # ####### # # #
 #   # # # # #   #     #       #   #   #   #         #   #     # # #     #   #   #   # #   #   # #   #   #     # #     #   # # #
 # ### # # # # # # ######### ##### # ##### ##### ##### # ##### # # ##### # ######### # ####### # # ### ####### ####### # ### # #
   #   # #   # # #           #     #     # #   # #     # #   # # #     # # #   #   # # #   #   # #   #   #   #   #     #   # # #
 ### ### ##### # ##### # ##### ######### ### # # # ####### # # # # ### # ### # # ### # ### # ### # # # # # # ### # ####### # ###
       # #   # #     # #     #         #     # # #         # # # # #   #   # # #   # #   # #   # # #   #   # #   # #   #   #   #
 ####### # # # ##### ##### # # ##### ######### # ########### # # # # ##### ### # # # ### # ### # # ######### # ### # # # ##### #
 #       # # #   # #     # #   #   #   #       # #         # # #   #     #       # #   #     # # # #   #     #   #   #   #   # #
 # ####### ##### # ##### ####### # ### # ####### # ####### # # ######### ####### ##### # ##### # ### # ####### # # ####### # # #
 # #       #     # #   #       # # #   #         # #       #   #     #     #   # #   #   #     #     #       # # #     # # # # #
 # # ####### ##### # ######### # # ### ######### # # ########### ### # ### # # # # # ##### ##### ########### # # # ### # # ### #
 # # #     # #     #   #     #   #   # #       # # #     #       # #   #   # # # # #       #         #     # # # #   #   #   # #
 # # # ### # # ### ### ### # ####### ### ### # # # ##### # # ##### ##### # # # ### ######### # ### # # ### # # # ### # ##### # #
   #   # #   # #   # #     #   #   #   # # # # # #   # #   # #     #   # # # #     #     #   # #   # # #   # # # # # # #     # #
 ####### ####### # # ### ##### # ##### # # # ### ### # ### # # ##### # # ### ####### # # # # # # ### # # ### # # # # # # ##### #
                 #       #     # #   # # # #       # #   # #   #   # #   #   #   #   # #   # # #   #   # #   # # #   # #       #
## ####### ########### # # ### # # # # # # ######### # # # ##### # ####### ##### # ### ##### ##### ##### # ##### ##### #########
   # #   # #   #       # #   #     #           #     # #   # #   # #     #   #   #   #     # #   #   #   # #     # #           #
 ### # # # # # ######### ### ################# # ##### ### # # ### # ### ### # ########### # # # ### ##### ### ### # # ####### #
     # # #   #       #   #   #       #   #     # #   # #     #   # # #   #   # #     #   # # # #     #     #   #     #       # #
 ##### # ########### # ### ### ##### # # # ### # ### # ### ##### # # # ### ### # ### # # ### # ##### # ##### ########### # # # #
 #     #       #     # #   #   #   # # #   # # #     # #     # # #   #   #   #   # #   #     #   #   #     #   #   #   # # # # #
 # ####### ### # ##### # ### ##### # # ##### # ####### # ### # # ####### ### ##### ######### ### ######### ##### # # # # # ### #
 # #     # #   #   #   #   #     #   # #               #   #   #   #   #   #   #         #     #         #     # # # # # # #   #
## ##### ### ####### # ### ##### # ### # # # # # ### ##### ####### ### ### # # ######### ### # ####### ####### # # # # ### # ###
   #   #   # #     # # # #     # # #   # # # # #   #     #       #   #   # # #   #     #   # #       #       #   #   # #   # # #
 ### # ### # # ### # # # ####### # ##### # ### ### ##### ####### ### ### # ##### # ####### ### ##### ##### # ######### # ### # #
     #   #   #   #   # #   #     #     # #   # # #     # #       #   #   #   #   # #   # #     # #   #     #     #     # # # # #
######## ####### ##### ### # ######### ##### # # # ### # # ####### ### ##### # ### # # # ####### # # # ########### ##### # # # #
   #     #       #       # #     #   # #     #   # #   # # #     #   # #   # # # #   # #       #   # # #         #     # # # # #
## # ##### # ##### ### # # ##### # ### # ### ##### # ### ### ### ### # # # # # # ##### ####### ##### # # ####### ##### # # # # #
   #     # #   # # # # #   # #   # #   #   #   #   #   #   #   # # # #   # # # #       #   #         #   #       # #   # # #   #
 ####### # ### # # # # ##### # ### # ##### ##### ##### ### ##### # # ##### # # # ####### # ### # ### ########### # # ### # #####
 #   # # # #   #   # #       #   # #     # #   #   #   #     #   # #     #   # #       # #   # # #   #     #       #   #   #   #
 # # # # ### ####### ### # ##### # ##### ### # ### # ### ##### ### ##### ##### ####### # ### ### # ### ### ########### # ##### #
   #         #           #     #   #         #     #   #               #       #         #       #   #   #             #       #
################################################################################################################################
