################################################################################################################################
################################################################################################################################
   #   #     #         #           #     #                         #                   #             #         #         #     #
 # ### # ### # # ####### ### ##### ### # # # ####### ############# # ### # ########### ### ######### # # # # # # ##### # # # # #
 #     # #   # #       #   # #   #     #   # #     #     # #     # #   # #   # #     #   # #     #   # # # # # # #   # # # # # #
 ####### # ### ##### # ### # # ########### # # ######### # # ##### ### # ### # # ####### # # ### ##### # # # ### ### # # # # # #
 #   #   #   # #   # #   # # #     #   #   #   #         #   #   # #   # #   #           #     #     # # # #     #   # #   # # #
 # # # ##### # # # # # ### ####### # # # ####### ######### ### # # ##### # ##### ######### ######### # # ######### ### ##### # #
 # #   # #   # # # # #   #   #   #   # #       # #         #   # #       # #   #   #       #   #   #   #     #   # #       # # #
 # ##### # ### # # ### # ### # # ##### # ##### # ######### # ########### # ### ### # ####### # # # ######### # # # ######### ###
 #       # #   # #   # # #   # #     # #   # # #   #   # # #     #       #   #   #   #       #   # #   #   #   # #         #   #
 ######### # ####### ### # ### ##### # # # # # ### ### # # ##### # # ####### ### ### # ############# # ### # ### ######### # # #
     #     #     # #     #   #   #   # # #   #   #   # # # #   # # #       #     #     # #   #   #   #   # #   #   #   #   # # #
#### # ######### # ######### ### # # # ##### ### ### # # # # # # # ####### ########### # # # # # # ##### # # # ### # # # ### # #
   # #       #   #       #   #   # # # #   # #   #   #   # # # #       #   #     #       # # # # #     # # # #   # # # # #   # #
 # # ##### ### ######### # ### ### ### # # ### # # ##### # # # ##### # # # # ### # ### ### # ### ##### # # ####### # # # ##### #
 # # #   # #   #     #   #     # #     # #   # # # #   #     #       # # #   #   #   # #   #   # #   # # #   #     # # #       #
 # # # # # # ### ### # ######### ####### ### # ### # # ############### # ########### # # ##### # # ### # ### # ####### ####### #
 # #   # # #   #   # # #   #           # #   # #   # #   #     #   #   #     #   #   # # #   #   # #   #   #   #       #       #
 # ##### # ### ### ### # # # ##### # # # # ### # ### ### # ### # # ######### # # ##### # # # ##### # ##### ##### ##### # #######
 #     # #   #   #     # #   #     # #   #     #   # #   #   #   #     #     # #       # # #   #   #   #   #       # #   #     #
 ### ### ### ### # ##### ######### # ### ##### ### ### ##### ######### ####### ####### # # ### # ####### ### ##### # ##### ### #
 # #   #   # #   # #   # #         #   # #   #   #     #   #     # #   #   #   # #     #   # # #   #   # # # #   #   #   # #   #
 # ### ### # # ### # ### # ### ### ### ### # ########### # ##### # # ### # # ### # ######### # ### # # # # # # # ##### # # # ###
 #   #   # # # # #   #   #   # # #   #     #       #     #     # # # #   #   # # # #       # # #   # #   #   # # #   # # # #   #
 ### ### # # # # # ### ##### # # # # ########### # # # # ####### # # # ####### # # # # ### # # # # # ######### # # # # # ##### #
     # #   # # #   #   #   # # # # #           # #   # #     #   # #   # #   #       # #     #   # #       #   # # #   #       #
#### # ##### # ### # ### # ### # # # ##### # ### # ### ### # # ### ##### # # # ####### ##### ##### ####### # ##### #############
     #     #     # #   # # #   #   #   #   # #   #   # #   # # #   #     # # # #   #   #   #         #   # #     #       #     #
 ##### # # ##### # ### ### # ### ##### ##### # ####### ####### # ##### ### # # # # # ### # # # ##### # ### ##### ####### # ### #
 #   # # #   #   #   #     # #   #   #   # # # #     # #     # # #   # #   # # # # # #   #   # #               # #     # #   # #
 # # # # ### # ##### ####### ##### # ### # # # # ### # # ### # # # # # # ### ### # # # ####### # ######### ### # # ### # ### # #
   # # # # # #               #   # #     # # # #   # # #   # # # # # # #   #     # # # #   #   # # #     #   # # #   # # #   # #
#### ### # # ########### ##### # # ####### # # ### # ##### # # # # # # ### ####### ### # # # ### # # ### ### # # ### ### # ### #
   #     # #             #     #   #     #   #   # #       # #   # #   # #     # #   # # # #   #   #   #     #       #   #   # #
 # ####### ################### ##### ### ### ### ########### ##### ### # ##### # ### ### # ####################### ### ##### # #
 #       #       #       #     #     #         #   #       #     #   #   # #   #   #     # #   #   #           # # #   #     # #
 ####### ####### # ### ### ##### ### ####### # ### # ##### ##### ### ### # # ##### ######### # # # # ######### # # # ### ##### #
 #     #         # #   #   #     #   #     # #   #   #   # #     # # # # # #   #             #   #   #     # # #   # # #     # #
 # # ############# # ### ### ### # ### ##### # # ##### # # # ##### # # # # ### # # ################### ### # # # ### # ##### # #
 # # #           # #   #   # #   #     #     # #   #   # #   #     # # # #   # # # #           # #   #   # # # #   #   #     # #
 # # # ######### ### ##### # ########### ####### # # ### ####### ### # # # ### ### # # ##### # # # # ##### # # ### ### # #######
 # # # #     # # #   #     #           # #       #     # #     #   # # #   #   #   # #     # #   # #       # #   #             #
 # ### # ### # # # ### ########### # # # ############# # ##### ### # # ### # ### ### ##### # ##### ######### ### ######### ### #
 #     #   # # # #   # #         # # # #             # #       # #   #     #     # #   #   #     # #   # #   #   #       # #   #
 ##### ### # # # ### # ### ##### ### # ############# # ######### ##### ########### # # ######### # # # # # ### ### ##### ### # #
 #   #   # # # # #   #   # #     #   #             # #                     #   #     # #       # # # #       #     #   #     # #
 # # ### # # # # # ##### # ####### ### # ##### ##### # # # ##### ##### ### # # # ##### # ##### # # ######### ####### ######### #
   #   #   # #   #     # # #   #   #   #     #   #   # # #     # #   #   #   #   #     # # #   # #         #       #         # #
###### ##### ####### # # # # # # ### ### ### ### # ### # ##### # # # ################### # # ############# # ####### ### # ### #
     #     # #     # # # #   #   #     #   #   # # #   #     # #   #             #     # # # #       #     #         # # # #   #
## ####### # ### # # # # ############# ####### # # # ####### # ################# # ### # # # ####### # ######### ##### # ### ###
   #     # #   # #   # #       #     # #   #   # # # # #   # #                 # # # #   # #         #       #   #   #   #   # #
 ### ### # ### ### ########### # ### ### # # ### # # # # ### # ##### # ####### # # # ##### ################# # # # # ##### ### #
 #   # #   #   #   #     #     # #   #   # #   # # # # #     #     # # #   #   #   #   # #   #   # #   # #   # #   # #     #   #
 # ### ####### # ### ##### ### ### ### ### ### ### # # ####### ### # # # # ########### # # # # # # # # # # ####### # # ####### #
   #             #   #     #   #   # # #   #   #   # #           # # #   # #           # # # # # # # #   #       # # # #       #
 ### ### ##### ### ### ####### # ### # ##### ### ### ##### ### ### # ### # # # ##### ### # # ### # # ### ####### # ### # # ### #
   #   #     # #   # #       # #   # # #   #   #   # #   # #   #   #   # #   #     #       #     # # # # #   # # #   # # # # # #
## ########### # ### ####### # ### # # # # ####### # # # # ##### ##### ### ####### # ##### ####### # # # ### # # ### # ### # # #
 # #       #   # # # #   #   # #   # #   #   #     # # #   #     #   #   #   #   # # #   #         #   # #     #   # #     # # #
 # # ##### # ### # # # # # ##### ### ####### # ##### # ##### ##### # ### ### # ### ### # ####### ####### # ####### # ####### # #
 # # #   # #     #     # #     # #     #   #   #   # # #   # #     #   #   # #     #   #     #   #     #   #   #   #         # #
 # # ### # # ##### ########### # # ### # # ####### # # # ### # ####### ### # ####### ####### # ### ### ### # # # ### ### ### # #
   #   #   # #       #         # # #   # # #     # # #   #   # #   # #   # #     #   #   # # #       #     # #   # #   #   # # #
 ##### # ### # # ##### ######### # ####### # ### # # ### # ### # # # ### # ####### ##### # # ####### ####### ##### # # # # ### #
       # #   # # #   #       #   #   #         #   #   # #   #   # #   # #     #   #   #           # # #   #   #   # # # # #   #
######## # ##### # # ####### # ##### # ####### ####### # ### # ### ### # ### # # ### # ########### # # # # ### # ### # ### # ###
   #   # #       # #   #   #   #   # # #     # # #   # # #   #   #   #     # # #     #     # #     #   # # # # #     #   # #   #
 ### # # ##### ### ##### # ####### # # # ### # # # ### ### ### ##### ##### # # ########### # # ######### # # # # ####### ##### #
   # # # #   # #     #   #   # #       #   # #   # #   #   #   #     #   # # #           # #     #       #       #     #       #
## # ### # # # # ##### ##### # # ##### ### # ##### # ### ####### ### # # # ##### # ##### # ##### # ####### ##### # ### # #######
   #       #   # # #   #     # # #   # #   # #   #   #   #     # #   # # #       # #   # #     # #     #   #   # # #   #       #
 ### ### ##### # # # ### ##### # # # ### ### # # ##### ##### # # ##### # ######### # # ####### # ####### ### # # # # ### ##### #
 #   #   #   # # # # #   #   #   # #     # #   #     #   #   #   #     #   #       # #       # #     #   #   # # # # # # # #   #
 ### # # # # ### # # ##### # # ### ####### ############# # ##### # ####### # # # ### ####### ####### # ### ### ### # # # # # # #
   # # # # # #   # #   #   # #   # #   #         #     # #   #   #   #     # # # # #   #   #     #           # #   # #   #   # #
## # # # # # # ### ### ### ##### # # # ### ####### ### # ### # ##### ####### # # # ### ### ##### # ######### # # ### ######### #
 #   # # # # # #     #   #     # # # #   # #     # #   #   # #     #     #   # #   # # #   #     #         # #   #   #         #
 ### # # # ### # ### ### ##### # # # ### # # ### ### ##### # ########### # ### ##### # # # # ##### ####### ### ### #############
     # #         # #   #     #   #   #   # #   #     #   # #     #   #   #   # #   # # # # #     #   #   #   #   #             #
 # # # ########### ### ##### # ####### ### ### ######### # ##### # # # ##### # ### # # ### ##### ### # # ### ##### ########### #
 # # #   #   #       #   # #   #       #     # #     #   #     #   # #   #   #       # #     #   #  S# #   # #   # # #       # #
 # ####### # ####### ### # ### # ####### ### # ### # # # ##### ######### # ########### # ### # ### ### ### # # # # # # ##### # #
 # #   #   #       #   #     # # #   #     # #     # # # #   #           # #         #   # # # #     #   #   # # # # #     #   #
 # # ### ######### # ####### # # # # ##### # ####### # # # ############### ######### ##### # # # ############# # # # ##### #####
 # #   # #   #   # # #       # #   #       #     #   # #                   #       # #   #   # #     #     #   # #   #   # #   #
 # ### # ### # # # # # ####### ######### ### ### # ########### ### # # # # # ##### # ### # ### # ### # ### ##### ##### # # # # #
 #     #     # # # # # # #   # #       # #   # # #   #       # #   # # # #   #   #   #   #   # # # # # #       #       #   # # #
 ############# # # # # # # # # # ##### # # ### # ### # ##### ### ### # # ####### ##### ##### # # # # # ####### ############# ###
     #   #     # # # # # # #   # # #   # # #     # # # #   #     #   # #                  G# # #   # # #     #   #   #         #
###### # # ### ### # # # # ##### # # ### # ##### # # # # # ### ### ##### # ####### ### ##### # ### # # # ####### # # ######### #
       # #   # #   #   # #     # #       #     # # #   # #   # #   # #   #       #   # #   # #   # # #   # #     # # #     #   #
 ####### ### # # ##### # ##### # # ########### # # ##### ### # # ### # ######### ### # # # # ### # ####### # ##### # # ### # # #
     # #     #   #   #     # #   # #           #         #     #     #   #     #   # # # # # #   #   #     #   # # #   #   # # #
#### # ########### # ### # # ##### # ################### ############### # ### ### # # # ### # ### # # ### ### # # ##### ##### #
   #               #     # #       #           #     #   #     #       # # #     # # # #   # #   # # #   #   # #   #   #       #
## ####################### # ##### ##### ##### # ### # ### ### # ####### # ##### # # ##### # ### # ######### # ##### ######### #
   #   #     #           # #   #   #   # #   # #   # #   #   # #     #   #   # #   #     # # #   #         # #   #     #     # #
 ### # # # # ##### ##### # ### # ### # # # # # ### # ### ##### ##### # ##### # ##### ##### # ##### ####### # ### # ### # # ### #
 #   #   # #   #   # #   #     #   # # #   # #   # #   # #     #     #     #   #     #     #     #   #   # # #   #   # # # #   #
 ######### ### # ### # ##### ####### # # ##### ### ### # # ##### ######### ##### ##### ######### ### # # # # # ### # # # # # ###
 #         # #   # # #       #       # # #     #   #   # #   #         #   #     #     #       # #   # # #   #   # # # # # #   #
 # ######### ##### # ##### # # ####### # # # ### ### # # ### # ####### # ### # ### ##### ##### # # ### # # ##### # # ### ##### #
   #       # #             # #       # # # # #   # # # #     #   #     # #   #   #   #   #   #     #   # # #     # #     #   # #
#### ### ### # # ### # ##### ####### # ### # # ### # ########### # ### # ### ### ### # ### # # ### # ### ### ##### ####### # # #
   #   # #   # # #   # # #         # #     # #   # #             #   # #   #   #   # #     # #   #   # #     #   #         #   #
 ### ### # ### # ##### # # # ### # # # ##### ### # ### ####### ##### ##### # ### # # ####### ### ##### ######### # #############
   # #   # #   #   #   # # #   # # # # #   #   #   #   #   #   #     #   # # #   # #       #   #     #         # # #   #       #
## # # ### ####### # ### # ##### # # ### # # ##### # ### # # ######### # # ### ### ####### ######### ### ##### # # # # ####### #
 # # #   #         #     # #     # #     # # #     # # # #   #         #   #   #     #   #   #       #   #   #   # # #     #   #
 # # ############# ####### # ########### # # # ##### # # ### # ############# ### ### ### ### # ####### ### ##### # # ##### ### #
 # #       #         #     # #     #   # # # # # #   #   #   # #             #     # #   # #   #     # #       # # #   #   #   #
 # ####### # # ##### # ####### ### # # ### ### # # ####### # # # # ####### ### ### # # ### ##### ##### ### ##### # ### ##### # #
   #       # # #   # # # #     #     #     #   # #     #   # # # # #     #   #   # #   #   #         #   #   #   #   #   #   # #
 ### ####### ### # # # # # ####### ######### ### ##### ####### ### # ### ### ##### # ##### # ##### # ### # ### ##### ### # ### #
   #         #   # # # # #   #   # #         #   #   #   #   #   # # #   # #   #   #   #   # #   # # #   #         #   # #   # #
## ####### ### ### # # # ### # # # # ########### # ##### # # ### # ### ### ### # ### # # ### # # # # ##### ####### ### # ##### #
   #     # #   #   # # # #   # #   #     #       # #   # # #   # #   #       # # #   # # #   # # # #   #     #   # #   #     # #
 ### ### # # ######### # # ############# # ### ### # ### # ### # ### # ####### # ##### # # # # # ##### # ##### # ### ####### # #
   # #   # #           # #     #     #   #   #     #   # # #   #   #   #       # #   #     # # #     #     #   # #   #       # #
 # ### ### ############# ##### # ### # ### # ##### ### # # ####### ##### ####### # # ##### # # ##### ####### ### # ##### ##### #
 #     #                 #   #   # #   #   #     #   # # #       # #     #       # #   #   #       #   #     # #   #   #       #
 ######### # ##### ##### ### ##### ##### ####### # ### # ####### # # ##### ##### # ### ########### ### # ##### ##### # ####### #
 #         #     #     # #   # #   #   # # #     # #   # #   # # # # #   # #   # # #   #   #     #   # #   #   #   # # #       #
 # ############# ##### # # ### # # # # # # # ##### # ### # # # # # # # # ### # ### # ### # # ### ### # ### # # ### ### # #######
   #             #     #         #   #   #   #         #   #   #   #   #     #     #     #   #   #   #       #                 #
################################################################################################################################
