################################################################################################################################
 #           #         #   #               #           #   #   #   #                   #   #     #             #               #
 # ######### # ####### # # # ####### ##### # ##### ### # # # # # ### # ################# # # ### # # ####### # # # ########### #
 # #       # # #     #   # #     # # #   #   #   #   # # # # # # #   #             #     #   # # # # #       #   #           # #
 # ### # ### # # ### ########### # # # # # ### ##### ### # # # # # ############### # ######### # # # ######### ############# ###
 #   # #     #   #   #       #   # #   # #   #   #   #   # # # #   #   # #       # #     #   #   # #   #       #       #   #   #
 ### # ########### ### ##### # ### ##### # # ### # ### ##### # # ##### # # ### ### ##### # ####### ### ### ##### ##### # # ### #
   # #     #     # #   #   #   # #   #   # #     #     #     # #     # #   # # #       # #           #   # #     #   # # #     #
## # ##### ### # # # ### # ##### ### # ####### ######### ##### ##### # ##### # # ##### # # ######### ### ### ##### # # # #######
 # #     #     # # # #   #           #   #   #       #   #   # #   # #   #     # #   # # # #       #   #     #   # #   #       #
 # ############# # # # ################# # # ####### # ### # # # ### ### # ##### # # ### # # ##### ### ######### # ##### ##### #
 # #         #   # # # #     #     #   # # #   #   # #     # # # #   #   # #   #   #     # # #     # # #   #     # #       #   #
 # # ####### # ### # # # ### # # ### # # ##### # # ######### # # # ### ### # # ### ####### # # ##### # # # # ##### ####### # ###
         # #   #     # #   # # # #   # #       # #           # #           # #   # #         #     #   # # #       #   #   #   #
######## # ####### ### ### # ### # ### ######### ############# # ####### # # ### # # ############# ####### ######### # ####### #
   #   #   #     #   #     #   # #   #         # #       #   # #       # # # #   #               # #           #   # #   #   # #
 # ### ### # # # ### ######### # ### ######### ### ##### # # # # ##### # ### # ######### # # ##### # ######### # # # ### # # # #
 #   # #   # # # #       #   #     #   #     #   # #   # # #   # #     # #   #         # # #   #   #   #   #   # # # #     # # #
 ### # # ##### # ####### # # ##### ### # ### ### # # ### # ##### ####### # ########### ### ### # ### # # ### # # ### ####### # #
   # #         #   #   #   #     #   # # #   #   # #   # # #   #   #   # #       #   #   #   # #   # #   #   #       #   #   # #
## # ############# # # ######### # # # # ##### ### ### # # ### ### # # ######### # # ### ### ##### # ##### ########### # # ### #
   #   #         #   #     #   #   #         #         #   #   #   # # #     #   # # # # #   #     #   #   #     #     # # #   #
 ##### # ####### ######### # # ######### ### ######### ##### ##### # # # ### # ### # # # ##### ####### # # # ### # ##### # # # #
 #   #   #   #   #   #   #   #   #     #   #         #       #   # # # #   # # #   #   #     #       # # # # #   # # #   #   # #
 # ####### # # ### # # # ####### # ### # ########### # ##### ### # # # ### # # # # ### ##### ####### # # ### # ### # # ####### #
 #     # # # # #   #   #       # # #   #   #   # #   #     #       # # #   # # # # #   #   # #       # #   # # #   # # #       #
 ##### # # # # ########### ### # # # ### # # # # # ####### ##### ### # # ### # ### # ### # # ######### ### # ### ### # ### #####
 #     #   #   #   #       #       # # # # # # #   #     #     # #   #   # # #     # #   #   #   #       #   #   #   #   #     #
 # ##### ####### # # ####### ####### # # # ### ####### # ### # # # ####### # ####### # ####### # ####### ##### ### ##### ##### #
 # #   #   #     #   #     # #           #     # #     #   # # # #   #       #     # #   #     #     #       #   #   #   #     #
 # # # ### # ######### ### ### ##### ########### # # ##### ### ##### ### ####### # # ##### ######### # ### # ### ### # ### #####
   # #   # #   #     # # #     #   # #   #     #   #     #     #   #   #   #   # # #       # #     # #   # #   #   # #   #     #
#### ##### ##### ### # # ####### # # # # # ### ### ##### ####### ##### ### # # # # ######### # ### # ### # ####### # ### # #####
     #   #     #   # # # #       # # # #   #   #   #   # #   #   #     # #   #   #             # # # #   #   #     # #   # #   #
 ##### # ##### # # # # # # ### ##### # ##### ##### ### # # # # ### ##### ##### ######### ####### # # ######### ##### # ### # # #
       #   #   # # #   #   # #       #     #     #     #   #   #   #           #       # #   #     # #         #   #   #   # # #
 ######### # ##### ##### ### ####### ########### # ############# ### # ### # ### ##### # # # ##### # # ######### # ######### # #
 #       # # #     #   # #   #     # #           #       #       #   # # # # # #   # # # # #   #     # #     #   # #     #   # #
 # ### # ### # ##### # # ### # ### ### ################# # ########### # # # # ### # # # # ### # ### # # ### # ### # ### # ### #
 # #   #   #   #   # # #   # #   # #   #   #             # #     #     # # #   #   #   # # #   # #   #   #   # #   # #   #   # #
 ### ##### # ### # # # ### # ### # # ### # # ##### ##### # # ### # ##### # ##### ####### # # ### # # ##### ### ##### # ####### #
   #     #   #   #   # #       # # # # # # # #     #     # #   # #     #     #   #     # # #     # #     #     #   # #         #
## ##### ##### ####### # ####### # # # # # ### ####### # # ##### # ### ##### # ### ### ### ####### # ### ##### # # # ###########
 #       #     #   #       #   # # # # # #   # # #     # #       #   #   # # # #   # # #   #   #   #   #     # # # #   #       #
 ### ##### # ### # ### ##### # # # # # # ### # # # # ################# # # # # ### # # # ### # # # ### ##### # # # ### ####### #
     #   # # #   #   # #     #   #   #   #     # # # #   #           # # #   # #   # # #   # #   #   # #   # # # #     #     # #
#### # # # ### ##### # # ####################### # # # # # ### # ### ### # ### # ### # ### # ####### # ### # # # ####### ### # #
 #   # # # #     #   # # #         # #   #   #S    # # # # # # #   #     # #   # #   #   # # # #   # #   # # # #       # #   # #
 # ### # # # ##### ### # # ####### # # # # # ####### # # # # # ### ####### # ### # ##### # # # # # ##### # # # ####### # # ### #
 #   # #   # #   # #   #   #     # # # # # # #   #   # #   #   # #       # #   # #     #   #   # #     #   # # #     #   #     #
 ### # ### # # # # # ####### # # # # # ### ### # # ### ####### # ####### ##### # # ############# ##### ##### # # # ########### #
 #   # # # # # #   # #   #   # # #       #     # #   # #     # # #     # #   #   #       #   # #   # #   #   #   # #         # #
 # # # # # # # ##### # # ### # # ### ### ####### ### # # ### # # # ### # # # ##### ### ### # # ### # ### # ### ##### ##### ### #
   # # #   # #     #   #   # # #     #         # #   # #   #   # #   # # # #       # # #   #   #   # # #     # #     #   #   # #
###### ##### ##### ####### # # ##### # ####### # # ### ### ##### # # ### # ######### # # ####### ### # ### ### # ##### # ### # #
       #     # #   # #     # # #     #   #   # # #   #   #     # # # #   #   #   #   #         # #   #   # #   # #   # # # #   #
 ### ### ##### # ### # ##### # # ##### # # # # # ####### ##### # # # # ##### # # # # ########### # ##### # # ### # ### # # #####
 #   #         # # # # #     # # #   # #   # #   #   #   #     # # # #   #   # #   # #       #   #     # # # #   #     # #   # #
 ##### ######### # # # # ### # ### # ########### # # # ### ##### # # ### # ### ####### ##### # ####### # # # # ######### ### # #
 #   # #         #   # # #   #   # # #         #   # # #         # #   # # #   #   #   #   # #         #   # #     #   # #     #
 # # # # ######### ### ### ##### # # # ####### ### # # ### ####### ##### # ### # # # # # # # ####### ##### # ##### # ### ##### #
   #   #   #     #   #     #   # # # #   #   #   # # #   #         # #   #     # #   # # # #       # #   #   #     #           #
########## ### ##### ##### # # # # # ### # # ### # ##### # ### # ### # # ##### # ####### ######### # # # # ### ############### #
   #     #   #   #   #     # # # # #   # # #     #   #   # #   #     # #   #   #         #       # # # # #               #     #
## # ### ### ### # ####### # ### # ### # # ####### # # ##### ####### # ### # ############# # ##### ### # ### ########### ##### #
   #   #     #   #         #     # #     # #       # #     # #   # # #   # #       #     # # #     #   #     #     #   #     # #
 ##### ####### # ######### ####### # ##### ####### ####### # ### # # ### ######### # ### # # # ##### ##### ### ### # # ##### # #
       #       #     #       #   # # #   #     #   #     # #     #     #       #   # # # # # # #     #     #   #   # #   #   # #
######## ########### # ####### # # # # ####### # ### ##### ########### ##### ### ### # # # # # # ### # ### # ### ### ### # ### #
                 #     # #     #   # #   #   # #     #   #   #   #   #     #   #   #   # # #   # #   # #   # #   #   # #   #   #
 ####### ####### ####### # ######### ### ### # # ##### # ### ### # ##### # ### ### ##### # ##### # ##### ### # ### ### ##### ###
 #     #     #   #       #       #     #   # #   #     #     #   # #     #   #   # #   # #     # # #     #   # #   #         # #
 ##### ##### # ### ############# ######### # ### # ########### ### # ##### # ### # ### # ##### ### ### ### ### # ### ####### # #
     #     # # #   # #     #     #       # #     # #         #     #   #   #   #   #   # #   #   #   # #   # # # #     #   #   #
#### ##### # # # ### # ### # ##### ##### # # ##### # ####### # ####### # # ### ##### ### # # ### ### ### ### # # # ##### # #####
   #       # #         #   #       #   #   # #     # #     # #         # #   #     #     # #   #     #   #     #     #   #     #
 # ##### ############################# ##### # ##### # ##### ############### # ##### ##### ### ####### ##### ##### ### ####### #
 # #   #   #   #         #           # #   # #     # # #     #               #       #   #   # #   #   #   # #     #   #   # # #
 # # # ##### # # ####### # ######### # # # # ##### # # # ##### ### ### ######### ##### # ### # # # # ##### # # ##### ##### # # #
 #   #       #   #   #   # # #     # # # #       #     # #     # # #   #       #   #   #   # # # # #   #   # #   # #       #   #
 ################# # # ### # # # ### # # ############### # # ### # ##### ##### ##### ### # # # # ##### # ### ### # ######### ###
 #   #   #         #     # #   #     #   #   #     #   # # # #   # #   #     # #     # # # # # #     #   # # #       #   #     #
 # # # ### # ##### ##### # # ######### ### # # ##### # # # # # ### # # ##### # # ##### # ### # # # ####### # ####### ### # #####
 # # #     # #   # #   # # # #   #         #       # # # # # # # #   # #   # # # #   # #     # # #     #   #       #       #   #
 # # ### ##### # # # ### ### # # ### ############# # # # ### # # ##### # # # # # # # # ####### # ##### # ######### ####### # # #
 # #     #     #   # #   #   # #   # #             # # #   #   # #   #   #   # #   # # #     # #   # # # #   #   #         # # #
 # ##### # ######### # ### ### ### ### ######### ### # ### # ### # # ######### ##### # # ##### ### # # # # # # # ######### # ###
 #     # #         # #   #   # #       #   #     #   # #   #       #         #   #   # #       #   # #   # # # #     #     #   #
 # ### # ########### ### ### # ####### # # # ##### ##### ### ####### # # # ##### # ### ######### ### ##### # # ####### ####### #
 # #   # #     #     # # #   #   #     # # # #     #     #   #     # # # # #   #   #                     # # #                 #
 ### ### # ##### ##### # # ##### ### ### # # # ##### ####### # ### # # # # # # ##### # ####### ##### ### # # ##### ########### #
   #   #   #   #   # #   #     #   # #   #   #       #       # #     # # #   #       #    G# #     # #   # # #     #     #   # #
## ##### ### # ### # # ####### ### ### ### ########### # ### # # ####### ################# # ##### ### ### # ##### # ### # # # #
   #   #   # # #   # #     # #     #   # # #         # #   # # #   #   # #           #     # #     #   #   #     # # #   # #   #
 ### # ### # # # ### ##### # ### ### ### # # ####### ##### ### ### # # # # ######### # ##### # ##### # # ####### # # ##### ### #
 #   #   # # #   # #     # #   # #   #     #     # # #   # #   #   # # #           # #     # # #     # #       # # #     #   # #
 # ##### ### ##### # ### # ### # # ####### ##### # # # # ### ### ### # ### ######### ##### # # ### # ######### # ####### ### # #
 #     #     # #   # #   #   #   #       # #   #   # # #     #   #   #   #   #       #     # #   # # #       # #     #       # #
 ##### ####### # ### ####### ### ####### # ### ##### # ####### ### ##### # # # ####### ##### # # # # # ##### # ##### ######### #
 #     #                 #   #     #     # #   #     # # #     # #     # # # # #     # #     # # # # #   #   # #   #     #     #
 # ##### ### ##### ##### # ####### # ##### # ### ##### # # # ### ##### # # # # ##### # # ####### # ##### ##### # ####### # #####
   #     #   #   # #   # #   #     # #       #   #     #   #     #     # # # #   #     #         #     # #     #   #     #   # #
########## ### # ### # # ### # ##### # ####### ### ####### ####### ##### # # ### # ############# ####### # ####### # ####### # #
           # # # #   #   #   #   #   #   #     #     #     #   #   #   # # # # # # #       #     #     #   #       # #     # # #
 ########### # # # ### ### ####### ##### # ######### # ### # # # ### ### # # # # ### ##### ####### ### ##### ### ### # # ### # #
 #           # #   # # #   #       #   # #       #   # #   # # # #       # #   #     #   # #       #     #     # #   # # #     #
 # ########### ##### # # ##### ##### # # ####### # ##### ### # # # ####### ########### ### # ####### ##### ### ### ### # # #####
   #       #   #   #   #       #     # # #     #   #     #   # # #       #               #   #   # #   #   #   #   #   #   #   #
#### ##### # ##### # ##### ##### ##### # # ######### ### # ### # ####### ######### ##### ##### # # ### # ####### ### ####### # #
     #   #   #     #       #     #   #   #           # # # #   # # #   # #         #           #     #   #       #   #     # # #
 ##### # ##### ########### # ##### # ### ############# # # ##### # # ### # ######### ### ####### ######### ####### ### ### # # #
     # #   #   #     #   # # #   # #   # #   #       #   #       # # #   #       # #   #       #   #     #       # # #   # # # #
 ### # ### # ### ### # ### # ### ##### # # ### # # # ### ######### # # ######### # ### ####### ##### ### # ##### # # ### ### # #
   #   # # #     #   # #   #   #   #     #     # # #       # #       # # #     # #   #   #   # #     # # # #   #         #   # #
 ####### # ####### ### # # ### ### ##### ####### # ####### # # ### ### # # ##### ### # # # ### # ##### # # # # ########### ### #
         #     #     #   #   #     #   # #       #       #   #   #     # #     # #   # # #     #   #   # # # # #   #     # # # #
 # ##### ##### ##### ##### ######### # # # ### # ####### # ##### ####### ##### # # ##### ##### ### # ### # # # # # # ### # # # #
 #   #     #   #   # #   #         # # #   #   # #   #   # #   #   #           # #       #   #   # #     # # # # # #   # # #   #
#### ####### ### # # # ### ######### # ##### ### ### # ##### # ### ### ##### ### ### ##### # ### # ### ### # # # # ### ### #####
   # #       #   # # #         #   # #       # #     #       #   #   # #   #     #   #   # # #   #   #     # #   #   #   # #   #
 # # # ####### ### # ##### # ### # # ####### # ########### ### ##### ### # ######### # # # # # ##### ##### # ####### ### # # # #
 #   # #     # #           # #   # #   #     # #         # # #     # #   #   # #     # # # # # #   # #   # # #     # #   #   # #
 ##### # ### # ########### ### ### ### ####### # ####### # # ### ### # ##### # # ##### # # # ### # # # ### # # ### # # ####### #
 #   # # #   #   #   #   # #   #     #   #   # # # #     #   #   #   # #   # # # #     # # #   # # #   #   # #   #   #       # #
 ### # # # ##### # # # # ### ### ####### # # # # # # ######### # # ### ### # # # # ##### # ### # # ##### ### ### ####### ### # #
     #   #   #   # #   #     # #       #   #   # #   #         # #   #   #   #   # #     #   # # #     # #   # #   #   # #     #
 ########### ##### ########### ####### ######### ##### ######### ### ### # ####### # ####### # # ##### # # ### ##### # # # #####
           #                         #         #       #           #     #         #         #   #                   #   #     #
