################################################################################################################################
#       #   # #         #       #               #             #           #   #   #         #     # #           #   #         # 
# # ### ### # # ######### ##### # ########### ### ####### ### # ####### ### # # # # ####### # ### # # ### ### ### # # ####### # 
# #   #     # # #   #     #   #   #       #   #   #     # #   # #     #   # # # # # #   #   # #   #   #   #   #   #   #   # #   
# ### # ##### # ### # ##### # ########### # ### ####### # # ### # ### ### # # # # # # ### ### ######### ### ### ####### # # ####
# #   #       #     # #     #           # #     # #   # # #     #   #   #   #   #   #   #   #   #       # #   # #       #   #   
# ########### # ##### # ############### # ####### # # # # # ####### ### ############### ### ### # # ##### ### # ### ####### # # 
# #     #   #   #     #         #     # #     #     #   # #         #                 #   #   # # # #     #S# #     #   #   # # 
# # ### # # ##### ##### ##### # ##### # ##### # ######### # ######### # # ############### ### # ### # ##### # ### ### # ### # # 
#   #   # # #     #   # #   # #   #   #         #         # #       # # #               #     #   #   #         # #   #   # # # 
# ### ### # # ##### # # # # # ### # ############# ######### # ##### # ############### # ######### ############# # # ##### # # # 
#   # #   #     #   # #   # # #   #     #         #         # #   # #         #     # #           #         #     # #     # # # 
# ### # ##### # ##### # ### ### ####### # ######### ######### # ### # ####### # ### # ### # ####### ####### # ##### # ##### # ##
# #   # #   # #           #   #     #   # #   #   #     #   # # #   #     #   #   #   #   #       #   #   # # # #   #   #   #   
# # ### # # ######### ####### ##### # ### # # # # ##### # # # # # ######### ##### ##### ### ######### # # # # # # ##### # ##### 
# # #   # #         #       # #   # # #   # # # # #     # #     #       #   # #   #     #         #   # # # #   #     # # # #   
# ### ### ######### ####### # # # # # # ### # # ### # ### ############# # ### # ### ##### ####### # ### # # # ####### # # # # ##
#       #   #     #   #     #   # #   # #   # # #   # #   #             #   #   # # #           # # #   #   # #     # # #   #   
# ######### # ####### # ######### # ### # ### # # ### # ### ############# # ##### # # ##### ##### # # ####### # ### ### # ##### 
#     #   # # #     # # # #   #   # #   #   #     #   #   #   # #     #   #     #   # #     #     # #   #     # # #   # # #   # 
### ### # # # # ##### # # # # ####### ### ######### ### ##### # # ### ####### # ####### ### # ##### ### ####### # ### # # # # # 
#   #   #   # # #     #   # #     #   #   #     #   #   #     # #   #       # #   #     #   #   #   #   #       #     #   # # # 
# ### ####### # ### ####### ##### # ### ### ### ##### ### ##### ### ####### ### # # # ### # ### ##### ### ############# ### # # 
#   # #     # #     #     # #   #   #     # # #     # #   #             # #   # # # # #   #   #       #   #           #     # # 
# # # # ### # ####### ### # # # ##### ##### # ##### # # ### ########### # ### # # # # ##### # ######### ### ####### # # ####### 
# #   #   #         # #   #   #   #   #     #       # # #   #         # #     # # # #     # #         # #     #     # # # #     
# ################# # ####### ### ##### ############# # ##### ####### # ######### ####### # # ### ##### ####### ##### # # # ####
# #                 #       # #   #   #   #     #     #   #   # #     #         #   #     # #   #       #   #   #           #   
# ####### ######### ####### ### ### # # ### ### # ####### # ### # ############# # # # ##### ### ######### # # ####### ##### ### 
# #     # #   #   #   #   #   #     #   #   # #         #       #     #         # # # #   #   #         # # #   #   # #   #     
# # ### ### # # # # # # ##### # ######### ### ######### ########### # # ########### # ### ### # # ####### # ### # # # # # ##### 
# #   #     #   #   #       # #   #     #         #   #   #       # # # #   #       #   #     # #       # # #   # #   # #   # # 
# ### ######### ####### # ### # ### ### ### ####### # # ### ##### # # # ### # # ####### ####### ####### # # ######### # ### # # 
# #   #   #   # #     # #     #     #   #   #       # #   #   #   # # #   #   #   # #   #     #     #   # #     #   # #   # #   
# # ### # # # ### ### # ############# ### ### ####### ### # ### ##### ### ####### # # ### ### ##### # ### ##### # # ##### # ### 
#   #   #   #   # #   # #       #   # #   #   #     #   # # #   #     # #         # # # # #         # #   #   #   #       # #   
### # # ####### # # ### # ##### # # ### ### ### ### ### ### # ### ##### ########### # # # ########### # ##### ############# # # 
# # # # #     #   #   # #     #   #       #     #   #   #   #   #   #   #   #     #   # #   #   #             #     # #   # # # 
# # # ### ### ####### # ##### ########### ####### ### ### ##### ### # # # # # # ####### ### # # # # ####### ### ### # # ### ### 
#   #   # #   #     # #         #   #   #   #     # #     # #   # # # #   # # # #   #   # # # #   # #     #       #   #     #   
# ##### # # ### # # # ##### ##### # # # ### # ##### ####### # ### # # ##### # # # # ### # # ######### ### ##### # ########### ##
# #     # #   # # # #     # #   # #   #   # # #     # #     #   # # # #     # # # #     # #     #       # #     #               
# # ##### ### # # # ##### # # # # ####### # # ### # # # ####### # # # ######### # ####### ##### # ####### # ####### ########### 
# #       #   # # #       #   #   #     # # #   # #   #   #     # # # #   #     #   #         #   #   #   # #     # #     #     
# ############### ##### ##### ##### ### # # ### ##### ### # ##### # # # # ### ##### # ### # ####### # # ### ##### # # # ### ####
# #         #     #   #       #     #   # #   # #       # # #     # #   #     #     # #   #     #   # # # #       #   #   #     
# # ####### ####### # ### ### # ##### ### ##### # ####### # # ### # ####### ### ##### ######### # ### # # ############### ##### 
# #     # #   #     #   # #   # #   #   # #             # # #   # # #   #   #   #   #   #   #   #   #   #   #       #   #     # 
# ##### # ### # ####### # # # # # # ### # # ########### # # ### # # # # # # # ### ##### # # ####### ##### ### ##### # # ####### 
#   #   #   # #   #     # # # #   # # # #       #     # #   #   # # # #   # # # #       # #       # #   #   # #   #   # #     # 
### # ### # # ### # ####### # ##### # # ####### # ### ####### ### # ####### # # # ####### ####### # # # ### # # ####### # ### # 
#   # #   # # #   #   #   # #     #   #       # #   #     # # #   #   #   # #       #   #   #   # # # # #   # #   #   #   # # # 
##### # ### # # ##### # # ####### ########### ##### ##### # # # ##### # # # ### ##### # # ### # ### # # # ### ### ### ##### # # 
#     # #   #   #   # # # #     #   #       #   # # #   # #   # #   # # #       #     #   #   #     # # #   #   #   # #     # # 
# ##### # ####### ### ### # ### ### # ######### # # # ### # ### # # # ##### ### # ######### ########### ### ### ### # # ### # # 
# #     #     #     # #   # #     #         # #   # #     #   # # # #     # #   # #     # # #   #     #   #     # # # # #   #   
# # ### ##### ##### # # ### ##### ######### # ### # ######### # # # ##### # # # # ### # # # # # ##### ### ####### # # # ####### 
# # # # #   #   #   # # #   #   #   #     #     # # #   #     # # #   #   # # # #   # # # #   #       # #   #     # # # #   #   
# # # # ### ### # ### # # ### # ### ##### # ##### # # ### ##### # ### # ##### # ### # # # ############# ### # ### # # # # # # # 
# #   #     # # #   #   #   # #   #     # # #     # # #   #     # #   # #   # #       #           #       # #   # # # # # # # # 
# ########### # # ######### ##### ##### # # # ##### # # ######### # ### ### ### # ############### # # ##### ### # # # # # ### # 
#       #       #         #     # #   # # # # # #   #             #   #   #   # # #     #   #     # # #     #   #   # # #     # 
####### ### ##### ####### ##### # ### # # # # # # ######### ##### ### ### ### # # # ### # # # ####### # ##### ####### # ####### 
# #   #   #             #     #   #   # # # # # # #   #     #   #   #   # # #   # #   #   # # #     # #   #   # #     #   #     
# # ##### # ##### ######### ####### ### # # # # # # # ####### # ### ##### # ##### ### ##### # # ### # ### # ### # ####### # # # 
#               #   #     #         #   #         # # #     # #   # #     #     #   # # #   #   #   # #   # #           #   # # 
########### ### ##### ### ##### # ### ########### # # # ### # ### # # ######### # # # # # ####### ### # ### ########### ##### # 
#             #     #   #   #   #   # #     #   #   #   #   #   # # #     #   # # # #   # #     #     #   #         # #       # 
# ######### ####### ### ### # ####### # ### # # # ####### ####### # ##### # # # # # ### # ### # ##### ### ######### # ### # # # 
# #   #       #   #   # #   #         # #   # # #     #   #     #     #   # # #   # #   # #   # #     # #     #   # #     # # # 
# # # ####### # # ##### # ######### ### # ##### # ##### ####### ### ### # # # ##### # ### # ### # ##### ##### # # # ####### # # 
#   #   #   # # #       #         #     #       # #   #     #   #   #   # # # #     #   # # #   #       #   # # #           # # 
####### # # # # ######### ####### # ### ######### # # ##### # ##### # ##### # ##### ### ### # ######### # ### # ############### 
#   #   # # # #       #   #     # #   #             # #   #   #     # #     #     #   #     #         #   #   #   #         #   
# ### ### # ######### ##### ##### ### ### # ##### ### # # ##### ### # ########### # # ############### ### # ##### # ####### # ##
#   #     #         #       #     #   # # #     #   #   # #   #   # #     #       # #         #   # #     #   #   # #     #   # 
### ############# # ######### ##### ### # ##### ########### # ### # ### # # ######### ######### # # # ### ### # # # ##### ### # 
# #   #   #     # #     #     #   # # # # #   #   #       # # #   # #   # #         # #         # #   #   # #   # #     #     # 
# ### ### ##### # # ##### ##### # # # # # # ##### # ##### # # ##### # ############# ### ######### ##### # # ##### ##### ####### 
#   #   #       # # #     #     #   # #   #     # # #     # # #   # # #           # #   #   #   #       #             #   #   # 
# ##### ####### # # # ####### ####### ######### # # # ##### # # # # # # ######### # # ##### # # # ########### # ### # ### # # # 
#       #       # # # #     #   # #   # #   #   #   #   #   # # #   # # # #   #   # #     #   #   #     #     # #   #   #   #   
# ####### ##### # ### # # # ### # # # # # # # ######### # ### # ##### # # # # # ### ##### ######### ### # ##### # ### # ########
#       #   #   #     # # #     #   # #   # #     #   # #   # # #   #   #   # #   #   # # #       # #   #     # # #   #         
####### # # # ######### # ####### ### # ######### ### # ### # # # # ##### ####### ### # # # ##### # ##### ### # # ### ######### 
#   #   # # #           # #   #   #     #       # #   # #   # # # #     #     # # #   # #   #   # #   #   #   # #   #     #   # 
# # # ##### ########### # # # ##### # ### ##### # # ### ##### # # ##### ##### # # # ### ####### # ### ### # ### ### # # ### ### 
# #   #   # #           #   # #   # # #   #     # #   #   #   #   #             #   #   #       #   # #   #   # #   # #   #     
# ##### # # ### ### ##### ### # # ### # ######### ### ### # ####### ####### ### ##### # # ######### # # # ### # # ####### ######
#   #   #   #   #   #   #   # # #   # #   #   #   #   # #   #     #   #   # #   #   # # # #       # # # #   # # #     # #       
### # ####### ####### # ##### # ### # # ### # # ### # # ##### ### ##### # ### # # # # # # ####### # # # # # # # ##### # # ##### 
#   # #     # #     # # #     #   # #   #   #   #   # #       # # #     #   # #   #   # #         #   # # # # # #   # #   #     
# ### # ### ### ### # # # ######### # ### ####### ### # ####### # # ####### # ######### ######### ##### ### # # # # # ##### ####
#   # # # #     # #   #   # #         #   #       # #   #   # # # #   #     #   #   # #                 #   # #   # # #   #     
### # # # ####### ######### # ######### ##### ##### ####### # # # ### # ####### # # # ########### ### ### ### ####### # # ##### 
# #   # #       # #             #     # #   # #             #   #   # # #     # # # #   #         #   #     # #   #   # #   #   
# ### # ####### # ### # # ##### # ### # # # # ####### ######### ### # # ### # # # ### # # ### # # # ####### # # # # ### ### ####
# #   # #       #     # # # #   #   #   # # #       #   #     #   #   #     #   #     #   #   # # # #     # # # # #   # # # #   
# # # # ####### ####### # # # # ### ##### # # ##### ### ### # # # ######################### ##### # ### # # # # # ### # # # # # 
#   # #       #       # #   # #   # #     # #     # # #   # #   # #     #                   #     #   # # # # # #   #     #   # 
##### ####### ####### ####### ### # ### ### ##### # # ### # ##### # ### ### ############# ### ### ### # # # # # ############### 
#     # #   #     #           #   #     # #   #   # #   #   #   # #   #     #       #     #   #   #   # #   #   #     #   #   # 
# ### # # # ##### ############# ######### ### ##### # ####### ### ### ######### ### # # ### ####### ### ### ##### ##### # # # # 
# #     # #     #     #           #         # #     # #           # #     #   #   #   # #   #     # #   #   #   #       #   #   
# # ##### # ######### # ######### # # ##### # # ##### # ########### ##### # # ######### # ### ### # # ####### ##################
# #     # #         # # #       # # # #   # #   #   # # #           #   #   #       #   #   #   # # #   #   #  G  #           # 
# ####### ##### ### # ### ##### # # # # # # ##### # # # ####### ##### # ######### # ### ### ### # # ### # # ##### # ######### # 
# #       #     #   #     # #   #   # # # #       # #           #     #         # #   #   #   # # #   #   #     #   #       #   
# # ####### ##### ######### # ##### # # # ######### # ########### ############# ##### # # ### # # ### ######### ##### # ####### 
# #       #     #           #   # # #   # #   #   #     #       #           #   #     # #   #   # # #         # #     #     #   
# ####### ##### ### ########### # # ##### # ### ### ##### ##### ### ####### # ### ####### # ##### # ######### ### ######### # ##
# #       #   #   # #     #   # #       # #       # #       #   #   #     # # #   #       #   #   # #   #   #     #       #   # 
# # ####### # ### # # ### # # # ####### # ####### # # ####### ### ### ### ### # ##### # ##### # ### # # # ######### ########### 
#   # #   # #   # # # # #   # # # #     # #   #   # #   #   #   #   # # #     # #   # # #     # # # # #   #   #                 
# ### # # # ### # # # # ##### # # # ##### # # # ### ### ### # # ### # # ####### # # ### ### ### # # # ##### # ########### ######
#       # #   # # # #   #   # # #   #   #   # #   #   #   # # # # # #   #   #   # # #   #   #   #   # #     #     #     # #     
# ########### # # ##### # # # # # ### # # ### ### ### ### # ### # # ##### # # ### ### ### ### ### ### # ######### # ### # # # # 
#     #   #   # #       # # # # # #   # # #   # # # #   # #     # #   #   #   #   #   #   #   #     #   #       #   #       # # 
# ### # # ##### ######### # # # ### ### ### ### # # ### # ####### ### # ####### ### # ##### ### # # ##### ########### ####### ##
#   # # #       #         #   #     #   #   #         # #         # #   #   #   #   # #   # # # # #       #   #     #   #   #   
### # # ######### # ################# ### ##### ####### ######### # ##### # # ##### # # # # # # # ##### # # # # ### # ### # ### 
#   #   #   # #   # #     #   #     # #   #     #     #     #   # #   # # # # #     # # # # # # #     # #   # #   #   #   #   # 
# ######### # # ##### ### # # ### # # ######### # ### ##### ### # # # # # # # ### ### # ### # # ##### ##### # ### ##### ##### # 
# #         # # #     #   # # #   # #       #   # # #   # #         #   # #   #   #   #   # # # #   # #   # #     #     #     # 
# # ######### # # ##### ### # # # ####### # ### # # ### # ##### ####### # ##### ### # ### # # # # ### # # ######### ##### ##### 
# # #     #   # # #   #   # # # # #     # #   # #     # #       #       # #   # # # #   #   #   #   # # #   #       #   # #     
# # # ##### # # # # # ### ### ### # ### ##### # ##### ### # # ### ##### # # # # # # # ####### ### # # # ### # ####### # # # ####
#           # #     #   #         #   #       #           # #   #     #     #   #   #             # #     #   #       #   #     
