################################################################################################################################
################################################################################################################################
#           #   #   #                   #               #   #           #     #                   #                 #         # 
# # ### ### # # # # # ################# ### ### # ##### # ### # ##### # # # # # ################# ##### ##### ##### # ##### # # 
# #   #   #   #   # # #       #     #       #   #     # #S    # #     #   # # #   # #   # #       #   #   #     #   # #   # #   
# ####### # ### ##### # ##### ##### # # ##### ####### # ####### # ##### ### # ### # # # # # ####### # ##### # ### # # # ### ####
# #   # # # #   #     #     # #     # # #     #       #         #   #   #   #     #   #   # #       #     # #   # # # #     #   
# # # # # # # # # ######### # # ##### # # ##### ########### ####### # ### ############### # ### # ####### ### # # ### ####### # 
# # # #   # # # #   #       #   #   # # #     #   #       #       # #   #   #       #   # #   # # #     #   # # #     #       # 
# # # ####### # ### # ############# # # ##### ##### ##### ##### ### # # ### # ##### # ### ### # # ##### ### # # ####### ########
# # #       # # # #   #     #     #   # #     #   # #         # #   # #   # # #     #   # #   # #     #   # # # #   #   # #     
### ####### # # # ##### # # # ### ##### # ##### # # ######### # # ##### # # ### ####### # # ######### # ### # # # # # ### # ### 
#   #   # # # # #       # #   #         #   #   # #     #   # # #     # # #   # #   #   # #     #   # #     # #   # # #   #G#   
# ##### # # # # ### ##### ####### ########### ### # ### ### # # ##### # ##### # # # # # # ##### # # ### ##### ####### # ### # ##
#         # # #   # #     #       #           #   #   # #   # #     # # #     #   # # # #     # # #             #   # # #   #   
# ######### # ### ### ##### # # ### ########### ##### # # ### ####### # # ######### ### # ##### # ####### ####### # # # # ######
# #     #   # # #     #     # # #   #     #   #     # # # #   #       # #   #     #       #         #   #     #   #   # #   #   
# # ### # ### # ####### ##### # # ####### ### ##### ### # # ### ####### ### ##### ####### # ######### # ##### # ####### ### # # 
# #   #   #   #           #   # #       # #       #     #     # #     # # #       #     #       #     #     # #   #   #   # # # 
# ######### # ########### # ######### ### # ### ############# # # ### # # ######### ### ### ##### ######### # ### # ### ### # # 
# #     #   #     #       # #   #   #   # # #   #         #     # #   #           #   #     #   #     #   # # #   #   #   #   # 
# # ### ##### ### # ##### # ### # # ### # # # # # ####### ####### # ### ####### ########### # # ##### # ### ### ### # ### ##### 
#   # # #   #   # #   #   #     # # # #   # # # #     # #     #   # #   #     #     #     #   #     # #   #   #   # # #     #   
##### # # # # ### ### ### ####### # # ##### # # ##### # ##### # ### # ### ### ####### ### # ######### # # ### ### # ### ### # ##
#     #   # # #   #   #     #     #   #   # # #     #     # #   # # # #   #   #       # # #       #   # # # #   # #     #   #   
# # ####### ### ### ### ##### ######### # ### ##### ##### # ##### # # # ### ### ####### # ##### ### ### # # ##### ####### # ### 
# # #     #     #   #   #   #     #     #     # #   #     #   # #   # # #   #   # #   # #   #   #   #   #   #   #         #   # 
# ### ########### ####### # ##### # ########### # ### ##### # # ##### # # ##### # # # # ### # ### ### # ##### # ############# # 
# #   #                   #     #   #   #   #   # #   #     # #       # #       #   #     # #   # #   # #   # #         #     # 
# # ### ### ### # ############# ##### # # # # ### # ##### ### # ### # # ############# ##### # # # # ### # # # ####### ### ##### 
# #     #   #   # #       #   #       #   #     # # #     # # # #   # # #       #   # #     # # #     #   # #     # #     #   # 
# ##### # ### # # ####### # # ##### # ########### # # ##### # # # ##### ### ##### # # # ##### # # ######### ##### # ######### # 
#       #   # # #       #   # # #   #     #   #   # #     # #   #     #   #     # #   #     # #   #   #         #       #     # 
### # ##### # # ####### ##### # # ####### # # # ### # ### # ### ##### ### ##### # ######### # ##### # # ############### ##### # 
# # #   #   # # # #   # #   # # #       # # #   # # #   # #   #     #   #     #               #     # # #   #         #         
# # ### # ##### # # # # # ### # ####### # # ##### # ##### ### # ### # ####### ####### ####### # ##### ### # # ### # # # ####### 
# #   # #     #   # #   #   #       #   # #   #   #     #     #   # #     #   #   #   #   #   #     #   # #   #   # #   #       
# ### # ##### # ### ####### ### # # # ### ### # # ##### ######### # ####### ### # ##### # # ####### ### # ##### ### ##### ##### 
#     #     # #   # #     #     # # # #   #   # # #   # #         #   #   # #   #       #   #       # #   #     # #     #   # # 
### ### # ### # ### ##### ####### # # ##### ##### # ### ####### ####### # ### ############# # # ##### ##### # # # ##### ### # # 
#   #   # #   #   #     # #       # #       #       #   #       #       #   # #   #       # # # #     #     # # # #   # #   #   
# ### ##### ##### ##### # # ####### ######### ####### ### ### ### ######### # # # # ##### # # ### ##### ##### # # # # ### ##### 
# #   #   #   # # #     #   #   # # #             #   # # # # #   #       # #   #   #     # #     #     #     # # # #   # #   # 
# # ### # ### # # # ######### # # # ### # ##### # # ### # # # # ### # ### # # ####### ##### ####### # ### ### # # # ### # # # # 
# # #   # # # #   #         # #   #   # # #   # # # #     #   # # # #   # # #       #     #         #   #   # #   #   #   # #   
# # ##### # # ############# ##### ### # # # # # # # ### ####### # # ### ### # ##### ##### ############# ### ######### ######### 
# # #     # # #     #     # #     #   # #   # # # #   # #     # # # # #     #     #     # #       #       # #       # #     #   
# # # ##### # # ### # ### # # # ### ### ##### ### ### # # ### # # # # ################### # ##### # ##### # # # ##### # ### ### 
# #   #     # # #   # #   # # # #   #   #     #   # # # #   #   # # #       #           # # #   # # #   # #   # #   #     #   # 
# ##### # # # # # ### # ### # # # ##### ####### ### # # ### ##### # # ##### # ######### # # # ### ### # ####### # # # ##### # # 
#       # # #   # #   # #   # #       # #   #       # #   # # #   #   #   #   #   #   #   # #     #   # #       # # # #   # # # 
# ### ### ####### # ### # ########### # # # ######### # ### # # ####### # ##### # # ####### ####### ### # ####### # ### # ### # 
#   #   # #       # # # #       # #   # # #   #   #   #   # #         # #   #   #       # #         # # # #       # #   # #   # 
# ##### ### ##### # # # ####### # # ### # ### # # # ##### # ######### ### # ####### ### # ########### # ### ####### # ### # ####
# #     #   #   # #   #     #   #   #   # # #   # #     # #   #     #   # # #     # # # #         #   #     #     # # #   #     
# # ##### ### # # ######### # ### ### ### # ##### ##### ##### # ### ### # # # ### # # # ##### ##### ########### # # # # ### ### 
# # #   # #   # #     #     # #   #     #     # # #     #     #   #   #   #   # # # # #       #     #           # #   #   # # # 
# # # # # # ##### # ### ##### # ##### ####### # # # ##### ####### # # ######### # # # ######### ##### ##### ##### ####### # # # 
# #   # # #     # #   #       #     #         # # # #   # #     # # # # #     #   #     #   #   #     #   # #     #     # #   # 
######### ##### # ### ############# # ######### # # # # # # ### ### # # # ##### ##### ### # # ######### # ### ### # ### # ##### 
#       # #   #   #                 # #         # # # #   #   #   # #   #   #   #     #   # #   #       #   # #   # # # #     # 
# ##### # ### ##### ############# ### # ######### # # ##### # ### ##### ### # ####### # ### ### # ######### ### # # # # ##### # 
# # #   #   #     # #           #           #   # #   #   # # # # #   #     #       # #   # # #   #         #   # # #   #   # # 
# # # ##### # ### # # ######### ### # # # # # # # ##### # ### # # # # ### ######### # ##### # ##### ######### ### # ####### # # 
# # #       #   # # #     #   #   # # # # # # # #     # #     # # # #   #   #     #   #     # #   #     #       #   #       #   
# # ############# # # ##### # ### # # # # ### ####### # ####### # # ### ### # ####### # ##### # # ##### # # ####### # ##### ####
# #     #   #     #   #     #     # # # #     #       #     # #   #   #     # #     # # #     # #     # # #   #   # # # #       
# # # ### # # ### ##### ########### # # ####### ########### # # ##### ##### # ### # # # ### # # ####### ####### # # # # # ##### 
# # # #   # #   # #   # #     #     # #       # #   #   # # #     #   #     #   # # # #   # # # #     #   #     # #   #   #   # 
# # ### ####### # # # # # ### ####### ### ### # # # ### # # ##### # ####### ### # # # ### # # # # ### ### # ##### ######### # # 
# #             # # # #   # # #     #   #   # # # # #   # #   #   #       # #     #         #   #   #   #   #   #           # # 
# ### ########### ### ##### # # ### ### # ### # ### # ### ### # ######### # ### ##### ####### ##### ######### # ############# # 
#   # #       #   #   #   #   # #       # #   #     #   #     # #       # #     #   # #     #         #   #   #         #   #   
### ### ##### # ### # # # ##### ######### # ########### ####### # ##### # ####### # # # ### # ####### # ### # ######### ### ### 
# #     #     #     # # # #       #       # #   #     # #       #   #   # #       # # # #   # #       #     #   #     #     # # 
# ####### ####### ### # ### # ### # ####### # # # # ### # ##### ### # ### # ####### ### # ##### ##### ##### ### # ### ##### # # 
#   #   # #   #   #         # #   # #     # # # # #       #   #   # # #   #   #   # #   #     #   #         # # #   #         # 
### # # # # # # ### # ######### ### # ### # # # # ######### # # # ### ####### ### # # ####### ##### # ####### # ####### ####### 
# # # # #   # #   # # #       # #   # # #   # # # #   #     # # #   #       #     #   #     #     # # #       #       # #       
# # # # ##### ##### # # ##### # # ### # ####### # # # # ##### # ### ####### ########### # # ##### # ### ############# # # ######
# # # # #   #     # # # # #   # #   #   #     #   # #   # #   #   # #       #         # # #     # # #   #             # # #     
# # # # # # ##### ### # # # ### ### ######### # ### ##### # ####### # ####### # # # # # # ####### # # ### ############# # ### # 
#     # # #     #   # # # #     # #   #   #             #   #   #   # #   #   # # # # # # #       #     #     #   #     #   # # 
# ##### # ######### ### # ####### # # # # ##### ####### ##### # # ### # ### ### ### # # # # ####### ########### # # ####### # # 
# #   #   #       #   #   #     #   #   # #   # #     # #     # #             # #   # # #   # #       #         # # # #     # # 
### # ### # ######### ##### ######### ### # # # # ### # # ##### ### ####### ### # ### # ##### # # ##### ######### # # # ####### 
#   #   #       #   # #         #       #   # #   # # # #     #   #   #   #   # # #   # #   # # # #     #   #     #   # #   #   
# ##### ### ##### # # ### ##### # ### ####### ### # # ####### ### ##### # ### # # # # # # # # # ### ##### ### ####### # # # # # 
# #   # #   #   # # #   #     # # #         #   #   #       # #   #   # #   # # # # # #   # # #   #   #     #     # # # # #   # 
# # # # # # # # # # ### ##### ### # ##### ##### ### ### # ### # ### # ##### # # # ### ##### # ### ### # ### ##### # # # ####### 
# # #   # #   #   # #   #   #     # #   #     #   # #   # #   # # # #   #   # # #   #   #   #     #   #   #   #   #   # #     # 
# ######### ####### # ### ########### # ### # ### # # ##### ### # # ### # ##### ### # ### ######### ##### ### # ### ### # ### # 
#   #     # #     # # # #   #     #   #   # # #   # #   #   # # # #   # #   #   #   # #   #       #   #   # #   #     # #   # # 
### # ### # ### # ### # ### # ### # ##### ### # ### ##### ### # # ### # ### # ### ##### ### ##### ##### ### ######### # ##### # 
# #   #   #     # #   #   # # #   # #     #   # #   # #   #   #     # #     # #   #   # # #     #     # # #   #   # # #     #   
# ##### ######### # ##### # # ##### # ##### ### # ### # ### # ####### ####### # ### # # # ### ####### # # # # ### # # ##### ### 
#                 #     # # #       # #     #   #           # #       #       #   # # # # #   #       # # # #     #             
# ##################### # # ######### # ### # ####### ######### ######### ### # ### # # # # ### ### ### # # ################### 
#   #   #   #     #     # #     #   #   #   #   #   # #       # #   #     # # # #   #   # #   #   # #   # #                   # 
### # # # # # ### # ##### ##### # ####### ##### # # # # ##### # # # ### ### # ### ####### ### ### # # ### ################### # 
#   # # # #   # # #   #     #   #             #   # #     # # # # #   # #   #   #       #   #   # # # #   #   #               # 
# ##### # ##### # ### # ### # ##### # # ##### ##### ##### # # # # ### # # ##### ####### # # ### # ### # ### # # ############### 
# # #   # #     #     # #   # #   # # #   # #     #   #   #   # # # #   #   # #   #     # #   # #     # #   #   #   #           
# # # # # # ############# ### # # # # ### # # ### ### # ####### # # ### ### # ### # ##### ### # ####### # ####### # # ##### ### 
# #   # # # #           #   # # #   #   #   # #     # #   #     # #     #   #   # # #   # # # #   #         #   # #   #   #   # 
# ##### # # # ######### ### # # ####### ##### # ### # ### # ##### ##### # ### # # # # ### # # ### # ####### # # # ##### ##### # 
#       #   # #   #   #     # #   # #       # #   # #   #   #   # #   # #     # #   #   # #   #     #     #   #           #   # 
# ########### ### # # ##### # ### # # # ##### # # ##### ### # # # # # ######### ##### # # ##### ##### ### ########### # # # ####
#     #     #     # # #     # #   #   # #     # #     #   # # # #   #     #     #   # #   #     #       # #     #   # # # # #   
# ### # ### ####### # # ##### # ######### ##### ######### # # # ### ##### # ##### # # ##### ##### ####### # ### # ### ### # ### 
# # # #   #       # #   #   # # #   #   # #     #   #   # #   #   # #   #   #   # # # #           #       # #   #   # #   #     
# # # ### ####### # ##### ### # # # # # # # ### # ### ### # ##### # # # ##### # # # # # ##### ##### ####### # ##### # # # ######
#   #   # #   #   #       #   # # # # # # #   #   #   #   #   #   #   #       # # # #   #   #     #   #     # #     # # #       
### ### # # ### ######### # ##### # # # # ### ##### ### ##### ########### # ### # # ##### # # ####### ####### # ##### # ####### 
# #   #   #     #   #     #       #   #   #       #   # #   # #         # # #   # # #     # # #     #     #   #       #   #     
# ### ########### # # ##################### ### ##### # ### # # ####### # # ##### # # ##### # # ### ##### # ############# ######
#   #             # # #                     #   #   #   #   # # #       # #     # # # #     # #   #     #   #             #     
# # ########### ##### # ####### # # # ##### # # # ####### ### # # ####### ##### ### # ####### ### ##### ##### # ########### ### 
# #       #     #     #   #   # # # #   #   # # #     #   #   # # # #         #   # # #     # #   #   #   #   # #     #     #   
# ####### # ##### ######### # ### ##### # ### ####### # ### ### # # # ##### ##### # # # ### # # ### # ### # ##### ### # ##### # 
#     #   # #   # # #     # #     #   # # #   #       #   # #   # #   #   #     #   #   # # # #   # #   # # #   #   # #   # # # 
# ### # ### # # # # # ### # # ##### # # # # ### ######### # # ### ### # # # ### ######### # # ### # # ### # # # ### # ### # # # 
#   # #   # # #   #   #     # #   # # # # #       #   #   # # # # #   # # # #               #   # # # #   # # #     #   # # # # 
### # ##### # ################# # # # # # ####### # # # ### # # # ##### # ### ### ####### ### ### # # # ##### ######### # # # # 
#   # #     # #       #   #     # # #   #     #   # # #   # # # #   #   # #   # #       #     #   # # #     # #     # #   # # # 
# ##### ##### # ##### # # # ##### ########### # ### # ### # # # ### # ### # ### ####### # ##### ### # ##### # # ### # ##### # # 
#               #       #   #                 #     #         #     #   #   #           #           #     #       #       #   # 
################################################################################################################################
