################################################################################################################################
################################################################################################################################
# #   #   #   #   #           #   #           #   # #       #       #               #         #   #     #     #     #     #     
# # # # # ### # ### # ####### # # # ##### # # # # # # ####### ##### ### ########### ### # ### # ### ### ### # ##### # ##### ### 
# # # # #   #   #   # #     #   #   #   # # #   #   #     #   #   #     #     #   # #   #   # #   #   # #   # #   # # #   #   # 
# # # # ### # ### ### # ### ######### ### ############### # ##### ####### ### # # # # ##### # ### ### ### ### # # # # # # ##### 
# # # #   # #   # #   # # #         #   #     #         # #     #   #     #   # #   #   #   #   #         # # # # #   # #       
# # # ### # ### # # ### # ######### ### ##### # ####### # ##### # ### ### ##### ######### ##### ### ####### # # # # ### ########
#   # #   #     # #   # #     #     # #     # #     # # # #   # #   # #   #   #   # #   # #         #   # #   # # #   #   #     
# ##### ####### # ### # # ### # ##### ##### # ##### # # # # # # ### # ##### # ### # # # # # ######### # # # ##### # # ### ##### 
#   #   #     # #   #   # #   #   #           #   # #   # # #   #       #   #     #   #   #     #   # # #           #   #       
### # ##### # # ### ##### # ##### # ########### # # ##### # ########### # ######### ####### ##### # # # # ########### # ####### 
#   # #   # # #   #     # #     # #   #   #   # # #     # # #       #   # #     #   #   #   #   # #   #   #     #     # #       
# ### # # # # ### ##### # ##### # ##### # # # # ####### # # # ##### # ### ##### # ### # # ### # # ####### # ### ####### # ######
#     # # # # # # #   #   #   # #   #   # # # #   #   # #   #   # # #   #   #     #   # # #   # #     #   #   #       # # #     
####### ### # # # # # ##### # # ### # ### # # ### # # # ####### # # ### ### ### ### ### ### ### ##### # ### ######### ### # ####
#     #   # #       #   #   # #   #   # #   # #   # # # #     #   #   #   #   # #   # #   #   #     # #   # #  S#     #   # #   
# ####### # ######### # # ####### ##### ####### ### # # # ### ####### ### ### # # ### ### # # ##### # ### # # # # # ### ### # # 
#       #   #   #   # # #       # #   #     #   # # #   #   #       #       # # # # #     # #     # #   #     # # # #   #     # 
# ######### # # # # # ####### ### # # # ### # ### # ####### ##### ######### # ### # # ##### ####### ### ### ### # # # ######### 
# #         # # # # #         #   # #   #   #             #     #         # #     # #   #   # #   #   # #   #   # # #   #   #   
# # ##### ### # # # ##### ### # ######### # ### ### ##### ##### ########### ####### ### # # # # # ### ### # ##### ##### # # # # 
# # #     #   #   # #   # #   #           #     #   #     # #   #                 #   # # #   # #   #     # #   #     # # # # # 
# # ##### # ####### # # ### # ########### ####### ### ### # # ### ### ####### ### ### # ####### ### ####### # # ####### # # ### 
# # #   # #   #   # # #     # #         # #   #   #   # #   # #     # #       # #     # #     # # # #     # # #       # # #   # 
# # # # # ##### # # # ####### ####### # # # # # # # ### ### # ##### ### ####### # ##### # ### # # # # ### # # ####### # # ### # 
#   # # # #     # # #G# #   #       # #   # #   # #     #   #     # #   #     #   #     # # #   # # #   # #     #   #   # # #   
### # # ### ##### # # # # # ####### # ##### ############# ####### # # ### ### # ### ##### # ##### # ### # ##### ### ##### # ### 
#   # # #       # # # #   #       # #     #     #     #         #   #     #   #         # #       #   # #     #           #   # 
# ### # # ####### # # ########### # ##### ####### ### ######### ### ####### ########### # ##### # ### # ##### ############# ### 
# #   #   #       # # #           #       #   #   # #   #     #   #   #     # #       #     #   #   #   #   #         #   #   # 
# # ############### # # ######### ### ##### # # ### ### ##### ### ### # ##### # ##### ##### # ##### ##### # ######### # ##### # 
# # #       #     #   # #       #     #   # # #   #   #   #     #     #       #   # #   #   # #     #   # #   #     # #       # 
# # # ##### # ########### ##### # # ### # # # ### # # ### # ######### ########### # ### # ##### ##### ### ### # # ### ####### # 
# #   #   # #       #     #       # #   #   #     # # #   # # #   # #   #         #   # #   #   #         #   # #   #       #   
# ##### # # ##### ### ##### ### ##### ############### # ### # # # # # # # ########### # ### # ############# ### ### ####### # ##
#   #   # #     #   # #     #   #     #   #           #   #   # #   # # #     # #     #   # #         #         # #   #     #   
# # # ### ##### ### # ########### ##### ### ### ### ##### ### # ##### ####### # # ####### # ######### # ####### # ### # ####### 
# # # # #     #   #   #   #     # #         # #   #     # # #       #       #   #   #     #     #             # #     # #   #   
# ### # ### # ### ##### # # ### # # ######### ### ##### # # # ##### ### # # ### ### # ######### # ######### # ######### ### # ##
# #   # #   # #   #   # #   #   #               # #   # # #   #   #     # #   # #   #   #                 # #   #   #   #   #   
# # ### # ### # ### # # ##### ### # # # # # ##### # # # # ##### # ####### ### # # ### # # ############### ##### # # # ### # ### 
#   #   # #   #     #   #   #     # # # # # #     # #   #   #   #     #     # # # #   # #   #   #       #     #   # # #   #   # 
# ### # # # ############# # ######### # # ### ####### ##### # ####### ##### # # # ##### ### # # # ##### ### # ##### # ####### # 
#     # # #   #   #       #     #     # #   #       # #     # #     #     # # # # #     #   # #   #   #   # #     # #   #     # 
######### # # # # # ########### # ##### ### ####### # # ### # ### ####### # ### # # ##### ### ####### ### ### ### ##### # ##### 
#         # # # # # #     #   # # #     #   #   #   # # #   #   #       # # #   # # #   # #   #     #   #   #   #     # # #   # 
# ######### # # # # # # ### ### # # ####### # ### ##### ####### ####### # ### ### # ### # # ### ### ### ### ### ####### # # # # 
# #   #     # # # #   #     #   # # #     # #   #     #         #   #   #   # # # #   # # #     #   #   # #   #   # #   # # # # 
# ### ##### # # # ### ####### ### # # ### ##### ##### ########### # # ##### # # # ### # # ####### ### ### ### # # # # ### # # # 
#     #     # # # # # #   #   # # # #   #     # #   #     #       #   #   #   # #     # #   #     #       #   # #   #   # # #   
####### ##### # # # # # # # ### # # ### ##### # # # ##### # ######### # # ##### ####### ### # ##### ##### # ########### # # ####
#           # # # #   # # # #   # # #   #   # #   #       # #       #   #                   #     # #     #           # #       
# ### # ### # ### # ### # # # ### # # ### # # ############# # ##### ####### # ### ##### ##### ### ### ### ########### # ####### 
#   # #   # #     # #   # #     # # #   # #   # #   #     #   #     #     # #   # #     #   #   #   # #   #     #   # #     #   
### ### # # ####### # ### # ##### # ### # ### # # # # # # # ### # ### ### # # ### # ##### # ##### # # # # # ##### # # ##### # ##
#   #   # # #         #   #   #   #     # #   #   # # # # # #   # #   #   # # #   #   #   # #   # # # # # #     # # # #     #   
# ### ### # # ############### # ######### # # ##### # # ### # ##### ### ### ### ####### ### # # ### ### # ##### # # # # ####### 
#   #   # #   #   #         # #     #     # #       # #     # #     #   # #   #       # #   # #     #   # #     # #   # #     # 
# # ### # ##### # # ####### # ##### ####### ######### ####### # ##### ### ### # ##### ### ### ####### ### # ##### ##### ##### # 
# #   # # #     #   #   #   #   # #     #               #   #   # #   #   # # # #   #     #   #     # #   # #   # #       #   # 
# ### # # # ########### # ### # # ##### # # ##### ####### # ### # # ### ### # ### # ######### ### # # # ### # # # ### ### # ### 
# #   # # # #           # #   # # #   # # #   #   #       #   # #   # #   # #   # #   #       #   #   # #   # # #   # #   #     
### # # ### # ######### # ##### # ### # # ### ##### ######### ####### ### # ### ##### ##### ### ####### # ##### ### ### ### ### 
#   # # #   #       # #       #       # #   #       # #     # #     # #   # # #     #   #   #   #       # #       #     #     # 
# ##### # ### ##### # ####### ######### ### ######### # ##### # ### # # ### # ### ##### # ####### ##### # # ### ######### ### ##
# #     #   #     #   #   #   #         # #   # #     #     #   #   # #         #       #     #   #   #     #   #           #   
# # ####### # # # ##### # ### # ######### ### # # ### ##### # ### ### # ####### ############# ##### # ####### # # ####### ##### 
# # # #     # # #     # #   #   #   #   #     #   #   # #   # #   #           #           #   #     #         #     #   #   # # 
# # # # ####### ####### ### ##### # # # ########### ### # ##### ####### ##### # ########### ### ######### ######### # # ### # # 
# #   # #   #   #       # # # #   #   # #         # # # #   #   #     #   #   # #     #   # #         #   #   #   # # #   # #   
# ##### # # # ### ####### # # # ####### # ######### # # ### # ### ### ### # ### # ### # # # # ####### ##### # # # # # ### # ####
#     #   # #   #   #       # # # #     #       #   #   # # # #   #     # #   # #   #   #   # #       #   # #   # # # #   # #   
# ######### ####### # ####### # # # ##### ####### ### ### # # ######### # ### # ### ######### # ##### # # # ##### # # ### ### # 
#     # #   #   #   #   #     #   # #     #     #   #     # #       # # # #   #   #   #     # #     # # #   # #   #   #   #   # 
# ### # # ### # ####### # ######### # ##### ### ### # ##### ####### # # # ########### # ### # ##### # # ##### # ####### # # ####
# #   # #     # #       #     #   #     #   # #   #   #   #     #   #   #   #     # # #   # #   #   # # #   # #   #   # #       
# # ### ####### # ########### # # # ##### ### ### ### # # ##### # ### ##### # ### # # ### # ##### ### # ### # ### # # ######### 
# #     #     #   #           # #   #   # #   #   #   # #       # # # #         #   # #   # #     #   # #   #   # # #           
# ####### ### ######### ####### ##### # # # ### ### ### ######### # # # # ##### ##### ##### # ####### # # ##### # ####### ##### 
#       # # #         # #   #     #   # # #   #   #   #           # #   # #   # #   #     # #   #     # # #   #   #     # #     
# ####### # ######### # # ### ##### ### # ### ### ### ############# ### ### # # # # ##### # ### ### ### # # ####### ### ### ### 
#       #   #       # #       # #   #   #     #   #   #       #   #     #   #   # #     #   # #   # # # # #   #   #   #   # # # 
# ##### ### # ##### # ### ##### # ### ####### ##### ####### # # # # ##### ##### # ########### ### # # # # ### # # # # ### # # # 
#     #   # # #     #   #   #   # # # #     #     #         # # #   #     #     #   #       #     #   # # #   # #   #   # # # # 
### # ### # # # ####### ### # ### # # # ######### ########### # ### # ####### ##### # ######### ####### # # ########### # # # # 
# # #   #   # # #   #   #     #   #   #     #   # #         #   #   #   #   #       #   #       #       # # #         # #   #   
# # # ######### # # # ####### # ####### ### # ### # ############# ####### # # ######### # # ##### ####### # # ####### # ####### 
# # #           # # #   #   # #         #   #     # #             # #   # # #     #   # # #     # #   # #   #   #   # #   #   # 
# # # ##### # ### ##### # # # ####### ### # # ### # ### ### # ### # # # ### ##### # # # # ##### # # # # # ##### # # # ### # # # 
# # # #   # #         # # # #       # #   #   #   #     #   #   # # # #     #   # # # # # #     #   # # # #   # # # #   # # #   
# # # # # # ### ### # # ### ### ### # # ### ### # ##### # ##### ### # ####### # # # # # # # ######### # # # # # # ##### ### ### 
#   # # #   #   #   # #   #   # #   # # # # #   #       # #   #     #   #     # # # # #   # #   #     # # # #   #     #     #   
####### ############# ### ### # # ### # # # # ##### # # # ### ######### ####### # # ##### # ### # ##### # # ##### ########### ##
#   #   #   #   #   #   #   # # #     # # # #     # # # #     #       #   #               #     #   #   #   #   #         # # # 
# # # # # # # # # # # # ### # # # ##### # # ####### # # ############# ### # ##### ### ### ######### # ######### # ##### # # # # 
# #   # # # # # # # # # # # #   # #     # #     #   # # #             #   # #   # #   #     #       # #           #     # # # # 
# ##### # ### # # # ### # # ##### # ##### # ### # ### # # ############# ### # # ### ####### # ####### # ### ############# # # # 
# #     #     #   #   #   # #     #     #   # # # #   #   #   # #   #   #     #   #       # #     # # #   #         #       #   
# ##### ############# ##### # ### ##### ##### # # ######### # # # # # ########### ####### ####### # # ### ######### # ######### 
#     #     #   #   #       #   # #   #   # #   # #         # #   # #     #             #     # # #   #   #       # # #     #   
# ### ##### # # # # ########### ### ##### # ### # # ### # ### ##### ##### # # ######### ##### # # ### # ######### # ### ### # ##
# # # #   #   # # #   #   #   #     #   # # #   #   #   #   #       #     # # #     #   #   #   # #               #   # # #   # 
# # # # # ####### # # # # ### # ##### # # # # ##### ################# ##### ### ### # ### # ##### # ############# ### # # ##### 
#   #   #         # #   #     #     # # # #   #   # #                 #     #   #   #   # #   #   #   #   #         #           
# ################# # ############### # # # ### # # # ################### # # ### ##### # ### # ### ### # ####### # ####### ### 
# #   #   #     # # #     #   #       #   # #   # # # #   #   #     #   # # #   #     #   # # #   # #   #       # #       #   # 
# # # # ### ### # # # ### # # # ######### ### ### ### # # # ### ### ### # # ### ##### # ### # ### # # # ####### # ####### # # ##
#   # # #   #     # # #   # # #   # #   # #   # # #   # # # #   # #     # #   # # #   #   #   #   # # # #   #   #     #   # #   
##### # # ### ##### # # # # # ### # # ### # ### # # ### # # # ### ########### # # # ### ####### ### # ### ### ####### ##### ### 
#     #   # #   #   # # # # # #   # #     #   # #   # # # # # # #   # #     #   #   #       #   #   #   #   # #   #       # #   
# ######### ### # ### # ### # # ### ##### ### # ##### # ### # # ### # # ### ### ############# ######### ### # # # ### ### # # ##
# #             # #   # #   # #   #         #     #     #   # #   # # # # #   #     #   #   #   #     #     # # #     #   # # # 
# # ####### ##### # # ### ### ### ############### # ##### ### # ### # # # ### # ##### # # # ### # ### ####### ####### ##### # # 
#   #     # #   # # #     #   # #   #         #   #       #   # #   # # #     #   #   # # # # #   #   #         #   # #   # #   
##### ### # # ### # ####### ### ### # ##### ### ### ### ### ### # ### # ########### ### ### # ##### ### # ##### # # # # # ### ##
#     # # # # #   #   #   #   # #   #   # #     #     # #   #   # #   #   #         #   #   # #     #   # #   #   # # # #   #   
# ##### # # # # ##### # # ### # # ##### # ####### ### ### ##### # # ##### ########### ### ### # ####### # # # ##### # # ### ### 
# #     # # # #   #   # #     #   #     #       #   #   # #   #       #   #       #   # #   #   #       # # #   #     # # #   # 
# # ##### # # ### # # # ########### ##### ####### # # # # # # # ####### ### ##### ### # ### ### ######### # ### ##### # # ### # 
# #     # # # # # # # #     #       #     #       # # # # # # # #   #   #   #   #   # #   #   #         # # # #   #   # #     # 
# ##### # # # # # # ####### # ####### ##### ####### # # # ### # # # # ####### ##### # # # ### ######### # # # ### # ### ####### 
# #   # # #     # #   #     # #             #     # # #   #   #   # # #     #   # # # # #   # #     #   # # #   # #   #     #   
# # ### # ####### ### # ##### # ############# ### # ##### # ### ### # # ### # # # # # ##### # # ### ### ### # ### ### ##### ### 
# #   #   #     #   # #       # #         #   #   #     #   # # # # #   #   # #   # # #     # #   #   #   # #   #   #     #   # 
# ### ##### ### ### # ######### # ####### # ########### # ### # # # ##### ### ##### # # ##### ####### ### ### # ### # ### ### # 
#           #       #             #       #             #         #                                           #         #     # 
################################################################################################################################
