################################################################################################################################
################################################################################################################################
# #   #     #   #               #       #           #       #   #     #     #     #       #       #         #   #     #   #     
# # # ##### # # # ############# # ##### # ####### # # ##### ### # ### # ### # ### # ##### # ##### # ####### # # ### # # ### ### 
#   #     # # #   # #       #   # #   # # #     # # # #     #   # #   #   #   #   #   #   # #   #         #   #   # #         # 
# ####### # # ##### # ### ### ### # # # # ##### # # ### ##### ### ####### ##### ##### # ### # # ### ### # ####### # ######### ##
# # #     #     #     # #   # #   # # # # #     # #     # #     #       #     # # #   #     # #   # #   # #     # # #   #   #   
# # # ######### # ##### ### # ##### ### # # ##### # ##### # ### ####### ##### # # # ### ##### ### # # ##### ##### # # # # # ### 
# #   #       # #     # #   # #   #     # # # #   #         #   #     #     # # #   #   #   #   # # # #   # #   # # # # # # #   
# ########### # ##### # # ### # # # ##### # # # # # ### ##### ####### ##### # # ##### ### # # ### # # # # # # # # ### # # # ### 
#             #     #   # #   # # # #   # # #   # #   # #   #       # #     # #       #   #   #   # #   # #   # #     # # #   # 
# ####### ######### ### ### ### # # # ### # ##### ### # ### ####### # # ##### ####### # ####### ######### ##### ####### # ### # 
# #     # #   #   #   #   #     #   #     # #     #   # #   #     #   # #       #     #       #   #     # #   #   #   # # #   # 
# # ### # # # # # ### ### ########### ##### # ######### # ####### ##### # ####### # ######### ### # ### # # # ### # # # ### ### 
#   # # #   #   #     #   #             #   # #     #             #     # #   #   # #       # # # # # # #   #   #   #   #   #   
# ### # # ######### ### ### ##### ##### # ### # ### ############### ####### # # ### # ####### # # # # # ####### ######### ##### 
#     # #   #     #       # #     #   # #   # # # #   #       #     #       #   # # #   #   # # #   # #   #               #   # 
##### # ##### ### ### ### # # ##### # ##### # # # ### # ##### # ##### ########### # ### # # # # ##### ### # ### ##### # ##### # 
#   # #     #   # #   #   # #     # #     # # # #   #   #   # #   #   #   #     #     # # # # # #   #     #   # #   # #   #   # 
# ### ##### ### # # ### ### ####### ##### # # # ### ####### # ### ### # ### ### ### ### # ### # # # ######### # # # # # ### ### 
#       #   #   # # #     # #       #   # #   #   # #       #   #   #   #   #       #   # #   #   # #         # # # # # #   # # 
# ####### ### ### # # # # # # ######### # ####### # # ######### ### ##### ######### # ### # ####### ### # ##### # ### # # ### # 
# #G  #   # # # # # # # #   # #   #     #         # #     #     # # #   #         #     # # #     #     # #       #   #   #     
# ### # # # # # # # ### ##### # # # ############### # ##### ##### # # # ######### ### ### # # ### ####### ######### ##### # ####
# #   # # #   # # # #   #     # # #         #   #   #     # #     #   #   #   #   #   #   # # # #   #   #     #     #   #   #   
# # ### ####### # # # # # ##### # # ####### # # # ### ### # # ### ####### # # ##### # # ### # # ### # # ### # # ####### # ##### 
# # #   #     #   # # # #       # #   #   #   #   #   #   # # #   # #     # #       #     #   #   # # #   # # # #     # # #     
# # # ### ### # ### # ########### ### ### ######### ### # # # # ### # ##### ### ######### ####### # ##### ### # # ### # # # ####
# # #   #   #   #   #     #       # #               #   # #   # #   #       #   #       #         #     #   # #   # #   #   #   
# # ### ### ##### ######### ####### # ############### ### ##### ### ######### ### ##### ### ########### ### # ##### ##### ##### 
# #   # #   #   #   #   #   #     #   #       #     # #       #               # # #   #   #   #   #     # #   #     #     #   # 
# ### # # ### ##### # # # ### ### ### # ##### # ##### # ### ############### # # # # ##### # # # # # ##### ##### ### # ### ### # 
# #   #   #         # # # #   # #   # # # #   #       #   # #     #       # #   # #   #   # # # # #   #   #     #   #   # #   # 
# # ################# # # # ### ### # # # # ##### ####### # # ##### ##### # ##### ### # ### ### # ### # # # ########### # # ### 
# #       #   #   #   #   # # #   # #   # #     # #     # # #     # #     #     #   #   # #   # #   # # #         #     # # #   
# # ####### # # # # ####### # ### # # ### ##### ### ### ### ##### # ######### # ### ##### # # # ### # ########### ### ### # # ##
#   #   #   #   # # #   #   #   # # # #       #   # # #   #     # #     #     #   # #       #   #   #       #         #     #   
# ### # # ####### # # # # ### # # # # # ##### ### # # ### ####### ##### # ####### # # ##### ######### ##### ##### ##### # ##### 
# #   # # # #     # # #   # # # # # # #   #   # #     #   #     # #   #   #       # # #   #         # #   #   #   #   # #     # 
# # ### # # # ##### ####### # ### # # ### # ### ####### # # ### # # ####### ##### # ### # ######### # # # ### # ### # # ### ### 
# #   #     #     # #     #       # #     # #     # #   # # # #   # #     # #   # #     #   #     #   # #     #   # # #   #     
# ### ########### # # ### ### ##### ####### # ### # # ##### # ##### # ### # # # # ######### # ### ##### ########### # ##########
#       #   #     # #   #   # #     # #     #   # # #       #   #   #   # # # # #         # #   #     #   #     #   #           
# ####### # ####### ### ### # # ##### # ####### # # ########### ### ### ### ### # ##### # # ### ##### ### # ### # ############# 
# #   #   # #   #   # # #   # # #           #   #   #     #   #   #   #   #     #     # # #     #   #   #   #   # #   #   #   # 
# # # # ##### # # ### # # ### # # ######### # ####### ### # # ### # # ### ####### # ### # ####### ##### # ### ### # # ### # ### 
#   # #       # #   #   # #     #     #   # #           #   # #   # #   #       # # #   # #     #   #   #   #     # # #       # 
# ############# # # ##### ##### ### ### # # # ############### # ### ########### # # # ##### ### ### # ### ########### # ##### # 
#             # # # #   #     #   #   # # #   #             # #     #   #   #   # # #       # #     # #             #   #   # # 
# ######### # # # # ### ##### ### # # # # ##### ########### # # ##### # # # # ### # ######### ####### # ########### ### # # # # 
# #       # # # # #   # #   # #     #   #             #     #   #   # # # #   #   # #       # #       #         # # #   # # # # 
# ##### ### # # ##### # # # # # ####### ############# # ######### # # # # ##### ### # ##### # # ########### ### # # # ### # ### 
#   #   #   # # #     # # # # # #     #       #     # #       #   #   # # #   #   # #   # #   # #     #   #   #   #   #   #     
### # # # # ### # ##### # # # # # ### ### # ### ### ### ##### # ####### # # # # # # ### # ##### # ##### # ### # ####### ########
# # # # # # #   # #     # #   # # # #   # # #   # #   #     # #   #     #   # # # #     #     # #     # # #   # # #     #       
# # # # # ### ### # ##### ##### # # ### # # # ### ### ### ### ### # ######### ### # ##### ##### ##### # ### ### # # ##### ######
#     # # #   #   # #   #     # #   #   # # # #   # # #   #   #   #         #     # #   # #   #     #       # #   # # #     #   
####### # # ### ### # ####### # ##### ### ### # ### # ##### ### ########### ####### # # # # # ##### # ####### # ### # # ### # # 
#     # # #   # #     #     #     # # #     # #   # #     #   #       #   # #         # # # # #   # # #   #     #   #     #   # 
# ### # ##### # # ### # ### ##### # # ##### # ### # ##### ########### # ### # # ####### # # # ### # ### # ##### # ####### ######
# #   #     # # #   # #   #   #   # # #     # #   #     #             #   #   # #     # #   #   # #     #     # # #   #         
# # ####### # # # # ##### # ### ### # # ##### # ### ##################### ##### # ### # ####### # ########### ### # # ##### ### 
# # #       # # # #       #         # # #   # # #   #     #                 #   # # # #   #   #           #   #   # #     # #   
### # ### ### # # ### ############### # # # # # # # # ##### ### # ### ##### # ### # # ### # # ### ##### # # ### ### ##### # # # 
#   #   #   #   #   #         #     # #   # #   # # #     # #   # #   #       # #   # #   # #     #     # #     #   #   # # # # 
# ### # ######### # ### ##### # ### # ############# ##### # ### # # ######### # ##### # ### ##### # ##### ######### # # # ### # 
#   # # #   #     #   # #     # #   #   #   #           # #   # # #     #   # #     #   #   #   # #   #             # # #     # 
### # # # # # ####### ### ##### # # ### # # ##### ### ### # # # # ##### # # ####### ####### # # # ### # ##### # ##### # ####### 
#     #   # # # #   #   #     # # #   #   #     # #   #   # # # #     #   # #     #   #     # #     # #     # #   #   #   #     
# ########### # # ##### # ##### # ############# ### # # ##### # # ######### # # ##### # ##### ### # # ##### ##### ### ##### ####
# #         # #       # # #   # # #           #   # # #       # #         # # #       # #     #   # # #   #     #   #     # #   
# # ####### # ####### # ### # # # # ##### # ##### # # ######### ####### # # # ######### ####### # # # # # ##### ### # ### # # ##
# #   # #   #     #   #     #S  #   #   # # #   #   #   #       #   #   # #   #   #   #   #     # # # # #     #   # #   #   #   
# ### # # ####### # ################### # # # # ####### ##### # ### # ######### # # # ### # ### # # # # ######### # ### ####### 
#   #   #       # #     #   #   #     #   #   # #     #       #     # #   #     #   #   # # #   # # # #       # # # #   #       
# ##### ####### # ##### # ### # # ### ##### ### # ############# ##### # # ############# # ### ### # # ####### # # # # ### # ### 
# #     #     # #   #   #     # #   #   #     # #       #       #     # #       #       #   # #   # #     #     # # #     # #   
# # ##### ### # ### # ######### ### ### # ### # ####### ### ### # ### # ####### ####### ### # # ### ### # # ##### # ######### # 
# # #   #   # #     #             #   # #   # #     # # #   #   # #   # #   #   #     #     # #   #   # # # #     #   #   #   # 
# # # # # # # ####### ############### # ### # ##### # # # ### # # ##### # ### ### ### ########### ##### ### # # ####### # # ### 
# #   # # # #     #   #   #     #     # # # #   #   # #   #   # #     # #   # #   # # #     #     #   #     # # #     # # # #   
# ##### # # ##### # ### # # ### # ##### # # # # # ### ######### ##### # # # # # ### # ##### # # ### # ####### # # ### # ### ### 
#     # # # #     #     # # # # #   #   #   # # #     #   #       # # # # # #   #   #     #   # #   #     #   # # #   #     #   
##### # ### # ##### ##### # # # ### # ####### ######### # # ##### # # # # # ##### ####### ##### # ####### # ### # ########### # 
#   # #   # # #         #   #   #   #       # #         # #     #   #   # #             # #     # #       #   # #       #   # # 
# # # ### # # # ####### ####### # ######### # # ### ##### ##### ### ##### ##### ##### ### # ##### # ######### ######### # # # # 
# #   #   # # #       # #     # # # #   #   # #   #     # #   #   #     # #   #     #   # # # #   #         # #   #   # # # # # 
# ### # ### # ####### # # ### # # # # # # ### ### ##### ### # ### # # # # # # # ####### # # # # ########### ### # # # # # # # # 
# #   # #   #   #   # # # #   # #   # #   #           #     # # # # # #   # # # #       # #   #           #     # # # # # #   # 
### ### # ##### # ### ### # ### ##### ################### ### # # # ####### # # # ####### # ########### # ####### # ### # ##### 
#   #   # #     # #   #   # # #     #   #     #         #   #   # #       # # # #   #     #   #       # # #   # # #   # #   #   
# ### ##### ##### # ### ### # # # # ### ### # # ####### ######### ####### # # ### # # ####### # ##### # # # # # # ### # ##### ##
# #   #   # #         #   # #   # #   #     #   #     #         # #       # #   # # # #   #   # #     # #   # #     #   #       
# # ### # # # ########### # ##################### ############# # # ### ####### ### # ### ##### ### ######### ##### # ### ######
# # #   #     #           #   #   #     #   #     #       #   #   #   # #       #   #   #     #   # # #     #     # # #   #     
# # # ####### # ############# # # # ### # # # # ### ##### # # ####### ### ####### # ### ##### ### # # # ######### # # ### # ### 
#   # #     # # #       #   #   #   #   # #   #     #   #   # #     #     #   #   #   #       #   # # #           # #     # # # 
# ### # ### ### # ##### ### ######### ### ########### # ##### # ### ####### # # ################### # ############# ##### # # # 
# #   # # #   #   #   #   # #   #   #   # #       #   #       #   #         #   # #     #   #   # # #   #         #   #   #   # 
# ### # # ### ##### ##### # # ### ##### # # # ### ############# ####### # # ### # # ### # # ### # # # # # ### # ##### # ##### # 
#     #   # #       #     # #     #   # # # # # #     #   #   # #   #   # # #   #   # # # # #   # # # #   #   # #     #     # # 
##### ##### ####### # ##### # ##### # # # ### # ##### # ### # # # # # ### # ######### # # # # ### # # ##### ##### ######### # ##
#     #   #   #   # # #   # #     # #   #     #   #   #     #   # #   #   #           # # # #   # # # #   #     # #       # #   
# ### # ##### # # # # ### # ### ### ########### ### ### ####### # ##### ####### ####### # # ### # # # # # ##### # # ####### ### 
#   #         # #   #     #     #   # #     # #   # #   #     # # #         # # #     # # #         #   # #   # # #   #     # # 
### # ######### ########### ### # ### # # # # ### # ##### ### ### ##### ### # # # ### # # ##### ######### # # # # # # # ##### # 
#   # #       # #   #       #   #   #   # # #   # #       # #   #   #     #   #   # # # # #   #             # #   # #         # 
##### # ##### # # # ##### ### # ### ##### # # # # ######### ### # # # ### ######### # # # # # ##### ######### ##### ########### 
#     #     #   # #   #   #   # # #   #   # # #   #     #     # # # #   #       #   #   # # #     # #       #     #     #       
# ######### ##### ### # ### ### # ### # ### # ##### ### ##### # ### ### # ##### ### ##### # ##### ### ##### # ### # ### # ######
# #   #   # # #   #   # #   # # #   # # #     #     # #   #   #     #   #     #     #     # #   #     #   # #   # #   #   #     
# ### # ### # # ### ##### ### # ### # # # ### # ##### ### ### ####### ### ### # ##### ### # # # ####### ### ### ### ####### ### 
#       #   # #   # #     # #           # #   #     #     #           #   #   #         #   # # #   #     #   #     #       #   
##### ### ### ### ### ##### # ############# # ##### ####### ########### # # ### ##### ####### # # ### ### ### ####### ####### # 
#     #   #     #   # #       #   #         #   #   #       # #   #     # # #   #   #   #   # # #   # # #   #         # #     # 
# ### # ### ### ### # # # ##### # # ##### ### # # ### # ##### # # # ##### # ##### # # # # # ### ### # # # ############# # ##### 
# #   #     #     #   # #   #   #   #     #   # #   # #   #   # # #   #   #     # # # # # #     #   # # #             # # #     
# ### ### ####### ##### ### # ########### # ### ### ##### # ### # ### # # ##### ### # # # ####### ### # ##### ##### # # # ### # 
# #       #     #     # #   #           # #   # # # #     #     #   # # #     #   # # # #   # #         #     #   # #   #   # # 
### # ##### ### # # # ### # ########### ##### # # # # ##### ######### # # ### ### # # # ### # # ######### ####### # ####### # # 
#   # #   # #   # # #     # #     #     #     #   # # #   #           # # # #   # # # #     #       #     #   #   #   #   # # # 
# ##### # # ### ### ######### ### # ##### ####### # # # # ############# # # ##### # # ####### ####### ##### # # ##### # # # # ##
# #   # # #   # #   #       # #   #   # # #     # # # # # #     #   #   #     #   # #         #       #     #   #   # # # # #   
# ### # ##### # # ### ##### # ####### # # ### # # # # # ### ##### # # ### ##### ### # ######### ############### # # # # ### ### 
#   # # #   # # #     #   # # #     #   #   # #   # # #   # #   # # #   # #     #   #         #           #   #   #   #   #   # 
# # # # # # # # ####### # # # # ### ####### # ##### # ### # # # # ##### # # ##### ##### # ############### # # ########### ### # 
# #   #   #   #         #   #   #           #         #       #         # #       #     #               #   #           #     # 
################################################################################################################################
