################################################################################################################################
#       #         #                           #               #               #     #     #   #                     #       #   
# ### # # # # # # ######### # ########### # # # # ########### ### # ### ### # ##### # ##### # # ####### ### ####### # ####### # 
# #   # # # # # #           # #   #       # #   # #     #   #     #   # #   #       #       # # #       #   # #   #   #       # 
# # ### # # # # ########### # # ### ####### ##### # ### ### ######### # # ######### ######### # # ##### # ### # # ### # ########
# # # # # # # # #   #   #   # #   #   #     #     #   # #   #   #     # # #   #             #   #     # # #   # #   # # #       
# # # # ### # # # # ### ### # ### ### # ##### ####### # # ### # # ####### # ### ### # ##### ##### ##### # # ### ### # # # ##### 
# # # #     # #   #   # #   #     #   #   #   #     # #     # # # #       #     #   # # #           #   # # #   # # #   # #   # 
### # ### ### ####### # # # ####### ##### # ### # ### ####### # ### ############### # # # ########### ### # # ### # # ### # # # 
#   #   # #       #   #   #   #   #   #   #     #         #   #     #   #         # #   # #           # # # #   # # #   # # # # 
# ##### ### # ### # # ##### # # ##### # ################### ######### # # ####### # ##### # ########### # # ### # # # ### # # # 
# #   # #   #   # # # #   # #   #   # #           #       #   #       #   # #     #   #   #     #       #   #   # # # #   # # # 
# # # # # ##### # # ### # # ##### # # ##### ### # # ##### ### # ########### # ####### # ####### ### ### ##### ### # # # ##### # 
#   #   #     # # #     # #     # #   #   #   # # # #   # #   #             #     #   #   #   #   #   #     #   # # # # # #   # 
############# # # ####### ##### # ##### # ##### ### # # # # # ################### # ##### # ##### ### ### # ### # # # # # # ### 
#             # #     # # # #   #     # # #   # #   # # # # # #   #   #   #     #   #   # #       #   #   # #   #   # # #     # 
# ############# ### # # # # # ######### # # # # # ### # # # ### # # # # # # ### # ### # # ######### ### ### # ### ### # ### ### 
# #   #       # #   # # # #   #   #   # # # #   #     # # #   # #   #   #   #   # #   # # #     #     # #   #   # # # #     #   
# # # ####### # # ### # # ##### # # # # # ######### ### # # # # ############# ### # ### # ##### # ##### ######### # # ##### # ##
# # #   #   #   # #     # #     #   #   #   #     #   # # # #   # #         #   # #   # #     #       # #         #   #   # # # 
# ##### ### ##### ####### # ############### # ### ##### # ### ### # ##### ##### ##### # ##### # ##### ### ########### # # # # # 
#     #   #       #       #         #     #   #         #   #       #     #   #     # #       # #   #   #   #         # # # #   
### ##### # # ##### # ############# # ##### ############### # ############# # ##### # ######### # # ### ### ### ##### # # # ####
#   #     # #     # # #           # # #     #   #     #   # #   #           #   #   #   #   # #   # #     # #   #     # # #     
# ### ####### ### # # # # ######### # # ##### # # ### # ### ### # ############# # # ### # # # # ### # ##### # ##### ### ####### 
#   # #     #   # # # # #     #   # #   #     # #   # #   #   # #     #       #   # #   # #     #   # #   #   #   #   #     # # 
### # ##### ##### # ### ##### # # # ##### ##### # # ##### ### ####### ##### ##### ### ### # ##### ### # # ##### # ### ##### # # 
#   #     # #     #   #   #   # # #       #   # # #   # #   #     #   #   #       #   #   #     # #     #     # #       # #   # 
# ####### # # # ##### ### # # # ########### ### # ### # ### ##### # ### # ### ##### ####### ### # ########### # ####### # ### # 
# #       #   # #       # # #G#   # #     #   # # # #   #   #     #   # #   #     # # #   # #   # #   #     # # #         #   # 
# # ########### # ##### # # ##### # # ### ### # # # ##### ### ######### ### ##### # # # # # ####### # # ### # # ######### # ### 
#   #       #   #   #   # #       #   # # # #   #   #     # #   #       # # #   # # #   #   #       # # #   # #   #     # # #   
##### ##### ### ### ##### ############# # # ####### # ##### ### # ####### # # # # # ####### # ####### # # ### ### # ### # # # ##
#       #         #       #           # # #   #   # # #       #   #   #   #   # # #   # #   #   #   #   # #     # # #   #       
# ##### ####### # ########### # ##### # # # # # ### # # # ### ##### ### # ##### ##### # # ##### # # ##### # ##### # # ######### 
# #   #       # #   #       # # #           #     # # # #   #       #   # # #   #   # # # #   # # #       #     # # # #     #   
# # # ####### # # ### ##### # # ####### ######### # # ######### ### # ### # # ### # # # # # # # # ############# # # # # # # ### 
# # #   #     # #     #   # # # #     #   #     # # # #       #   #     #   # #   #   #     # # #       #     # # # # # # #     
# # # ### ##### ######### # ### # ### ### # ### # # # # ##### ### ########### # # ##### ####### ####### ##### # # # # # # ##### 
# # # #   #     #     #   # #   #   # #   #   #     # # #     # # #         # # #   #     #   #     # #   #     # # # # #   #   
# # # # ### # ### # ### # # # ##### # ####### ##### # # # ##### # # ##### # # ##### # ##### # ##### # ### ##### # # # ##### # ##
#   # # # # #     #   # # # #     # #       # #   # #   # #       # #   # # #   #   #       #   #       #   #   # # #   # # #   
####### # # ######### ### # ####### ####### ### # # ##### ### ##### # # ### ### # ### ####### ### ######### ##### # ### # # ### 
#       #   # #     #   # #   #   # #           # #               # # #   #   #   #   #     # #   #     #   #   # # #   #   # # 
# ### ##### # # ### # # # ### # # # ############# ########### ### # # ### ########### # ### ### ### ### # ### # # # # ####### # 
#   # #   #   #   # # # # # #   # #           # #   #   #   #   # # # #   #   #       #   #     #   # # #   # #   # #   #     # 
### ### # ### ### # # # # # ##### ########### # ### # # # # ### ### # # ### # # ### # ### ####### ### # ##### ##### ### ### ### 
# #   # #   #   # # # #   #     #       #     #   # # # # #   #     # #   # # #   # #   #   #   #   # #     # #     # #   #     
# ### # ### ##### # # ##### # ######### # ####### # # # # ### ##### # ### ### ### # # ##### ### ### # ##### # # ##### ### ##### 
# # #   # #     # # #       #         # #     #       #   #   #         #   #   # # # #   #     # #   #   #   #     #   # #     
# # ##### ##### # # ##### ##### ####### ##### ############# ### # ##### ### ### # # ### # ##### # ####### ######### # ### # ### 
#   #     #   #   #     # #   # #     #     #         # #   #   # #   #   #       # #   #       #   #   #   #     #   #   #   # 
### # ### # # ######### # # # # # ### # ############# # # ### ### # # ### ########### ########### # # # ### ##### ### # ##### # 
# # # # # # #       #   #   # #   #   #     #         # # #   #   # # # # #   #       #         # # # #   # #     #   #   #   # 
# # # # # # ######### ### ### ############# ########### # # ### ### # # # # ### ########### # # # # # ### # # ##### ##### ##### 
#   # #   # # #   #   #     # #    S    # #         #   # # #   #   # #   # #   #   #     # # #   #   # #   # #   # #   #   #   
# ### ##### # # # # ####### # # ####### # ####### # # ### # ##### ### ### # # ### # ##### # # # ####### ##### ### # # # ### ### 
# #   #   # # # # #   #     #   #   #   #   # #   #   #   #     # # #   #   #     #   #     # #             #     #   # #   #   
# # ### # # # # ##### # ### ##### # # ##### # # ####### ####### # # # # ### ######### # ##### ########### # # ######### ##### # 
#   #   # # # #     # # #     #   # #   #   # #     #   #     # # # # #   #         # #     #           # # # #   #   #   #   # 
# ### ### # # ##### # # # ### # ### ### ### # ##### # ### ### ### # ##### # # ####### # ### ########### # # # # # ### ### # ### 
#   #   # #   #     # # # #   #   #   #   # #     # # #   # # #   #       # #     #   #   # #   #     # # #   # #   #   # # #   
# # ### ##### # ##### # ### ##### ### ### # ### ### # # ### # # ########### ##### # ##### # # # ##### # # ##### ### # # # # # ##
# #   #     # #       #   #     # #       #       #   # #   #   #   #     #     #   #     # # #     # # # #     #   # # #   #   
# ######### # ########### ##### # ############# # ##### # # ##### # # ### # ### # ### ####### ##### # # # # ##### ### # ####### 
# #   #     # #     #     #     #   #   #     # #         #       # #   # # # # #         #   #   # #   # #     # #   #       # 
# # # # ##### # ##### # ### ####### # # # ### # ####### ##### ##### ##### # # # ########### ### ### ### ##### ### ####### ### # 
#   # # #   # # #   # #   # #     #   # # #           #     # #   # #     # #   #           # #     #   #   # #   #     #   #   
##### # # ### # # # # ### ### ### # ### ### ##### ### # ### # # ### # ##### ##### ########### ######### # # # # ### ### ### ####
#   #     #   #   #   # #   # #   #   #   #     # #   # #   # #     # #                 #     #   #   # # #   # #   #   #       
# # ##### # ######### # ### # ########### # ### ### ### # ### ####### # ############### ##### # # # # # # ##### ##### ######### 
# #               #     #   #   #         #   #   #   # #   #   #     #   #   #     #   #     # # # # # # #   #       #   #   # 
# ######### # ### # ##### # ### # ######### # ### ### ##### # # # ##### # # # # ### # ### ##### ### # ### # # ######### # # # # 
#   #       #   # #     # # #   # # #       #   # #   #     # #   #   # #   #   #   #     #   # #   #   #   #           # # #   
### ##### ##### # ### # # ### ### # # # # ##### # ##### ##### ####### # ######### ### ####### # # ##### ################# # ### 
#   #   # #     #     # #   #   # # # # # #     #   # # #             #   #   #   # #           #     #   #   #             #   
# ### # ### ##### ######### ### # # # # # ######### # # ##### ### ####### # # # ### ### # # ######### ### # ### ### ####### ### 
#   # # #   #   # #       # # #   #   # # #   #     #   #     #   #       # #   #   #   # # #     #   #   #     #   #   # # #   
### # # # ### ### # ##### # # ##### ### ### # ### ####### ##### ### ####### ##### ### ### # # ### # ### ####### # ### # # # # # 
#   # # #   #     #     #   #   #   # # #   # #   #       #   #     #       # #   #   #   #   # # #   #     #   # # # # #   # # 
# ### # ### # ######### ##### # # ### # # ### # ########### # ####### ####### # ### ### # ##### # ### ##### ### # # # # ##### # 
#     #   # # #         #     # # # # # #   # #     #     # #     # #     #   #     #   # #     # #   #   #   # #   # # #     # 
##### ### # ### ############### # # # # ### # ##### # ### ####### # ##### # ######### ### ### ### # ##### ### # ##### # # ##### 
#   # #   #   # #   #         #       #   # #     #   # #       # #       #             #     #   #       # # #   #   # # #     
# # ### # ### # # # # # # ### # ######### ####### ##### ### ##### ######### ##### ##### ####### # ######### # ### # ### # ##### 
# # #   # #   # # #   # # # #   #     # #     #   #       #       #       # #   #     #       # #     #     #   # #   #   #     
# # # ##### ### ######### # # ### ### # ##### # ### ##### ######### # # # # # # ####### ####### # # ### # ##### # ### ##### ### 
# #   # #   #   #       #   #   #   # #     #   # # #       #       # # #   # #         #       # # #   #       # #   #     #   
# ##### # # # ### ##### ##### # ##### ##### ##### # # ##### ### ### # # # ### ######### # ####### # # ############# # # ##### # 
#     # # # #   #     #     # # #   # #   #   #   # # #   #   # #   # # # #   #         # #   #   # #             # # #     # # 
# ### # # # ### # ######### # # # # # # # ### # ### # # # ### # # ##### # # ### ### ##### ### # # # ############# # ######### # 
# #   # # # # #   #       # # # # #   # #   # #     # # # #     #     # # # #   #   #   #   #   # #           #   # #         # 
# # ### # # # ##### ####### # # # ##### ### # ####### # # ##### ##### # # # ##### ### # ### ################# # ### # ######### 
# # #   # #   #   #         # #     #     # #         # #   #   #     # # #     # #   #   #     #     #       #     #   #   #   
# # # ### # ##### ########### ####### ##### ### # ##### ### ##### ##### ####### ### ##### ##### # ### # ################# # ### 
# #   #   #       # #     #   #       #     #   #     #   # #   # #   #   #   #     # #       # # #   # #       #       # # #   
# ##### ### ####### # ### # ### ####### ##### # ##### ### # # # # # # ### # # ####### # ##### # # ##### # ##### # ##### # # # # 
# #     #   #     #   #   #   # #       #     #   #   # # #   # # # #     # #     #   #     # # #   #   # # #   # #     # # # # 
# # ##### ### ### # ### ### ### ######### ######### ### # ##### # # ####### ##### # ####### # # ### # # # # # ### # ####### ### 
# #     #     #   #   # #       #   #   #       #   #   # #   # # # #     # # #   #       # # #   # # # #   # #   #   #   #   # 
# ##### # ##### ### ### # ####### # # # # ##### # ##### # # # ### # ##### # # # ######### # ##### # ### ### # # ##### # # ### # 
#   #   #     # #   #   #     #   #   # # # #   # #   # # # # #   #       #   #       #   # #     # #     # # #     #   #   #   
##### ####### # # ### ####### # ####### # # # # # # # # # # # # ############# ##### ### ### # ##### # ### # # ##### ####### ### 
#     #       #   # # #     # #     #   #   # # # # # # #   #   #     #       #   #   # #   #   # #   #   # #     #   #     #   
# ####### ##### ### # # ### # ##### ######### # # ### # ######### ### ####### # # ### # # ##### # ### ##### ### # ##### ####### 
#   #     #   #   #   # # # #     #   #       # #     #     #   # # # #     # # # #   # # #     #     #     #   # #   #         
# # ####### # ### ##### # # # ### ### # # ##### ########### # ### # # # ### # # # ##### # # ########### ########### # # ####### 
# #     #   #   #     # #   # # #   # # # #   #           # # #   #   # #   #   # #     # # #           # #         # # #       
# ##### # ##### ### ### ##### # # ### # ### # ##### # ### # # # ####### # ####### # ##### # # ########### # ######### # # ##### 
# #     # #   #   #   #   #   #   #   #     #   #   #   #   # #     #   #     #   #     # #   #           # #   # #   # #   #   
# # ##### # ##### # # ### # ####### ########### # ### ####### ##### # ####### # ####### # ##### ### ### # # # # # # ####### # ##
# # #   # #   # # # #         #     #           #   #   #     #   #   #       # #       # #       #   # # #   # #   #     # # # 
### # # # ### # # ########### # ##### # ########### # # # ### # # ##### ####### # ####### # ##### ### # ######### ####### # # # 
#   # #   # #   #   #       #   #     #   #   #     # #     # # # # #   #       #         #   #   #   # #   #   # #     #   #   
# # # ##### ### ### # ##### ############# # # # ### ######### # # # # ##### ################# # ##### # # # # # # ### # ####### 
# # # #     #   # #   #   #         #   #   # #   # #   #   #   #   # #   #   #   #           #     # # # # # # #   # #     # # 
# # # ### # # ### ##### # ######### # # ##### ### # # # # # ### ##### ### ### # # # ##### # ####### # # # ### # ### # ##### # # 
# # #   # #     #       #   #   # # # # #   #   # # # # # #   # #   #   #     # # #   # # # # #   # # # # #   #     # #   # # # 
# ##### # ##### # ######### # # # # # # # # ### # ### # # ### # # # ### ### ### # ### # # # # # # # ### # # ### ##### # ### # # 
# #     #     # # #     # #   # # # # #   #     #     # # #   # # #     #   #   #     #   #   # # #   # #   #   #   #   #   #   
# # ##### ### # # # # # # ##### # # ############# ##### # # ##### ####### ### ############# ### ##### # ##### # ### ##### ### ##
#   #   # #   #   # # # #   # #   # #   #     #   #   #   #     # #             #     #       #       #   #   #   # #   #   #   
# ### # # # ##### # # # ### # ##### # # # ### # # ### ######### # # ######### ### ### # ### # ########### # ### # # # # ### ### 
# #   #   # #   # # # #   # #     #   # # #   # #     #   #   #   # #   #   #   #   # # #   #   #     #   # #   # #   #   # #   
# # ####### ### # # # ### # # ### ##### ### ### ####### # ### ##### # # # # ### ##### # ### ### # ### ##### ##### ####### # # # 
# #     #   #   # # #   #   #   # #   # #   # #         #     #     # #   #   #   #   #   #   # # #       #     # #   #   #   # 
# ##### # ### ### # ### # ####### ### # # ### ######### # ##### # ### ####### ##### ##### ### # # ####### ##### # # # # ####### 
#       #     #     #   #             #   #             #       #           #       #     #   # #       #       #   #           
