################################################################################################################################
################################################################################################################################
#                       #           #   #       #           #   #     #           #         #                 #   #     #       
# ######### ##### ### # # # ### # # # # # ### # # ### # ### # # # ### ### ##### # ######### # ####### # # ### ### # ### ####### 
#     #   # #   # #   #   #   # # # # # # # # #   #   # #   # # # # # #   #   # #                   # # #   #     # # #   #   # 
##### # # # # # # # ######### # # # # # # # # ####### # # ### ### # # # ### # ### ############# ##### # ### ##### # # ### # # # 
#   # # #   # # # #   # #   # # # # # # # # # #       # # #   #   # #   #   #   #   #         #   #   #   #     # #   #   # # # 
# # # # ##### # # ### # # # ### # # # # # # # ######### # # ### ### ### # ##### ### # ####### ### # ##### ##### ##### # ##### # 
# #   #       # #   #   # #     # #   # #   # #         #       #       #   # #   # # #   #   #   #     # #   #       #       # 
# ############# # ####### ####### ##### ##### # ######### ########### ##### # ### ### # # ### # ####### ### # ##### ########### 
#     # #     # #       # #     # #   #       # #         #     #     #   #   # #   #   #   # #       #     #     # #     #     
# ### # # ### # ######### # # ### # # ####### # # ### # ### ### # ### # # ##### ### ####### # ####### ########### # # # ### ####
# # #   #   # # #     #   # #   #   #       # # # #   # # # #   # #   # #   #             # #     #   #   #     # #   #     #   
# # ####### ### # ##### ### ### ########### ### # # # # # # # ### ### # ### # ##### ##### # ##### ##### # # ### # ### ######### 
#   #     #     # #   # # # #   #   #     #   # # # # # # # #     #   #   # # #   #   #   #   # #     # #     # #   #           
# ### ### ####### # # # # # # ### # # ####### # # # # # # # ####### # ### # # # # ##### ##### # ##### # ####### ### ####### ### 
# #   #   #         # # #   # #   # # #     # # # # # # # #   #   # #   # #   # # #   #   #   # #   # #   # #   # #       #   # 
# # ### ### ### ####### # ### ##### # # # ### # ### # # # ### # # ##### # ##### ### # ##### ### # # # ### # # ### ####### # # ##
# #   #     # # #     # # #   #   # #   # #   #   # # # # #   # #   #   #     #     #       #     # # # #   #   # #   #   # #   
# ### ####### # # ### # # # ### # # ##### # ##### # # # # # ### ### # # ##### ############### ####### # ### ### # # # # ### ### 
#   #   #     # #   # # # #     # # #     #   #   # # #   #   #   # # # #   #     #       # #     #   #   #   #   # #   #     # 
# # ##### ### # ##### # # ####### # # ####### # ### ############# # ### ### ##### # ### # # ##### # ##### ### ##### ##### ##### 
# #     # # # # #     # #       #     #       # #           #     #   #       #   # #   #   #     #     #   #     # #     #   # 
# ##### # # # # # ##### # ##### ####### ##### # ############# ####### ####### # ### # ####### ######### ### ##### # # # # # # # 
#     # #   #  S# #     #     #   #   # #     # #   #       # #         #   # #   # # #           #     # # #   #   # # #   # # 
##### # ### ##### # ######### ### # # # ##### # # # # ##### # ######### # ### ### # ### ########### ##### # # # ##### # ####### 
#     #   #   # # # #   #   #   #   # #     # # # # #     # #   #     # #     #       # #   # #     #         #       #   #   # 
# ####### ### # # # ### # ##### ##### ##### # # # # ####### ### # ##### # ##### ##### # ### # # ##### ########### ##### ### # # 
# #     #     # #   #   # #   # #   #   # # # #   #           # #   #   #       #   # # #   # #   #     # #     # #   # #   #   
# # ### ####### ##### ### # # # # # ### # # ################### ### # ### ####### # ### # ### ### # ### # # ### # # # ### ######
# # #   # #                 #   # #   #   #             #     # #   #   # #       #   # # # #   # # #   # #   #   # # #   #     
# # # ### # ################# ### ### ########### ### # # ### # # ##### # # ######### # # # ### # ### ### ### ##### # # ### ####
#   # #             #       #   #   #   #     # # #   # #   #   # #     # # #       # # # #   # #   # #   # #   #   # #     #   
# ### # ####### ### # ##### ####### ### # # # # # ######### ### # # ##### # # ####### # # # ### ### # # ### ### # ### ####### # 
# #   # #     #   #     #   #     #   #   # #   #       #   #   # # # #   #   #     #   #         # #         # # # # #     # # 
# # ##### ### ### ####### ### ####### ##### ########### # ####### # # # # ### # ### # ##### ##### # ### ##### # # # # ### ### # 
# #     # #   #         #     #     # #   #         # # #       # # # # # #   # # # #       #   # #   #   #   #     #   # #   # 
# ##### ### ##### ### # ####### # ### # ####### # # # # ####### # # # # # # ### # # ######### # # ### # ### # ######### # # ### 
#     #   #     #   # #       # #     #     #   # # # #   #   #   # #   #     # #   #       # # # #   # #   #     #   # # #   # 
##### ### ##### # # ######### # ########### # ### # # # ### # ##### ######### # ##### ##### # # # # ### # ##### # # # # # ### # 
#       #       # # #   #     #   #   #     # #   #   #     #   # # #       # # #   # #   #   # # # #   # #     # # # # #   # # 
# ### # ######### # # # # ####### # # # ##### # # # ########### # # # ##### # # ### # ### ##### ### # # # # ####### ### ### # # 
# #   #         # #   # # #       # # # # #   # # #     #     # # # # #   #         #   #     #     # # # # #     #     #   # # 
# # ####### ### # ##### # # ####### ### # # ##### ####### ### # # # ### # ### ######### # ### ####### ### # ##### ####### # # ##
# # #   #   #   #   #   # # #     #   #   # #     #       #   # # #   # #   # #       #   # # #     #   # #       #       # #   
# # ### # ######### # ### # # ### # # # ### # # ### # ##### ### # ### # ### # # ##### ##### # ### # # # # # ############### ### 
# #     #           # #   # #   #   # # #   # #   # # #   #     # #   # # # #   #           #   # # # # # #                 #   
# ### ############### # # # ### ##### # # ####### # ### ######### # ### # # # ### ####### ##### # # ### # ####### ##### ##### ##
#   #   #   # #   #   # # #   #   # # # # # #     #   #   #       # # #   # # # #   #     #   # # #   # #   #   # #   # # #   # 
# # # # ### # # ### ##### ### ### # # # # # # ####### ### ##### ### # ##### # # ### # ##### # # # ### ##### # # ### # # # # ### 
# # # #     #     # #       #   # # #   # #   #         # #     #   # #       #     #   #   # #   # # #   # # # #   # #   # #   
# # # ########### # # ######### # # ##### ##### ##### ### # ##### ### # ############# # # ### ##### # # # # # ### ### # ### # ##
# # #     # #   # # #   #     # #   #   # #   # #     #   # #   #   #   #         #   #   # #       # # # #   #   # # # #   #   
# # # ### # # # # # ### # # ### ### ### # # # # ####### ### # # ### # ### ####### # ####### # ####### # # # ### ### # ### ##### 
# # # #   #   #   #   # # # #   #   #   #   # # #       #   # # #   #   #       # #       # #     #   # # #   #   # #     #     
### # # ######### ### ### # # ### ### ####### # # ####### ### # # ### # ####### # ### # ### ##### # ### # ### ### # ####### # ##
#   # # #       # # #     #   #           #   #   # #   #   # # #   # #     #   #   # #   # #     #     #   #   # #     #   #   
# ### # # # # # # # ########### ####### ### ####### # # ### # # ### # ####### ##### ##### # # ### ######### ### # ### ### ##### 
#   # #   # # # #       #     # #     # #   #     # # #   # # #     # #     #   #   #   # #   # # #   #     # # #   # #   #   # 
### # ##### # ######### # ### # # ### ### ### ### # # ##### # ####### # ### ##### ### # # ##### # # # # ##### # ### # # ### # ##
# # # #   # #       #   # # #   # #   #   #   #   # # #     #   #     # # #   #   #   #   #   #   # # # #         # # #     #   
# # ### # # # ####### ### # ##### # ### ####### ### # # ####### # # ### # ### # ### # ##### # ##### # # # ### ##### # ######### 
#   #   #   #     #   #   #   # # #   # #   #   #     # #     # # # #   #   # # #   # #     #       # # #   # #     #         # 
##### ####### ##### ### ##### # # ##### # # # ### ##### # ##### # # # ### # # # ##### # ############# # ### # # ##### ####### # 
#           #     # # # #   # # #     # # #   #         #     # # # #     # #   #     #   #     #     # #   # # #   # #         
# # ####### ##### # # # # # # # ##### # # ##### ############# # # # ####### ##### ####### ### # # # # # # ##### # # # ######### 
# #       # #     # #     # # #     # # # #                   # # #   #   #   #   # #   #   # # # # #   #   #   # # # #       # 
# ### # ### # ##### ####### # # ##### # # # # ############### # ##### # ##### ### # # ### # ### # # ######### ### # ### ##### # 
#   # # #   #     #                 #   #   # #       #     # # #   # #     #   #   #   # # #   # #   #     # # # #     #   #   
##### # # ####### ##### ##### ##### ######### # ##### # ### ### # # # ### ##### ####### # # # ### ### # ### # # # ####### # ### 
#     # #   #   #   #   #   #     #           #     # #   #   #   #   #   #     #     # # # #       #   # #   #   #       # #   
# ##### ### ### ### # ### # ##### ##### ### ######### ####### ##### ### ### ##### ### # ### ##### ####### ######### ####### # ##
# #   #   #   #     # # # #     # #   #   #       #   # #   #     # #   #   #     # # # #   #             #         #     #   # 
# ### ### ### ####### # # ##### # ### # # ######### ### # # ##### # # ### ### ##### # # # ######### # ############# # ### ##### 
#     # #   #         # #     # # #   # # #         #     #       # #   #   # #     # #   # #     # #   #     #   # #   #       
####### # # ########### ####### # # ##### # ######### # # ##### ### ### ### # # ##### ##### # ### # # # ##### # # # ######### ##
#     #   #             # #     # #       #   #     # # # #   #       #   # # #           #   # # # # #       # # #         #   
# ### ##### ##### # # ### # ##### ####### ### # ### # # ### # ####### ### # # # ######### ##### # # # ######### # ######### ### 
# # #       #   # # #     # #           #   #   #     # #   #     # #   # #   # #               #   #   #       #   #     # #   
# # ### ### # # # # ### ### ##### ##### ########### ##### ####### # # ### ##### # ######### ### ##### # # ######### ##### # # ##
# #   # #   # # # #   #   #     # #   # #     #     #   #   #   # #   #   #     # #       # # #       # #   # #     #   #   #   
# ### # # ### # ##### ### ##### ### # # # ### # ### # # ### # ### ##### ### ### # # ####### # ##### ####### # # ##### # ### ### 
#   #   #     #   #   #   #   #     # #   # # # #   # #   # #   #           #   # #     #   #     #   #   #   #     # #   #     
# # ############# ######### # ####### ##### # # ### # ### # ### ####### ##### ### ##### # ####### ### # # ### ##### # ### ##### 
# #       #     #           #       #   #   # #   # # # #   #     # #   #     # #       #       # # #   #     #   # #   # #     
# ####### # ### ############### # ##### # ### ### # # # ##### ### # # # # ### # ########### ##### # ########### # # ##### # ####
#       #   # # #   #     #   # # #   # #     #   # #   #     # # #   # # #   #     #       #     #   #     #   #   # #   #   # 
# ##### ##### # # # ##### # # # # # # # ####### ### ##### # ### # ### # # ######### # ####### ####### # ##### ####### # ##### # 
#     #       # # #       # # # #   # #         #         #   #   #   # #         # #       #   #     #   #   # #       #     # 
# ### ### ##### # ######### ### # ################### # ##### # ##### # ######### # ####### ### ### ##### # ### # ####### ##### 
# #   # # #   # # #           # # #       #   #       #     # #     # #     #   #   #     #   #   #     #   #     #     # #     
### ### # # # # # # # ####### # ### ##### ### # ########### # ##### ### ### # # ######### ### ### ##### ##### ##### # ### # ####
#   #   # # # # # # # #     # #     #   #     #   #       # #     #   #   # # #     #   # # #   #   #   #     #     #     #   # 
# ### ### # # # # # ### ### ##### ### # ######### ####### # ##### ### # ### # ##### # # # # # ##### # ### ##### # # ######### # 
#     #   # # # # #   # # #     #     #       #   #       #     #   # # #   # #     # #     #     # #           # # #   #       
##### # ### # # # # # # # ##### # ############# ### # ####### # ### # ### ### # ##### ##### ##### # # ######### # # # # # # ### 
#   # #G    # #   # # # #   #   # #   #   #   # #   # #   #   #   # #     #   # #   #     # #   #   #   #     # # #   # # #   # 
# # ######### ##### # # ### # ### # # # # # # # # ### # # # ##### # ########### ### # ### # # # ##### # # ### ### # ### # ### # 
# #   #             # #     # # # # #   #   # # #   # # # #   #   #             #   #   # #   #       # #   #     #   #   #   # 
# ### # ####### ############# # # # ######### # ##### # # ### # ################# ##### # ######### # # ##### ##### ####### ### 
# #   #       # #   #       # #   #       # # #     # # #   # # #       #   #   # #     #   #   #   # #     # #   # #       #   
# ########### # # # # # # ### ### ####### # # ##### # # ### # ### ##### ### # # # # ####### # # # ### ##### # # # # # ####### # 
# #     #     #   #   # # #   #   #       # #       # # # # # #   #   #     # #   # #     # # #   #   #     # # # # #   # #   # 
# # ### # ####### ##### ### ##### # ####### ######### # # # # # ### ######### ##### ##### # # ######### ####### # ### # # # # # 
# # # # #       #     #   # #   # #     #       # #     #   #   #   #                 #   # #         #     #   #   # # #   # # 
# # # # # ##### ### # ### # # # ### ### ####### # # ############# ### # ############# # ### ####### # ##### # ##### ### ##### # 
#   #   #   #   #   # #   # # #   #   #     # # #   #             #   # #   #       #   # # #     # #     #       #   #     # # 
##### ##### # ### ### # ### # ### ######### # # # ### ### # ### ### ### # # # ##### # ### # # ### # ##### ####### ### # ### ### 
#     #     #   #   # #   # #   #   #       #   #   #   # #   # #   # #   #       # #     #   # # #   #   #     #   # #   #   # 
# ##### ####### # # ##### # ### ### # ####### ##### ### # ### ### ### ############# ####### ### # ### # ### ### ##### # ##### # 
#     #     #   # #     # # #   # #   #   #   #       # #   # #   #       #   #     #     #     #   # #     # #   #   # #     # 
##### ##### # ### ####### # # ### ####### # ######### # ### ### ### ### # # # # ##### ### # # ##### # ####### ### # ### # ##### 
#   # # #   # #     #     #   #   #     #   #     #   # # #       # #   #   # # #   # # # # #     # #           # #   # #   #   
# # # # # ### # # ### ### ####### # ### ### ##### # ### # ####### # # ######### # # # # # # ####### # # ######### ### # ### ####
# # # #   #   # #   # #         #   # #   #   # #           #   #   #         #   #   #   # #       # # #       # # # #   #     
# # # ### # ####### # # ##### # ##### ### ### # # ######### # # ### ######### ############# # ####### # # ##### # # # ### ##### 
# # #   # # #   #   # #     # #           #   # # #     #   # #   # #     #   #     #       #   #     # #   #   # # #   #     # 
# # ### # # # # ### # ##### # # ########### ### # # ### ##### ### # # ### # # # ### ########### # ##### ### ##### # ### # ### # 
# #   # # # # #   # # #   # # #         #     #   # # #     # #   # #   #   # #   #         #   # #   # # #     # #     #   # # 
# ##### ### # ### ### # # ### # ##### ### # # # ### # ##### # # ### ######### ### ######### # ### ### # # ##### # ########### # 
#     #     # # #     # # #   #   # #     # #   #   #     # # # #   #       # #   # #       #   #     #   #   # #   #   #   # # 
##### ####### # ##### ### # ##### # ####### # ### ##### # # # # ##### ##### ### ### # ######### # ######### ### ### # # # # ### 
#             #       #   # #     #         # #   #   # # #   #     #   # #     # #   #       # #         # #   #   # # # #   # 
# ##### # # ########### ### # # ############### ##### ### ######### ### # ####### ##### ##### # ### # ##### # ### ### # # ### # 
# #   # # #         #   #   # #   #             #   #   # #       #   # #   #   #       #   # #   # #     # # #   # # #   # #   
# ### # ########### # ### # ####### ############### ### # # ##### # ### ### ### ### # ##### # ### # ##### # # ### # # ##### ### 
#     #           #   #   #                                 #     #     #           #       #     #     #   #     #   #         
################################################################################################################################
