################################################################################################################################
################################################################################################################################
         #     #   #     #     #       #   #             #           #       #     #                 #   #       #   #   #     #
 ####### # ### ### # ### # ##### ##### # # # ### ##### # # ### ####### ### ### ### ############### ### # # ####### # # # ##### #
   #   # #   #     # # # #       #   #   # # #   #   # # #   #       # #   #   #   #               #   #   #       #   #   #   #
## # # # ### ####### # # # ####### ####### ### ### # # ##### ####### # # ### ####### ######### ##### ####### ############# ### #
   # # # #   #     # #   # #     #   #   #   # #   # #   #     #   #   # #   #     # #       #     #         #     #     #   # #
 ### # ### ##### ### # ### # ### ### # # ### ### ### ### # ##### # ####### ##### # # # ##### ################# ##### ### ### # #
     #   #   #   #   # #     #   #   # #   #     # #   # # # #   #         #     # # #     #     #   #             #   #   # # #
 ####### ### # ### ### ####### ### ##### # ####### ### # # # # ############# # ### # ##### ##### # # # ##### ##### ### ### # # #
 #     #   # # #   # #   #   #   #     # #       #   # # #   # #   #   #     #   # # #   #   #   # # # #   #   #     # # #   # #
 ##### # ### # # ### ### # # ### ##### # ########### # # ### # # # # # ######### # # # # ### # ### ### # # ### ####### # ##### #
       #       # #   #   # #   # #     #   #     #   # #     #   #   #   #       # # # #     #   #   # # #   #         #       #
###### ######### # ### ### ### # ##### ### # ### # ### # ############### # ####### # # ######### ### # # ### ################# #
       #   #   # #   # #   # # #     # #   # #   #     #             #   #   #     #         #   #   #   # #   #   #     #     #
 ####### # # # ### # # ##### # ##### # # # # # ######### ### ### ##### ##### # ####### ##### ##### ####### ### # # ### # ### ###
       # # # #     #   #             # # # # #             #   # #   #       #   #   # #   #       #       #   # # #   #   #   #
 ####### # # ########### ##### ####### ### # ######### ### ### # # # ########### # # # # # ######### ####### ### ### ##### ### #
 #   #   #   #         # #   #       # #   #     #   #   # #   #   #   #       #   # #   #   #     #     # #   #     #         #
 # # # ####### ####### # # # ### ### # # ####### ### ### # ##### ### # # ##### ##### ####### # ### ##### # ### ##### ######### #
 # #   #   #     #   # #   #   #   #       #     #   # # #   #   # # #   #   #   #   #     #   # #   # #     #     # #         #
 # ##### # ####### # # ### ### ########### # ##### ### # # # # # # # ### # # ### # ### ######### ### # ##### ##### # # ####### #
 #       # #       # #   #   #     #   #   # #         # # # # #   #   # # # #   # # #         #       #     # #   # # #     # #
 ######### # ####### ### ### ##### # # # ### ####### ### # # ######### # ### # # # # ##### ### # ####### ##### # ##### # ### # #
     # #   #   #           #     #   # #   #       # #   # #         # #     # # # #       #   # # #     #     # #     # #   # #
 ### # # ##### # ######### ##### ##### ### ####### # # ############# # ####### ### ######### # # # # ##### ##### ######### ### #
 #     # #     # #       #   #   #   #   #     #     #   #     #     #   #   #   # #   #     #           #     #   #       #   #
 # ##### # ##### # ##### ### # ### ##### ##### # ####### # ### ######### # # ### # # # # # ############# # ####### ### ### # ###
 #   #   # #   # # #       #     #     #   #   # #       #   #         #   # #   # # #   # #           #   #     #   #   #     #
 ### # ##### # # # ####### ########### ### # ### # # ####### ######### ##### # ### # # ##### ######### # ### ### ### ######### #
 #   # #  G# #   #   #   #     #   #       #     # # #       #     # #   #   #   # # # #   #       #   #   # #   #   #   #     #
 # ### ### # ### ### # # ##### # # # ############# ### ####### ### # ### # ####### # ### # ######### ### # # ##### ### # # ### #
 #   # #   # # #   #   # #   # # # # # #       #   #   #       # # #   # #   #   # #   # #   #       #   # #     # #   #   # # #
 # ### # ### # ### ##### # ### # # # # # ##### ##### ##### ##### # ### # ### # # # ### ##### # ####### ######### # # ####### # #
 # #   #     #   #   # #   #   # # #   #   # #       #   #   #   # # # #   # # # #   # #     # #   #           # # #       # # #
## # ######### ##### # ##### ### # ####### # ########### ### # ### # # ### ### # ### # # ##### # # ### ####### # # ####### # # #
   # # #             # #     #   #       # #     #   #   #   #     #   # #   # #     # # #   # # #     #   #   # # #       #   #
 ### # # ############# # ##### ######### # ### # # ### ####### ####### # ### # ####### # # # # ######### # # # # # ######### ###
     #               # #     # #     #   #   # # #   # #     #   #   # #   # #     #       # #   #       #   #             #   #
 ##### ############# # ##### # ### # # ##### ### # # # ##### ### ### # # # # ##### ##### # # ### # ####################### ### #
       #           #     #   # #   # #   #   #     # #     #   #         # #     #     # # #   # #     #   #     #   #         #
 ####### ######### ####### ### # ### ### # ### ########### ### ### ##### # ##### ##### # # ### # # ### ### # ### ### # #########
   #     # #     #         # # # #     # # #   # #         # #     #   # # #   #     # # # #   # #   # #   #   #   #       #   #
 # # ##### # # ############# # # ##### # # # ### # ######### # ##### # # ### # ##### # # # # ### ##### # ######### # ### ### # #
 #   #   #   #     #       # # #     # #   # #   #         #   #     # #     #     # # # # #   #   #   #     #     #   # #   # #
 ##### ### ##### ### ##### # # # ### # ##### # ########### # ### ##### ### ##### ### # # ######### # ####### # ##### # ### ### #
     # #   #   #     #   #   # #   # #     # # #     #     # #   #   #   #     #   # # # #S      # # #       # #     #   # # # #
#### # # ### # ##### # # ##### ### # ##### # # # ### # ##### # ### # ### ##### ### # # # # ##### # # # ####### # ####### # # # #
     #       # #   # # #     #   # # # #   # # #   # # #     # #   #   # #   #   # #   # # #   # #   # # #   # #       #     # #
 ####### ##### # # # # ##### ### ### # # ### # ##### # # ### # ### ### # # # # # # ##### # # # # ##### # # ### # ##### ####### #
 #   #   #   # # # # #   # # # #     # #   # #       # # #   #   # # # # # #   # # #       # # #           #   #   # # #     # #
 # # ##### # # # # ##### # # # ####### ### # # ####### # # ##### # # # # ####### # ##### ### # ### # ####### ##### # # # ### # #
   # #   # # # # # #     # # #           # #   #     # # #     #   #   #     #   # #   #     #   # #   #   # #   #   # #   # # #
#### # # # # # # # # ##### # # ########### # ### ### # # ##### # ####### ### # ### # # ####### ### # ### # # # # ### ##### # # #
   # # #   # #   # # #   #   # #       #   #     # # # # #   # # #     # #   # # #   # #   #   #   # #   # # # #         # # # #
 # # # ##### # ### # ### ##### # ##### # ### ##### # # # # # # # # ### ### ### # ##### # # # ### ##### ### # ####### ### # # ###
 # # # #   #   #   #   #         #     # #         #     # # # # # # # #   #   # #     # # #   #       #   # #     # #   # #   #
 ### # # ### ######### # ##### ####### # # # ########### ### # # # # # # ### ### # ##### # ### ######### ### # ### # ##### ### #
   # #   #   #     #   #   # # #     # #   #         #   #   #   #   #   #   #   #     # #   #   #     #   # # #   #       #   #
 # # ##### ### ### # ##### # # # ### # ############# # ### ############### # # ####### # ### # # # ### ### # # # ### ####### ###
 # #         #   #   #   #   #   #   #   #   #       #     #               #   #       #   #   #   #     # #   # #   #     #   #
 ### ########### ####### ### ##### ####### # # ### ######### ##### ##### # ##### ##### ################### ##### ### # ### #####
               #       # # # #   # #       #   #   #       # #   # # #   #   # # #   # #         #   #   #     #   # # #   #   #
#### ################# # # # ### # # ########### ### ##### # # ### # # # ### # # # # # # ####### # # # # # ####### # # # ### # #
   #     #           # #   #   #   # #           #     #   #   #   # # #   #   #   # # #   #   #   # # # #   #   # #   #     # #
 # # ##### ##### ##### ### ### ##### # ####### ### ##### ### ### ### # # # ######### # ### # # ##### ### # ### # # ### ####### #
 # # #   # #   #           #   # #   # #   #   #   #     #     #   # # # #       #   # #   # #     #     # #   # #       #   # #
## # # # # # # ######### ### ### # ### # # ##### ### ##### ##### # # # # ### ### # ### # ######### ######### ### ##### ### # ###
   # # #   # #     #   #   # #   #   # # #   #   # # #   # #   # # #   # #   #   # #   #     #   #     #     # # #   #   # #   #
 ### # ##### ####### # # # # # ##### ### ### # ### # ### # # # ### ##### ######### ######### ### ##### # ##### # # # # # # ### #
       #         #   # # #         #     # #   #   #   #   # #   # #     #       #           #       # # #     #   # # # # #   #
 ##### # # ##### # ### ##### ### ######### ##### ##### ##### ### # # ##### ##### ############# ####### # # ######### # ### #####
     #   # #   # #   #     #   #                 #   #   #   # #   #       #   # #     #     # #       # # #         #         #
 ### ##### ### # ### ##### ### ##### ### # ##### # ##### # ### ##### ####### ### # ### # ### # # ####### # # ################# #
 # #     #   #     # #   #   # #     # # # #   # # #     # #               # #   #   # # # # #     #     # #     #         #   #
 # ##### ### ####### # # ### # # ##### # # # # # # # ##### # # ### ##### ### # ### # # # # # ##### ####### ##### ### ##### # ###
 #     #   # #       # #   # # # #   #   # # #   # #   # # # #   # #   # #   # # # # #   # #     #   # #       #   #   #   #   #
 ##### ### ### ####### ### # ### # # ##### # ##### ### # # # ### # # # ### ### # # # ##### ##### ### # # ##### ### ### # ##### #
       #   #   #     #   # # #   # # #   # # #   #   # # # # #   #   #   #   # #   #       #   # # # #   # #     #   # #   #   #
###### # ### ### # ##### # # # # # ### # # # # # ### # # # ### ####### # ### # ############# ### # # # ### # ### ### ##### # # #
   #   #     #   # #   # #   # # #     # # # # # # # # # #   # #     # #   #   #           #   # #   #     #   #   #     #   # #
## # ######### ##### # ####### ######### # # # # # # # # ### ### ### # # # ##### ######### # # # # ### ##### # ### ##### ##### #
   # #         #     #   #       #       # # # #   # # #   #     #   # # # #   #         # # # # # #   #   # #   #     #   #   #
 ### # ####### # ####### # ##### # ####### ### ##### # ### ####### ##### # # # ######### # # ### # ### # # # ### # ####### # ###
 #   # #       # #   #   #     # #   #       #     #   # #   #     #     #   #   #     # # #     #   # # # #   # #   #     #   #
 # ##### ####### ### # ######### ### ##### # ##### ##### ### # ##### ############# ### # # ##### ### # # # ### # ##### ####### #
 #     # #     # #   #         # #   #     #       #   # # # # #                 # # # # #     #         # #   #       #       #
 ##### # # ### # # # ######### # # ### ### ######### ### # # # # ### ########### # # # ####### ### ##### # # ################# #
     # # # #   # # #   #   #   #   #   #     #     #   #   #   #   #           #   # #   #     #   #   # # #       #   #       #
#### # # # ##### ##### # # # ####### ####### ##### ### ### ####### ####### # # ##### ### # ##### ### # # # ### ### # # # ##### #
         #   #   #     # #   #       # #   #     #   # # #     #   #   # # # #         #   #     #   # # #   #   # # # #     # #
 ####### ### ### # ##### ##### ##### # # # # ### ### # # ##### # ### # # # ### ### ######### ##### ### # ### ##### # # ####### #
 #       # #     #   # #     # #   # # # # #   #     # #     #   #   #   #   #   #           #     #   #   #     # # # # #     #
## ##### # ######### # ##### ### # # # # # ########### ### ####### ######### ### ##### ##### # ################# # ### # # #####
   #   #           # #     # #   # #   # #     #           #   #   #       # # #     #     # #   #   #       #   #     #   #   #
 ### ############# # # ### # # ### # ### ##### # ####### ### ### ### ##### # # # ### ##### ##### # # ####### # ### ##### ### # #
 #     #               #   #   #   # #   #   #   #     #     #   #   #       # # #   #   #     #   #   #   #   #     #   #   # #
 ##### # # ### ### ####### ##### ##### ##### ##### ### ####### ### # ######### ### ### # ##### ####### # # ##### # # # ### ### #
 #   #   #   # # # #     #     # #             #   # #         #   #     #   #     #   #   #         #   # #     # #   # # # # #
 # # # ####### # # # ### # ### # # ############# ### ############### ### # # ############# # ####### ##### # ### # ##### # # # #
 # # # #       #   # #   # # #       #         #     #       #     # #   # # #   #         # #     #   #   #   # #     # # # # #
 ### ### ####### ### # ### # # ##### # ####### ##### ##### # # ### ### ### # # # ### ##### # # ### ##### ##### # # ### # # # # #
     #   #       #   # #   #   #     # #     # #   # #     #   # #     #   #   #   # #     # # # #     #   # # # #   # #   # # #
###### ### # ##### ### # # ##### ### # # ### # # # # # ######### ######### # ##### # # ### # # # ##### ### # # # ### # ##### # #
       #   #     # # # # # #   #   # # #   #   # # #   # #   #   #         # #   #   # # # # #   # #   #   #   # #   #       # #
 ####### # ####### # # # ### # ##### # ######### ####### # # ### # ########### # ##### # # # ### # # ### ######### ######### # #
 #   #   #   #     #   # #   #     # # #   #     #     # # #   #   #           # #     #   #   #   # #   #   #   #       #   # #
 ### ### ### # ##### ### # ####### # # # # # ##### # ### # ### ##### ########### # ##### ##### # ### # ### # # # ####### # ### #
   # #   #   #     #     #   #     # #   # #     # # #   #   #     #         #   #   #       #   #   #     #   #       # #   # #
## # # ### # ##### ######### ### ### ##### # ##### # # ##### ##### ########### ##### # ### # ##### ################### # ### # #
   # #   # # #     #   #   #   #       # # # #     #   #   #   # #   #         #     # #   # # #   #         #       # # #   # #
 ### ### # ### ####### # ##### ####### # # # # ######### # ### # ### ### ####### ##### # ### # # # # ##### ### ##### # # # # # #
   #   # #   #     #   #       #   #     #   #       #   #   # # # #   #         #   # #   #   # # # #   #     #   #   # # # # #
## ### ##### ##### # ########### ### # ##### ####### # ##### # # # ### ### ####### ### ### ### # ### # # ####### # ##### # ### #
 # #   #     #   #   #           #   # #   #       #   #   #   #     #   # #     #       #   # #     # # #       #       #     #
 # # ### ##### # ##### ######### # ### # ##### # # ##### ######### ##### ### ### ####### ### # ######### # ####### # ### # #####
 #   #         #           #   # #   #         # #     #         # #   #   # # #       # #   #   #   #   # #   #   # #   #   # #
 ##### ################### # # # ####### # ##### ##### ######### # # # ### # # ####### # # ##### # # # ##### # # ### # ### # # #
     #       #             # # #   #   # # #     #   #     #     # # # #   # #   #   # # # #   #   # #       #   #   # #   #   #
#### ##### ### ############# # ##### # ### # ##### ####### # ##### # ### ### # ### # # # # # ####### ### ####### ##### ### #####
     #   # #   #           # #     # #   # # #         #   #       #   # #   #   # #   # # #     # # #   #     # #   #   #     #
 ##### # ### # # ######### # ##### # ### # # # ##### # # ##### ### ### # # ##### # ##### # ##### # # # ### ### ### # ### ##### #
       #     # #       # # # # #   #   #   # # #   # # #   #   #   # # # # #     #     # # #   # # # #   # #       #     #   # #
############## ####### # # # # # ##### ### # ### # # # ### # ### # # # # # ##### ##### ### # # # # # ### # ############### # # #
   # #   #   #   #   # # # # # #   #   #   # #   # # #   # #   # #   # # # #   #     # #   # # # # #     #       #     #   #   #
 # # # ### # # # # # # # # # # ### # ### # # # ### # ### # ##### ### # # # # # ### # # # ##### # # ##### ####### ##### # #######
 #         #   #   # #   #   #       #   # #   #   #   #         #         # #     #     #                     #       #       #
################################################################################################################################
