################################################################################################################################
################################################################################################################################
         #   #   #   #                   # #                               #     #   #   #     #   #     #       #     #       #
 ####### ### ### # # # # # ### ####### # # # ### ########### ### # ##### # ##### # # ### # ### ### # ##### ##### # ### # #######
 #   # #     #   # # # # #   #       # #   # #   #   #       # # #     # #     # # #       # # #   #     # #     #   # #   #   #
 # # # ####### ### # # # # # ####### ####### # ### # # ####### # ##### # ##### # ### ##### # # # ####### # ########### # ### # #
   # #       #     #   # # #       #   #   # # #   # #   #     #   #   # #     # #   #   #   #   #       #     #         #   # #
#### ##### # # ######### # ########### # # # # # ### # # # ####### ####### ##### # ### # ######### ########### # ### ##### ### #
   #     # # #   #     # #       #   # # #   # # #   # # #       #   #     #     #   # #     #   # #             #   #     # # #
 # ##### # # ### ### # # # # ### # ### # ##### # # ### # ####### ### # # # # ##### # # ##### # # # ######### ##### ### ##### # #
 #       # #   #     # # # #   # #     #     # # # #   #   #   #     # # # #   #   # #     # # # #           #   # #   #   # # #
 # ####### ### ####### # ##### ############# # # # ##### # # # ####### # ##### # ######### # # # ########### # # # # ### # # # #
 #   #   # # # #   #   #     # #   #     #   #   # #   # # # # #   #   #         #         #   #             # #   #   # #   # #
 ### # # # # # ### # ####### ### # # # ### ####### # # ### # # # # ### ########### ##################### # ### ### ### # ##### #
   #   # # #   #   #     # #     # # #       #   # # #   #   # # #   #     #       # #   #           #   #   #   #   #   #     #
 ####### # ##### ####### # ####### # ######### ### # ### ##### # ### ####### ####### # # ### ##### # # # ########### ##### #####
       # # #   #           #     #   #   #   #     # # #   #   # # # #       #     #   #   # #   # # # #   #     # #     # #   #
###### # # # # # ######### # ######### # # # ####### # ### ##### # # # ####### ### ####### ### # # ### # ### ### # ##### # # ###
   #   #   # # # #       # #         # # # #         #     #   # #   #   #   #   #       #     # #     # #   # # #         #   #
## # ######### # # ##### # ######### # ### ################# # # ####### # ##### ##### ######### # ##### # ### # ####### ##### #
   #     #     # # #     #       #   #   #   #         #   # # # #       #     # #   #     #   # # #     #   # # #     # #     #
 ### # # # ##### # # ##### ##### # # ### ### ##### # ### # ### # # ########### # ### ##### # # # ### ####### # # # ### # ##### #
   # # # #   #   # #   #   #   # # #               # #   #     # # #     #     # #   #   # # # #   # #     #   #   # # #       #
## ### # ### # ### ### ### # # # # # ######### ##### # ######### # # ### # ##### # ### # # # # ### # # # # ######### # ####### #
 #   # #   # #   # # #   # # # #   # #       # #   # # # #     # #     # # #G    # #   #   # # #   #   # # #   #     # #     # #
 ### # # # # # # # # ### ### # ####### ##### ### # # # # # ### # ####### # # ##### # ####### ### ### ### ### # # # ### # ### # #
   # # # #   # # #   #   #   #     #   #         # #   #   # # #         # # #     #         #   #     # #   #   #   # # # #   #
## # # # ####### ##### ### ####### # ############# ### ##### # ########### # # # # ########### ### ##### # ######### # # # ### #
   # # # #     #     #   # #   #     #         # #   #     #             # # # # #         # # #   #     #       # #   # # # # #
 ### # # # ### ##### ### # # # ####### ####### # ### ##### ### ####### # # # ### ######### # # ##### ### ####### # ##### # # # #
     # #     #     # #   # # # #     # #   #   #   # #   #   #   # #   #   #     #       # # #       #   #     #     # #   # # #
 ##### ##### ##### ### ##### # # ### # # ### ##### # # # ### ### # # # ########### ### ### # ######### # # # # ##### # ##### # #
   #     #       #     #     #   #   # #   # #     # # #   #   # #   # #   #     #   # #   #     #     # # # # #     #       # #
## ##### ####### ####### ######### ##### # # # ##### # ### ### # ##### # # # ### ##### # ### # # # ### # # # ### ##### ##### # #
 # #   #   # #   #               #       #   # #     # #   # # # #   # # # # # #   #   # #   # #   #   # # #   #   #     # # # #
 # # # ### # # ### # ####### # # ############# # ####### ### # # # # ### # # # ### # ### ##### ##### # # # ### ### ##### # # # #
 #   #   # # #     #     #   # #       # #       #   #   #       # # #   # # #     #   #       #     # #   # # #   #   # #   # #
 ####### # # ######### # # ### ### ### # # ######### # ####### ### # # ### # ######### ######### ##### ##### # # ### # ### ### #
   #   #   #   #     # # #   #   #   #   #   #     # # #   #   #   #   #   #       #   #   #     #   #       # #     # #   #   #
 ### # ####### # ### ### ### # # ####### ### # ### # # # # # # # ####### ######### # ### # # # # # ######### # ####### # # # ###
     # #     #   #   #   #   # #   #   # #   #   #   # # # # # # #   #   #         # #   #   # # #         # #   # #   # #     #
###### # ######### ### ### ##### # # # ### ### ####### # ### # # # # ##### ######### # ##### # # ####### ### # # # # ######### #
       #     #   #     #       # #   # #   # #   #   # #     #     #               # #   # # # #         #   # #   #           #
 ########### # ############### # ##### # ### # # # # # ######### ################# # # # # # # ########### # # ############### #
 #   #             #     #     # #   #   #     #   # #     #     #   #   #         # # # #   # #     #   # # #       #         #
 ### # ####### ##### ### # ####### # # ### ######### ##### # # ### # # # ####### ### ### ##### # # ### # # ####### ### ####### #
         #   #   #   # #   #       # #             #       # #   # #   #       #   #   # #   #   # #   # # #     #   #   #     #
## ##### # # ### # ### ### # ##### # # ### ####### ############### ########### ### ### ### # # ### # ##### # ### ### ##### #####
 # #   # # #   # # #     # # #   # # #   # # #   # #         #     #   #   #   # #   #     # #   # #       # # #     #     #   #
 # # # ### ### ### ##### # # ### ### ### # # # # # # ####### # ####### # # # ### ### ####### ##### ######### # ### ### ### # # #
   # #     #   #   #   #   #   #   # #   # # # #   #       # # #     #   # # #       #     # #   # #       # #   # #   # # # # #
 ### ####### ### ### # ####### ### # ##### # # ########### # # # ### ##### # ####### # ### # # # # # ##### # ### # # ### # # # #
 # #     #   #     # #     #     # #   #   # #           # # # # #   #   # #   #   #   #   # # #   # #   # # #   # # #   #   # #
 # ##### # ### ### # ##### # ##### ### # ### ########### # # # # # ### # # ### # # ####### # # ### # # ### # # ### # # ### #####
   #   # #   #   # #     #   #     #   #     #   #   # # # #   # #   # # #   #   #       # #   #   # # #   # #     #   #   #   #
## ### # ### ##### ##### ##### ##### ####### # # # # # # # ######### ### ### ##### ##### # ##### ### # # ### ##### ##### # # # #
   #   #   # #   #   #   #   # #           # # #   #   # #           #   #       # #   #           # #   #   #   #   #   #   # #
 ### ##### # # # ### # ### # # ########### # ######### # ############# ### # ### # # # ########### # ##### ### # ##### ##### ###
 #   #     #   #     #     # #         #   #     #   # #   # #             #   #   # # #       #   # #   #     # #     #   #   #
 ### # ### ################# ######### # ##### ### # # ### # # ######### ##### ##### # # ##### # ### # # ######### ##### # ### #
     #   # #     #     #     #   #   # # #     #   #   # # #   #     #   #   #     # # # #     # # #   #           #     #   # #
#### ### ### ### # ### # ####### # ### # # # ### ####### # ##### ### ##### # ##### # # # ####### # ################# ####### # #
   #   #   #   #   #   # # #     # #   # # #     # #     # #       #     # #       # # #   # #     # #             #   #     # #
 # ### ### ### ##### # # # # ##### # ### # ####### # ### # # ######### # ######### # # ### # # # ### # ##### ######### # ##### #
 #       #   #   # # # # # # #     #     #         # #   #   #       # #   #       # #   # #   #           # #         # # #   #
 ####### ### ### # # ### # # ##### ####### # ####### # ####### ##### # ### ####### # ### # ### ############# # # ####### # # # #
   #       #     # #     # # #             #         #   #     #   # #   #       # #   #   # #       #       # # #     # #   # #
 # ####### ####### ####### # # ############# ########### # ##### ### ### ####### ##### ##### ##### # # ##### # ### ### # ##### #
 #     #       #   #       #   #                       # #   #     # #     #   #   # # #   #       # #   #   #     # # #   #   #
###### # ##### # ### ##### ##### ########### # ####### # ### ##### # # ##### # ### # # ### ######### ### # ######### # ### # # #
   #   # #     #     #   #   # # #   #       # #     # # # # #   # # # #   # #   # # #   # #   #   #   # # #     #   # # # # # #
 # ##### # ######### # # # # # # # ### # # # ### ### # # # # # # # # ### # # ### # # ### # # ### # ### # # # ### # ### # # # # #
 # #   # # #   #     # # # #   # #     # # #   # #   # #   #   # # #     # # # #   #   # #       #     # #   # # #     #   # # #
 # # # # # ### # ##### # ##### # ####### # ### # # ### ####### # # ####### # # ##### ### ############# # ### # # ####### ##### #
 #   #   #   # #     # #     # #       # #   #   #   # #     # # #   #   # # #     # #   #   #     #   #   # #   #     # #   # #
 ########### # ##### # ##### ######### # ### ####### # # ### # # # # # # # # ##### # # ### # # ### ### ### # ##### ### # ### # #
 #         # #       # #   #   #       # #   #       # # #   # # # #   # #   #         #   #   # #   # #   #   #   # #   #     #
 ### ##### # ####### # # # ### # ######### # # ######### # ##### # ##### ##### ####### # ####### ### # # ### ### ### ##### ### #
   #   #   # #     # # # #   #   # #       # # # #       #   #   #   #         # #   #   # #   # #   # # #   #   #           # #
 # ##### ### ### ### # # ######### # ####### # # # ########### ### ### # ##### # # # ##### # # # # ##### ##### ### ######### ###
 #     #   #   #     # #   #   # #   #       #   #     #     #   # #   #     #   # #S# #   # # # # #     #     #     #     #   #
###### # # ### ### ### ### # # # ####### # # ######### # ### ### ### # ########### # # # ### # # # # ##### ##### ##### ### ### #
       # #   #   #   # # #   #           # #   #   # #   # #     #   #   #   #     # #       # # # #     #   #   #   # # #   # #
 ####### ### ### ### # # ######### ### # # ### # # # ##### ####### ##### # # # ##### ######### # # ##### ### # ### # # # ### # #
 #     #   #     #   # # #         #   # #   # # #     # #       # #     # #   # #   #   #   # # #     #   # #   # #   #   #   #
 # ####### ####### ### # ##### ### # ####### # # ##### # # # ### # # # # # ##### # ### # # ### # ##### ##### ### # ####### ### #
 #   #     #       # # #       #   #   #   # # # #   # #   # # #   # # # #     # #     # #                       #       #     #
 ### # ########### # # ######### # ##### # # # ### # # ### # # ####### # ##### # ####### ### ####### ####### ### ####### ##### #
 #   #       #   #   # #         #   #   #   #     # #   # # #   #     # # #   #       #   # #     # #     #   # #     # #   # #
 ### ####### # # # ### # ############# ####### ##### ### # # ### # ##### # # ####### # ### # # ### ### ### # # # ##### # ### # #
   #   # #   # #   #   # #           # #   #       # #   # #     #     #   #       # #   # # #   #     #   # # #       #   #   #
 # ### # # ### ### # ##### ######### # # ### # # ### # ############# # ########### # ### # # ### ####### ### # ### ####### #####
 # # #   #   # #   # #     # #   #   # #     # #   #   #     #     # #   #       # #   # # #   #   #   #   # #   #   #   #     #
 # # ### ### # # ### # ##### # ### ### ####### ### ######### # ### # ### # # ##### ##### # ####### # ##### # ### ### # # ##### #
 # # # # # # # #   #   #     #     # # #       #       #     #   # # #   # #       # #   #         # #   # # #   #   # # #   # #
## # # # # # # ### ##### ### ####### # # ####### ##### # ####### # ### ### ######### # ############# # # # # # ####### # # ### #
   #       # #   # #       # #     #   # #     # #     # #   #   #   # #   # #   #     #           #   #   # #       # # #     #
 ######### # ### # ##### # ### ### ##### # ### # # ##### # # ####### # # ### # # # ##### ### # # ########### ####### # # ##### #
       #   #     #     # # #   # #     #   #   # #       # #     #     #   #   # #       #   # #             #   #   # # #     #
 ##### # ####### ##### # ### ### ########### ### ##### ### ##### ######### ##### ### ##### ####### ### ### # # # # ##### # # # #
     # #   #     #   # # #   #     #         #       #   # #   # #         #   #   #   #   #     #   # # # # # # #   #   # # # #
 ##### # # # # ### # # # # ##### # ### ####### ##### # # # # ### # ######### # ### # # # ##### # ### # # # ### # ### # ### ### #
 #     # # # #   # # # # # #     #   # #         #   # #   #   # # #   #     #       # #     # #     #   #     #   #   #   #   #
## ##### ### ##### # # # # # ####### # # ### ### # ### ### ### # # # # # ### ######### ##### # ####### ######### # ####### # ###
   #       #   #   # # # #   #     # # #   #   # #   #   #   # #   # #   #   #       #     # # #     # #       # #   #   # #   #
 ### ##### # # # ### # # ##### ##### # ######### ### ### ### # ##### ######### ##### ##### # ### ### # # ##### ##### # # ##### #
   # #   # # # #   # # #       # #   # #       #   #   #   #       # #   #     #     #   # #     # # # #   #   #   # # #     # #
 # ### # # # ### ### # # ####### # ### # ##### ### ### # # ####### # # # # ##### ##### # # ####### # ##### # ### # # # ####### #
 #     # # # #   #   # #         # #   # # #   # #   # # # #     #   # # # #     #   # #   #       #       # #   #   #   #     #
 ####### # # # ### ### ##### ##### ### # # # ### # ### ### # ### ##### # # # ##### # # ########### ######### # ######### # # # #
 #       #   # #   # # #   # #     #   # # # #     #   #   # # # #     # # #   #   #   #         # # #       #     #   # # # # #
## ####### ### # ### # # # # # ##### ### # # ##### # ### ### # # # ##### # ### # # ### # ####### # # # ########### # # # ### # #
   #       #   #   # # # # # #       #   # #   #   # #         #   #   #   #   # # #   #       # # # #           # # # #     # #
 ######### # ##### # # # # # ######### ### ### ### # ######### ####### # ### ### # ####### ##### # # ########### # # # ####### #
 #         # #   #   # # # #     #   # # #   #   # #   #     #     #   # # #   # #         #     # #   #   # #   #   #   # #   #
 ### ####### # # ##### # ####### # ### # # # ### # ### # ### ####### ### # ### # ####### ### ##### ### # # # # ######### # # ###
   # #       # #   #   #         #     # # #     #   # # # # #       #       # #   #   # # # #   #   # # #   # #         # #   #
## ### ######### # # ####### ########### # ####### # # # # # # ############### ##### # # # # # ##### # # ##### # ######### ### #
   #   #   #     # # #     #   #   #     # #       # #     # #     #     #   #       # #   # # #   # # #       #   # #     #   #
 ### ### # # ##### # ### # ### # ### ### # ### ##### ####### ##### ### # # # ### ##### # ### # # # # # ########### # # ##### ###
   # # # #   #   # #   # #   # # #   # # #   # #   #     #   #     #   #   #   # #     #   # #   #   #   #   #     #   #   #   #
 # # # # ##### # # ### # ### # # # ### # ### ### # ##### # ### ##### ######### ### ##### # # # ##### ### # ### ##### ### # ### #
 # # #   #     #     #   #   # # #   # #   # #   #     # # # #     # # #     #     #     # # # #   #   # #   # #   #     #   # #
## # ##### ######### ##### ### # ### # ### # # ####### ### # ##### # # # ### ############# # ### # ### # ### # ### ######### # #
   # #   #       #       # #   #   # # # # # #   #     #   #   # #   # # #   #     #   #   #     #   # #   #   #     #   #   # #
 ### # ######### # ##### # # # ### # # # # # ### # ##### ### # # ##### # # ##### # # # ############# # # # ##### ### # # # ### #
     #           #     #     #       #           #       #   #           #       #   #               #   #         #   #       #
################################################################################################################################
