################################################################################################################################
################################################################################################################################
# #     #       #           #   #   #           #                 #   #         #       #         #   #     #     #       # #   
# # ### # # # # ####### # # ### # ### ########### ##### ##### ### # # # # ####### ### # # ####### # # # ### # ### # ##### # # ##
# # #   # # # #   # #   # #   # #   #   #   #   # #   #     # # # # # # #     #   # # # #     # #   # #   #   # # # # #   # #   
# # ##### # # ### # # ### ### # ### ### ### # # # # # ##### # # # # # # ##### # ### # # ##### # ##### ### ##### # # # # ### ### 
#       # # # # # #   #   #   #   #   #   # # #   # # #     #   #   #   #   # # #   # #   #   #   # # #   #   # # # #   # # # # 
# ##### # # # # # ##### ### ### ##### ### # # ##### # # # ############# # ### # # # # # ### ### # # # # ### # # # ### ### # # # 
# #   #   # # # #   #   #   #   #   # #   # # #   # # # # #     #     # #   # # # # # #     # # #   #   #   #   # #   #         
# # # ##### # # ### # ### ##### # ### # ### # # # ### # ### ### # ### # ### # # ### # ### ### # ######### ####### # ########### 
# # # #   # # #       # #     #     # #   # #   #   # #       # # # # #   # #       #   # #   #     #   #         # #         # 
# # # # # ### ######### ##### ##### # ### # ####### # ######### # # # # # # ########### # # # ##### # # ########### # ####### # 
# # #   #     #     #       #           #     # #   #   # #   #   #   # # #     #   #   #   #     #   # #     #   #   #     #   
# # ##### ##### ### ##### # ### ####### ##### # # ### # # # # ########### ##### # # # ### ####### ##### # ### # # ##### ### ### 
# #   #   #   #   # #     #     #     # #       #   # # # # # #         # #   #   # # #         #       # # #   #   #   #     # 
# ### # ### # ### # # ########### ### # ### ### ### # # # # # # ####### # # ####### # # # ##### ######### # ######### ### ##### 
#   # # #   #     # #       #     # # #     #         #     # #   #     #   #     #   # # #   #             #   #     # #       
# ### # # ######### ####### # ##### # ####### # ########### ##### # ######### ### ##### # # # # ####### ### # # # ##### ########
# #   # # #   #     #   #   # #               # #         #       # #         #   #     # # # #       #   #   # # #   # #       
### # ### # # # ##### ### ### # # ############# # ####### # ####### ########### ##### ### # ### ##### # # ##### # ### # # ##### 
#   # #   # #   #   #   # #   # #   #         # #     # # #       #         #   #     #   #   # #     # #   #   #   # # #     # 
# ### # ######### ##### # # ######### ####### # ##### # # ####### ##### ##### ### ####### ### ### ##### ### # ##### # # ##### ##
#   # #     #     #   #   #   #       #       # #   #   #       # #   #   #   # #       #   #   # #     #   #   #   #       #   
### # ##### ### ### # ### ### # ####### ####### # # ########### # # # ### # ### ### ### ### ### # # ### # # ##### ######### # # 
#   #     # #   #   #   #   #   #   # #       # # #   #     #   # # #   #   #     # #   #   # #   # #   # # #   #   #     #   # 
# ######### # # # ##### # # ##### # # ####### ### ##### # ### ### # ### ######### ### ### ### ##### # ### # # # ### # ### # ####
#         # # # # # #   # #       # #       #     #   # #   # # # # # #       #   #   #   #   #   # #   # # # #   #   #   # #   
######### # ### # # # ### # # ##### ####### ####### # # ### # # # # # ####### ### # ### ### # # # # ### # ### ### ##### ### # # 
#   #   #   #   #   #     # #     # #   #   #   #   #   # #   #   #   # #   #   #   # # # # #   # #   # #   #   #     # # #   # 
# # ### ##### # ########### # # # # # # # ### ### ####### ##### ####### # # ### ##### # # # ######### # ### ### ##### # # # ### 
# #   #       # #           # # # #   # #   # #   #     #     # #     # # #   # #     # # #       # # #   #   # #   #   #   # # 
# ### ### # # # ### ####### # # ####### ### # # ####### ### ### # # ### # ### # # ##### # ####### # # ### ### # # ####### ### # 
# # # #   # # #   # #       # #       #     # #   #   #         # # #   #   # # # #     #       #   #   #   #   #         #   # 
# # # # ### # ### ### ####### ##### # ####### ### # # ##### ####### # ##### # # # # ######### # # ##### # ####### # ####### ### 
# #     #   # # #     #       #   # #     #     # # #     #         #       # # #   #       # #   #   # #         # #     #     
# ##### # # # # ########### ### # # ####### ##### # ##### ### ############### # # ####### # ##### # ### ### # ####### ### ##### 
#     # # # # #             #   # #         #   # #   #   #   #     #   #   # # # #     # #       #     #   #   #   # #   #     
##### ### ### # ##### ##### # ### ########### # # ### # ##### # ### ### # ### # # # ### # ####### ####### ##### # # ### ####### 
#   #   #   # # #     #     #   #     #     # # #     #       #   #     #   # # # # #   # # #       #     #     # #     #       
# # ### ### # # # ##### # ##### ### ### ### # # ############# ### ######### # # ### ##### # # ##### # # ### # ### ##############
# #     #   # # #     # #     #   # #   # #   # #       #                     #   #   #   # # #   # # # #   #   # #             
# ####### # # # ##### ######### ### # ### ##### # ##### ############# ##### ##### ### # ### # ### # ### # # ### # ##### ####### 
#   #     # # #   #   #     #   #   #   #     # #     # #         #   #   # #   #   # # #   #   #   #   # # #   #   #   #   #   
### # ##### # ##### ### ### # ### ##### ### # # ##### # # ####### # ### # # # ##### # # # ##### ### # ### # # ##### # ##### # ##
#   #   #   # #   #       #   #   #   # #   # # #     #   #   # # # # # # #   #     # # # #   #   #   #   # #     #   #   # # # 
####### ### # # # # ####### ### ### # # # ### # # ######### # # # # # # # ### # ##### # # # # ### ##### ### ##### ##### # # # # 
#     #   # #   # #   #   #   # #   # # # #   # # # #       #   # #   # #     #   # # #   # # # # #     #   #   # #     #   #   
# ####### # ##### ##### # ### # ##### # ### ### # # # ### ####### ##### ##### ### # # ##### # # # ### ### # # # # # # ######### 
#       # #     #   #   #   # #       #   # # #   #   # # #       #   #     #   #   #     # #   #   # #   #   # #   #         # 
####### # # ### ### # ##### ### ######### # # ######### # # ####### # ##### ### ### ##### # ####### ### ####### ############# # 
#   # #   #   #   # #     #   #   #     # #                       # #   #   # # #   #     #         #   #   #   #           #   
### # ##### # ##### ##### ### ### # ##### ############# ######### ##### # ### # # ### ############### ### # # # # ######### ####
#   #       #   #     # #   #   # # #     #             #       # #   # # #   # #   #     #   #   #   #   # # #       #   #     
# ####### # ##### ### # ### ### # # # ##### # ######### # ##### # # # # # # ### ### ##### # # # # ### # ### # ##### # # # ##### 
#         # #   #   # #   #   # # # #   #   # # #     # # #   # #   # #   #       # #   #   # # #   # #   # #   #   # # #     # 
########### # # ### # ### ### # ### ### ### # # # ### ### # # # ##### ######### # # # ####### # ### # ### # ### # ### # ##### # 
#           # #   # #   # # # #   #     #   # # #   #     # # # #   #   #       #   #   #   #   #   #   # # #   # #   # # #   # 
# ####### ### ### # ### # # # ### ####### # # # ### ####### # # ### ### # # ####### ### # ####### ####### # ##### ### # # # ### 
#   #   #   # # #   #   # # # # #     #   # #     # # #     #   #   # #   # #     #   # #   #   #   #     #     #   # # #   #   
# # ### ### # # ##### ### # # # ##### # ########### # # ######### # # ##### # ### # # # ### # ##### # ######### # # ### ##### # 
# #       # # #       #   # #     #   #     #       # # #   #     # #       # #   # # #       #     #   #   #   # #   #     # # 
# ######### # ### ### # ### ##### # ####### # ####### # # # # ### # ### # ### ### ### ##### ### ####### # ### ### ### ##### # # 
#     #   # #   # #   # #   #     # #     # # # #     #   # #   # #   # #   #   #   # #   # #   #   #   #   # #     #   #   # # 
##### # # # ### ### ### # # # ##### # ### ### # # ####### # ### # ### # ####### ### # ### # # ### # # ##### # # ##### # # ##### 
# #   # # #   # #   #   # # # #   #   # #         #     # #   # # # # # #   #   # # #         # # #   #     # # #     # #   #   
# # ### # ##### # ### ##### # # # ##### ########### ### ##### # # # # # # # ##### # # ####### # # ######### # # # ######### # ##
# # #   # #   # #     #     #   #     # #   #       # #     # # # # #   # #     #   # #     #       # #   # # # #   #     #   # 
# # # ### # # # # ##### # ########### # # # # ####### ##### # # # # ### # ##### # ##### ### ####### # # # # # ##### # ### ##### 
#   #   #   #   #     # #     #       #   # # #     #     #   # # #     #   #   #     # #   #   #   #   #   # #   #     # #   # 
# ##### ######### ### # ####### ####### ##### ### ####### ##### # # ### ### # ####### ### ### # # ####### ### # # ##### # # # # 
# #     #   #   #   # #   #     #       #   #   #       # #     # #   #   # # #     #   #     # #       # #   # #     # #   #   
# # ##### # # # ##### ### # ##### ##### # # ### ####### # ##### # ### ##### # # ### ### ####### ####### # # ### ##### # ####### 
# # #     # # #     # #   # #       #   # #   #     #   #   #   # # # #   # #   #   # # #   #   #       # #   #   # # #   #   # 
# # ####### # ##### # # ### # ##### # ### ### ##### # ##### ##### # # # # # ######### # ### # ### ####### ### ### # # ##### # # 
# #       # #   #   #     # # #   # #   # # #     # #     #       #   # # #   #     # # #   #   # #   #     # # #   #   #   # # 
# ####### # ### # ####### # ### # # ### # # ##### # ##### ######### ### # ### ### # # # # ##### # # # # ##### # ####### # ### # 
# #     #   #   #       # #   # #   #   # #     #   # #   #         #   #   #     # # # #           # #   #   #   #   #   #   # 
# # ### ##### ######### # ### ####### ### ##### ##### # ######### ### ##### ####### # # # ### ##### # ### # ##### # # ##### ####
# # #         #   #     #   #       # # #     # #   #           # #   #     #   #   #   # #   #   # #     #       # #     #     
# # ########### # # ############### # # ##### # ### ########### # # ### ####### # ### ##### # # # # ########### ### ### ####### 
# #   #   # #   #   #         #     #      G#   #   #         #   #   #   #     # #   #     # # # #     #     #       #       # 
# ### # # # # ####### ####### # ##### ########### ### ####### ####### ### # # ### # ##### ### # # ####### ### ######### ### ### 
#   # # #   # #     # #   # #   #   #     #         #     #   #       # # # #     # #     #   # #       # # # #   #   # #   #   
# ### ##### # # ##### ### # ####### # ### # ##### # ##### # ### ####### # # ####### ####### # # ####### # # # # ### # # # # # ##
#   #   #   # # #         #         # # #   # #   #       #     #     #   #     # # #       # #     #   #   # #     # # # # #   
### ### # # # # # ##### ### ##### ### # ##### # ### ############# # # ######### # # # ### ### ##### # ####### ####### # # # ### 
#     # # # # #   #   #   #     #     #     # # # #     #         # # #         #     #   #   #   # #   #   # #     # # # #   # 
# ##### ### # ### # # # ### ### ### ### # # # # # ### # # ##### # # # # ################# # # # # # ##### # # # ### # ### ### # 
#   #   #   #   # # # #       #   #     # # # # #     #   #   # # # # # #   #       #     # # # #   #   # #   # #   #     #   # 
### # ### ##### # # # ########### # ##### ### # ####### ### # # # # # # # # # ##### ####### # # ### # # # ##### # ############# 
#   # #       #   # #     #   # # # #   #     #   #         # # # # # #   # # #     #       #   #   # #   #     #     #         
##### ####### ### # ##### # # # # ### # # ####### ### ##### ### # # # ##### # ### ### ########### # # ##### ######### # ########
#   #   #   # #   # #   #   # #   #   # #   #   #   # #S  # #   # # # #   # #   #     #     #     #     #   #   #   #   #   #   
# # ### # ### # ### # # ##### ##### ### ### # # ### # # # ### ### # ### # # # # ####### ### # ######### # ##### # # ### # # ### 
# #     #     #   #   # #   #     # #   #   # # #   # # #     #   #     #   # # #       #   # #           #   # # #   # # #   # 
# ########### ### ### # # # ##### # # ####### # # ##### ####### ############### # ### ##### ### ####### ##### # # ### # ##### # 
#     #     #         #   #     #   #       # #   # #   # #         # #   #     # # # #   #   #   #   #   #     # #   #         
# ### # ### ### ### # ######### ########### ####### # ### # # ##### # # # ####### # # # # ### ##### # ### # ##### # ########### 
#   # #   #   # #   #     #   #   #   #   #   #     # #   # # #     #   #         #   # #   #   #   # #       #   # #       #   
### # ####### # # ### # # ### # ### # ### ### # ##### # ### # # ################### ### ### ### # ### # ##### # ##### ##### # ##
# # # #     #   # #   # #     #     #   # #   #       # #   # # #       #       #   #   # # #     #   # #   # #   #   #   # # # 
# # # # ### ##### ##### ############### # # ########### # ### # # ##### ##### ### # # ### # ####### ### # # ##### # ### # # # # 
#   # #   #   #   #   #               # # #   #         # #   #   # #   #   #     # # #   #   #   #   #   # #     # #   # # #   
### # ####### # # # # ##### # ### ### # # ### ######### # # # ##### # ### # ### ##### # ##### # # ### # ### # ##### # ##### # ##
#   #         # # # # #   # # #   #   #   # # #       #   # #       # #   # #   #     # #   # # #   # #   # # #   # #     # #   
# ############# # # ### # # # # ########### # # ##### ##### # ####### # ### # ### ##### # # # ##### # # # ### # ### ##### # ### 
# #   #       # # #     # # # #       #   # # #     #   #   #       #   #   #   #     #   #   #   # # # #       #   #     #   # 
# # # # ##### # ######### ### ####### # # # # ##### ### # # ####### ##### ########### ######### # # # # ### ##### ### ####### # 
#   #   #   # #       #   #   #     #   #   #       #   # #       #   # # # #       # #   #   # # #   #   #   #   # #         # 
# ######### # ##### ### ### ### ### ################# ### ##### ##### # # # # ##### # # # ### ### # ### # ### # ### ########### 
#     #   # #     #   #   # #   #   #                 #   #   # #     # # #     #   #   #               # #   #   # #           
##### # # # ##### ### ### # ##### ### ################# ### # ### ##### # ##### ######### ######### # ### ####### # ##### # ####
#     # # # #   #   # #   #         # # #   #   #       #   # #   #     #   #       #   # #       # #   #       # # #     #     
# ##### # # # ### ### # ############# # # # # ### # ### # ### # ### ####### ####### ### # # ##### # ##### ### ### # # ######### 
#       #   #     #   #   #           #   # #     # #   #   # #     #       #   # #   # # #   #   #     #   #     #   #         
# ################# ##### # ############### ####### # ##### # ####### ####### # # ### # # ### # ####### ############# # ####### 
#                 #       #     # #       #       # # #   # #     #   #   #   # #           # #       # #     #       #       # 
# # ##### ##################### # # ### ######### # # # # # ##### # ### # ##### # ##### ##### ####### # # ### ##### ######### ##
# #   # # #     #         #     # #   #   #     # # #   # # #   # #   # #       # #   # #   # #   #   # #   # #   #         #   
# # # # # # ### # ####### # ##### ### ### # # ### # ##### # # # ##### # ######### # # ### # # ### # ####### # # # # ####### ### 
# # # # #   #   #       #   #           # # #     # # #   # # # #     #   #     #   # #   # #   # #       # # # # # #   #   #   
# ### # ############### ####### ####### ### ####### # # # # # # # ####### # ### # ### # ### ### # ####### # # ### # # # # ### ##
#   #   #             # #     # #     #   #         #   # #   #   #   #   # #   #   # # #     # #   #   #   #   # # # # #   # # 
### # ### ####### ##### ##### # # ### ### ############### ######### ### ##### ##### # # # ##### # ### # ####### # # # # ##### # 
#   # #   #     #   #   #     # # # #     #   #   #   #             #   #     # #   #   #       #   # #   #   # # # # #   #   # 
# ##### ### ### ### # ### ####### # ##### # # # # # # # # ####### ### ### ##### # ############### # # ### # # # # # # ### # ### 
#         #   #     #     #       #         #   #   #   #       #                                 #     #   # #   #   #   #     
################################################################################################################################
