################################################################################################################################
#         #       #           #         #           #       #     #   #   #         #                             #     #     # 
# ####### ##### # # ######### # ####### ### ##### # # # ### # ### # # # # # ### ### # ### ### ### ######### ##### # ### # ### # 
# # #   #     # #   #   #     # #   # #     #   # #   #   # #   #   # # # # #   #   #   #   #   #         # #   # # # #     # # 
# # # # ##### # ##### # # ##### ### # ##### # # # # ##### # ######### # # ### ### ##### ### ############# # # ### # # ####### # 
# #   # # #         # # #     #     #   #   # # # # #   # #   #   # # # # #   #     #     # #       #   # # #   # # #   #   # # 
# # ### # # ######### # ############# # # ### # # # # ### ### # # # # ### # ####### # ##### # ##### ### # # ### # # ### # # # # 
# #   # # #   #     # # #   #         # #   # #   # # #   # # # # # #   # # #     # #   #   #   #   #   # # # # # #     # #   # 
# ### # # ### # ### # # # # # ##### # # ### # ### ### # ### # # # # ### # # # ##### ### # ### ### ### ### # # # # ##### # ##### 
# #   #   #   #   #   #   #   # #   # #     #   # #   # #   #   # # #   # #   # #   #   # #   #   #       #   #       # #       
# # ####### ##### ############# # ### ######### # # ### # # ##### # # ### ##### # ### ##### ### ######### ########### # ########
# #             #   #       #   #   # #       # # #   # # # # #   # # #                 #   # #     #     #   #       # #   #   
# ############# ### ##### ### ##### # ####### # ##### # ### # # ### # # ############### # ### ##### ####### # ####### # # # # # 
# #   #       # # #     #     #     # #   #   #     # #   # # #         #     #     #   #   # #   #     #   #   #     # # # # # 
### # # ##### # # ##### # ##### ### # # # # ####### # ### # # ##### ##### ### # ### # ##### # # # ##### # ##### ####### # # # # 
#   #   #             # # #     #   #   # # #     # #     #       # #     #   # #   #   #   #   #   #   #   # #       #   # # # 
# ####### ############# # # # ### # ##### # # ### # ############# # # ##### ### # ####### ##### ### # ##### # ####### ##### # ##
#       #   #     #   # # # # #   #     # # # # # #     #   #   #   #   # # #   # #   #   #   # #   #       #   #   # #     #   
# ##### ### # ### # # # # ### # ##### # # # # # # ##### # # # # # ##### # # # ### # # # ##### # # ########### ### # # # ####### 
#   #   #   # # #   #   #   # #     # # #   #   #       # #   # # #   # #   # # #   # #   #     #           #     # #   #   #   
# ### ### ### # ########### # ##### # ################### ##### # # # # ##### # ##### ### # ####### ####### # ##### ##### # ### 
#   #   #   #   #       # # # # #   #                 # # #     #   # # #   #       #     #       #   #   #   #     #   # #   # 
### ### ### ##### ### # # # # # # ##### ### # ##### # # # ######### ### # # ####### ####### ##### ### # # ##### ##### # # ### # 
# #   #   #       #  S# # #   #   #     #   #   #   # # #         #   # # # #   #   #     #     #   #   # #   # #     # # # # # 
# ### ### # ####### ### # ####### # ##### ##### # ### # ######### ### # ### ### # ####### # ### ### ##### # # ### ####### # # # 
#     #   # #       # #     #     #     # #     #   #   #       #   # #   # #   # #   #       #   # #   # # #     #       #   # 
# ##### # # # ####### ##### # ######### # ##### ### ##### ##### ### # ### # # ### # # # ######### ### # # # ####### ########### 
# #     # # # #     #   # #   #     #   #     #   # #     #   #   # #   # #   #   # # #   #   #   #   # #   #       #       #   
### ####### # # ### ### # ### # ### # ####### # ### # ##### # ### # ### # ### # ### # # # # # ##### ### ##### ######### ##### # 
#   #     # #   # #   #       #   # # # #     # #   # #   # #     #   # # #   #     # # # # #       #   #     # #     #   #   # 
# ####### # ##### ### ########### ### # # ####### ### # # # ######### # # # # ####### # # # ######### ### ##### # ### ### # ### 
# #   #   #     # # #   #     #   #   #   #       #   # # #       #         # #         #   #       #   # #     # # # #   #   # 
# # # # ##### # # # ### # ### # ### ####### # ##### ##### ####### ##### ##### # ####### ##### # ### ### # # ##### # # # ##### # 
# # # # #     #   #   # #   #   # #   #     # #   # #           # #   # #   #         #   #   #   #   #   #       #   #       # 
# # # # # ####### # # # ### ##### ### ### ### # # # ########### # # # ### # ##### ### ### # ##### ######### ########### ####### 
# # # # #   #   #   # # #   # #     #   #   # # # #         #   # # #     # #   #   #   #   #   #                     # #   #   
# # # # ### # # ##### # # ### # ### ### ### # ### ######### # ### # ####### # # ### ### # ### ######### # ##### ####### # ### ##
#   #     #   # #     #   # # #   #   # #   # #   #         #     # # #     # # #   #   #           #   # #   #     #   #     # 
# ############# ########### # ### ### # ##### # ### ########### ### # # ####### # ### ######### ### # ##### # # ### # ######### 
#     #       #             #     #   # #   #     #     #     # #   # #           # #   #       #   # #   # # #   # # #   #   # 
####### ##### ### ##### # ######### ### # # ########### # ### # ##### ##### ####### ### # ######### # # # # # ### # # # # ### # 
#   #   #   #   #     # #     #     #   # #           #     # #     #     # #     # #   #   #     # #   # # # #   # # # # #     
# # # ##### ### ### # # # # ### ##### ### ####### ### ####### ##### ### ### # ### # # ### # # ### # ####### # # ### # # ### ### 
# #   #       # #   # # # # #   #   # #       #   #   # #   # #       # #   # #   #   #   #   #   # #   #   # #   #   #     #   
# ########### # ####### ### # ### # # # ####### ### ### # # # ####### # # ### # ### ########### ### # # # ### ### ########### # 
# #           # #       #   # #   # #     #   # #     # # #   #   # # #   # # #   # #     #     # # # #   #   #   #   #       # 
# # ######### ### ####### ### # ########### # # # # # # # ##### # # # ### # # ### # # ### # ##### # # ######### # # # # ####### 
#   #   #     #   #     #     #   #         # # # # #   #       #   #   #   # #   # # #   # #       #         # #   # #     #   
##### ### ##### ##### # # ####### # ######### # # ##################### ### # ####### # ### ################# # # ### ####### ##
#     #   #     #     # #       #   #   #   # # #   #         #     #             #   #   #       #           # #   #   #     # 
##### # ####### ####### ####### ####### # # # # ### # ### ##### ### ########### ### ##### ####### # ########### ##### ### ##### 
#     #       #     # #         # #       # #   #   #   # #     #   #           #   #   #   #     # #               #     #   # 
# ########### ##### # ######### # # # ########### ##### ### ######### ######### # ### ##### # ##### ##### # ####### # ##### ### 
#   #   #   #       # #         #   # #   #   #       #   # #     #   #     #   #   #     # # #     #     #     #   # #         
### # ### ########### ### # ######### # # # # ####### ### # ### # ### # ### # ####### ### # ### ##### ######### # ### # # # ####
#   #   # #     #   #     # #         # #   #       #   # #     #   #   #   #     #     #   #   #     #       # #   # # # # #   
# ##### # # ### # # ### ### # ######### ########### # ### ######### ############# # ######### ### ##### ##### # ### # # # # # # 
#       #   #   # #   # #   #   #       # #         #         #   # #   #       #           # #   #     #   # # #   # # # #   # 
# ########### ### ### # # ##### # ####### # ################### # # # # # ##### ##### ##### # ##### ####### # ### ### # # ##### 
#   # #     #     # # # #       # #   # #   #         #         # #   #   #   #     #     # # #     # #     # #   #   # # #   # 
### # # ### ####### # # ######### # # # ##### # # ### # ######### ######### # ##### ##### ### # ##### # ### # # ### ### # ### # 
#   # # #           #       #   #   # #       # # # #   #       #   #     # #     #   #   #   #     #   # # # # #       #   #   
# ### # ############### # ### # ##### ##### ##### # ####### ### ### # ### ### ####### # ### ### ### ##### # # # ########### ### 
# #   #   # #     #   # #     #     #   #   #   # #         #   #   #   #   # #     # #     #   #   #   #   #   #         # #   
# ### ### # # ### # # # # ####### ##### # ### # # ####### ### ### ##### ### # # # ### # ####### # ### ### ####### ######### # ##
# #     #   # # # # #   #       #   # # #     # # #     # # # #   #   # #       #             # # # #   # #     #           #   
# # ### ### # # # # ##### ######### # # ####### # # ### # # # # ##### # # ############# ##### ### # # # # # # ################# 
#   #   #   # #   #     #   #     # # #   #     #   #   #   # #     #   # #   #       # #     #   # # #   # # #   #             
##### ### ### ######### # # # ##### # ### ########### ####### ##### ##### # # # ##### ### ##### ### # ##### # # ### ### # ##### 
#   #   #   #         # # # #       #   #           # #             #   # # # # #     #   #   # #   #   #   #       #   #   #   
# ##### ### ######### # # ########### # ########### # ##### # ##### # # # # ### ####### ##### # # ##### # # # ####### ##### # ##
#         #         #   #    G    # # #   #   #     #     # # #   #   #       #   #     #   # # # # #   # # # #   #   #     #   
##### ### ### # ### ##### ####### # # ##### # # ##### ### ### # # ######### # ### # ##### # # # # # # ##### # # # ##### ####### 
#     #   #   # # # #   #     #   #   #     # #     #   #   # # #         # #   # # #     # #   #           # # #       #       
# ### # # # ### # # # # # # # # ##### # ########### ### ### ### ######### # ##### # # ##### ################### ######### # ### 
# #   # #   #   # #   #   # # #   #   # #         #   #   #   # # #   #   # #     # # #   # # #   #       #     #         #   # 
# ##### ### # ### ####### # ##### # # # # ####### ### ####### # # # # # ### # ####### # ### # # # # ##### # ######### ### ### # 
# #   #   # # # #   #     # #   # # #   # #     # #   #       # #   #   # #   #   #   #     # # # # #   #   #         #   #   # 
# # # ### ### # # ### # ### # # # ##### # # ##### # ### ####### ######### # ##### # ######### # # # # # ##### # ####### ### ### 
# # # #   #   # #     # # #   # #     # # #       #   # #   #   #       #   #     #     #       # # # #     # #   #   #   # # # 
### # # ### ### ### ### # ########### # # ########### # # # # ######### # ### ######### # ####### # # ##### # ### # # ### # # # 
#   #   #   #       #   # #   #       # # #         #   # # # # #       # #   #         #       # # #   #   #   # # #   # # # # 
# ####### ####### # # ### # ### ####### # # ####### ##### ### # # ####### # ### ############### ### # ### ####### # ##### # # # 
# # #     #     # # #   # #   #       #   # #     #         # #     #     # #   #       #     #     # #   #       # #     # #   
# # # ##### ### ### ### # ### ####### # ### # ### ### ##### # ##### ##### # # ####### # # ### ####### # ### ### ### # ##### ### 
# # # #       # #   # #   #     #   # #   # # #     #     # #   # #     #   # #     # # # #     #   # #   # #   #   # #   # #   
# # # # ##### # # # # ######### ### # # # # ### ######### # ### # ##### # ### # ### # # # # ### # # # ##### # # # ### # ### ####
#   # #   #   #   # #   #   #       # # # #   #   #     # #   # #     #   #   # #   # #   # # # # # #     # # # #     # #   #   
# ### ### # ### ####### # # # ####### # ##### ### # ### # ### # ##### ### # ### ########### # # ### ##### # # # ####### # ### # 
# #   #   # #   #     #   # #   #   # # #     #   #   #   # # #   # #         #           #   #           # # # #     # #     # 
# # ##### # ##### ### ##### # ### # # # # ##### ########### # ### # # # ##### ########### ############### # # # ##### # ####### 
# #     # #     # #       # # #   # # #   #       #       #     # #   #   #           # # #   #         #   # #   #   #     #   
# ##### # ##### # # ##### # # # ### # # ####### ### ##### ##### # ######### ######### # # # # # ####### ##### ### # ####### # ##
#   # # #     #   #     # # # # #   # # #     # #   #   #   #   #           #     #     #   #   #   #   #     #   # #     # #   
# # # # ### ########### ### # # ### # # # ### # # ##### ### # ############### ### # ############# # # ### # # # ### # # # # ### 
# #   # # #           #     # #   # # # #   #   #     #   # #   #     #       #   # #   #       # # #   # # # #   # # # # #   # 
# ##### # ##### # ########### ### # # # ####### ##### ### # ### # ### # ####### ### # # # ##### # # ### # # ##### # # # ### ### 
#     # #       #           #   # #   #                 # #   #   # # # #     # #   # # # #     # #     # #     #     #     #   
# ### # ##### ####### # # ##### # ##################### # # # # ### # # ##### # # # # ### ####### ####### ##### ############# ##
# # # #   #   #     # # # #     # #         #       # # # # # # # #   #     # # # # #   #       #       # #   # #     #     #   
# # # ### ##### ### # # # # ##### ### # ### # ##### # # # ### # # ######### # # ### ### ### ### ####### # # ### # ### # ### ### 
#   #   #     # #   # # # #     #   # # #   #     #     #   # # # # #     # #           #   #         # # #     # #     #     # 
# ### # ##### ### ### # ####### ### # # # ### ####### ##### # # # # # ##### # ####### ##### # ####### # ####### # ########### # 
# # # #     #   # #   #   #   # #   # # #   # #       #   # # # #   # #     # # #   #       #   #   # #       # #         # # # 
# # # ##### ### # # ##### # # # # ### # ### # # # ##### # # # # # ### # ##### # # # ##### ##### # ### ####### # ######### # # # 
#   #   # #   # # # #   #   #   #   # # #   # # # #   # # #   #   #   #   #   # # #   #   #     #           # #         # # #   
# ##### # ### # # # ### # ######### ### ### ### # # # ### ##### ### ##### ### # # ### ##### ##### ########### ### ### ### # ### 
#   #   #     #   #   # #         #   #   # #   # # # #   #       # #   #   # # #   #   #   #     #         #   # #   #   #     
# ### ##### ######### # ### # ####### ### # # ### # # # ### ##### # # # ### # # ### ### # ### ##### ####### ### # # # # ####### 
#   #   #   #   #   #   #   #   #   # #   # # #   # #   #   #   # #   # #   #   #   # # #   # #   #     # #     # # # #   #     
### ### ##### # # # ##### ### ### # # # ### # # ### ####### # ### ##### # ####### ### # ##### # # ##### # ####### # # ### # ####
# #   #     # # # # #   # #   #   #   #   #   #     #     # #     # #   #   #     # # #     #   #       #   #     # #   # # #   
# ### ##### # # # # # # # ##### ######### ####### ### ### # ####### # ### # # ##### # ##### ##### # ####### # # # # ##### # # # 
#   #     # # #   # # #   #   # # #     # #     #   # #   #         #   # # # #     # #   #   #   # #     #   # # #   #   # # # 
### # # ### # ##### ### ### # # # # ### ### ### # ### # ##### # ####### ### # ##### # # ##### ##### # ### ####### ### # ### # # 
# #   # #   # #   #   # #   #   #   # #   #   # # #   # # #   #   #   #     #     #   #     #   #   #   #     #     # #   #   # 
# ##### # ### # ##### ### ########### ### ##### # # ### # # ##### # # ########### # ####### ### # ##### ##### # ##### ### ######
#       # #   # #     #   #     #       # #     #   #   #   #     # #           # #   #   #   # #     # #     # #   # # #       
# # ##### # # # # ##### ### ##### ##### # # ##### ############# ### # # ### ##### ### # # ### # # ### # ####### # # # # ####### 
# #   #   # # # #       #       # #     # #     #   #         # #   # # #   #     #     #     # #   # #   #     # #   # #       
# ### # ### ### ######### ##### # # ##### ##### # # # ####### # # ### # # ### ############# ### ##### ### ##### # ##### # ######
#   # #   #     #   #     #     # #       #   # # #   #     # # #   # # #   # #     #     # # # #   # # #   #   #   #   # #     
##### ### ####### ### # ######### ######### ### # ######### # # ### # ##### # ##### # ### # # # # # # # ### # ##### # ### # ### 
#   #   #       # #   #       #   #         #   #         # # #   # # #   # #   # # #   # #   #   # # #   # #     #   # # #   # 
# # ##### # # # # # ######### # ### ### # ### ########### # # ##### ### # ##### # # ### # ### ##### # # # # # # # ##### # ### # 
# # #     # # #   #   # #   #   #   #   #   # #   #     # # #     #   # # #   # # #     #   # #     # # #   # # # #   # #   # # 
# ### ##### # ####### # # # ##### ### ####### # ### # ### # ##### ### # ### # # # ######### # # ##### # ####### # # # # ### # # 
#     #     #             #         #               #           #     #     #   #                     #         #   #     #   # 
