################################################################################################################################
   #   #       #     #   #                         #         #   #             #               #     #   #     #     #         #
 # # ### ##### # ### # # # # # ############### ### ##### # # # # # ##### ### ### # ### # ##### # ### # # # ### ### # ######### #
 # #     #   #   #   # # # # #     #   #     #   #     # # # # # # #   # # #   # #   # # #     #   #   # #   #     # #     #   #
 # ### ### # ##### ### # # ####### # # # ### ### ##### ### # # ### ### # # # # # ### # # # ####### ##### ### ####### # ### # # #
 #     #   # #         # # #     #   # # # #     #   #   # # # #   #   # # # #   #   # # #       # #       #     # # #   #   # #
 ####### ### ########### # # ######### # # ######### ### # # # # ### ### # ####### ### # ######### ####### # ### # # ######### #
   #   # #       #       # #     #   # # # #   #     # #   #   #     #   #         #   #   #     # #   #   #   # # # #   #     #
## ### # ####### # ####### ##### # # ### # # # # ### # ####### # ##### # ######### ######### ### ### # ### ### # # # # # # #####
   #   #     #   #   #   #   #   # #     # # # #   #   #     # # #     # #   #     #       # # # #   #   #   # #   # # # # #   #
 ### ####### # ##### ### # ### ### ####### # # ####### # ### # # # ####### # ##### # ##### # # # # ##### ### ####### # # # # # #
   # #   #   # #   #   # #     # #   #   #   #   #     # #   # # #     #   # #   # # #     # # # # #   # #   #         # # # # #
## # # # # ### ### ### # ### ### ### ### # ### ### ####### ### # ##### # ### # # ### # ##### # # # ### # # ### ### ### # # # # #
   # # # # # # #   #   #   # #   # #     #   #       #     # # #   #   #   # # # #   #     # #   # #   # #     #     # # #   # #
 ### # ### # # # ### ##### # # # # ######### ####### # ##### # ### # ##### # ### # ######### # ### # ### ########### ### ##### #
   # # #   #   #     #   # #   #   # #   #   #     # #       # #   #       #     #           # #   # #   #         # #   #     #
 # # # # ### ### ##### # # ####### # # # # ### ### # ####### # # ############################# ### # # ### ####### # # ### #####
 #   # # #   #         #   #     #   # # #   # # # #         # #       #   #     #       #   #   # # #     # #   #   #     #   #
 ##### # # ##### ####### ### ### ##### # ### # # # # ######### ####### # ### ### # ##### # ##### # # ####### # # ##### ##### ###
     #   # #     #     #   # # # #   # #   #   # # # #   #     #       # #     # #   # # #     # # #       # # #       #   #   #
#### ##### # ### # ### # ### # # # # # ### # ### # ### # # ##### ####### # ##### ### # # ##### # # # ##### # # # # ### # # ### #
     #     # #   # # # #     #   # # #   # # #   #     #   #   # # #     #   #   #   #   #   # #   # #     #   # # #   # # #   #
###### ##### # ### # # ##### ##### # ### # # ### ########### ### # # # ##### # ####### ##### # ####### ##### ### # # ##### # # #
     # #     #   #   #     #     # # #   # # #   #             # # # # #     #       #   #   #       #     # #   # #     # # # #
 ### # # ####### ######### ##### # # ##### # # ### # ##### ### # # # ### ########### ### # ### # ### ##### ### # # ##### # ### #
   #   #       #         #     #   #     # # # # # #     #   # # # #   #     #     #     #     #   # #         # #   #   #     #
## ################# ######### # ##### # # # # # # ##### # ### # # ### ##### # ### ############### # # ######### # # # ####### #
   #             #   #     #   #     # # # #       #     # #   # #     #   # # #         #       # # # #     #   # # #       # #
 ### ### ####### # ### # ### ### ##### # # # ############### ### # ##### # # # # ##### # # ##### # # ### ### ### # ######### # #
 #     #   #   #   #   #     #   #     # # # #         # #   #   # #     # # # #   #   # # #   #   #     # #   # # #     #   # #
 # ### # # ### ##### ########### # ### ### # # ####### # # # # ### ### ##### ####### ### # # # ########### ### # # # ### # ### #
 # #   # #     #     # #         # #   #   # #     #   #   # #   #     #     #       # # #   #   #   #     # # # #   #   # #   #
 # ############# ##### # # ### # # ##### ### ##### # ########### ##### # ##### ####### # ##### # ### # ##### # # ##### ### # ###
       #       #     #   # #   # #     # #     #   #   #     #         #       #   #   #     # #   #   #   # # #     #   #   # #
 ##### # ##### ##### ##### # ### ##### # # ##### ##### # ### # ################# # # # ##### # ### # ### # # # ##### ### ##### #
 #   # # #   #     #     # # #       #   # #   #     #   #   # # #     #     #   #   #     # # # # # #   #   #     # #       # #
 # # # # ### ### ####### # # ##### ####### # # ##### ##### ### # # ### # ### ############# # # # # # ####### ##### # # ##### # #
 # # # #   #   # #       # # #   #           #     # #   #       #   #   # #         #     # #   # # #   #       # # #     #   #
 # # ##### ### # # ######### # # ####### ####### ### # # ########### ##### ######### ##### # ##### # # # # ### # # ##### # # ###
   #   #   #   #   #     #   # #       # #     #     # #       #    S#             #     # #       #   # # #   # # #   # # #   #
 ##### # ### # ##### # # # # # ####### ### ### ### ### ####### # ##### ### ##### # ##### # ############# ### ### # # # ### ### #
 #     #     #   #   # #   # # #     #   #   #   #   # #     # # #     # # #     #                     #     # # #   #   #   # #
 ############### ### # ##### # # ### ### ### ### ##### # ##### # # ##### # # ############### ##### ### ####### # ####### # # # #
     #     #   #   # # #   # # #   #   #     # # #     #     # # # #   # # #     #     #   #     #   #       # #     #   # # # #
#### # # # ### ### # # # # # # ### ### ####### # # ######### # # # ### # # ##### ##### # # # ### ########### # ### ### ### # ###
   #   # # #     # # #   # # #     #   #       #   #         #   #   #   #     #       # # # #   # #       # #   # #   # # #   #
 # # ### # # ##### ####### # ####### ### ########### ############# # ### # # # ######### # ### ### # ##### # # # # # ### # ### #
 # # #   # # #   #   #     #   # #   #             # #         #   #   #   # # #   # #   #   # #   #   #   # # # # # #   #   # #
 # ### ### # # # ### ######### # # ### ######### ### ### # ### ####### ##### # # # # # ##### # # ##### # ### ### # # # ##### # #
 # #   #   # # # #   #       #   # #   #       #   #   # # # #         #     #   # # #   #     #     # #   #   # # # #       # #
 # # ### ### # # # ### ##### ##### # ######### ### ### ### # ########### # # ##### # ### ########### # ### ### # # # ######### #
 # # #   #   # # # #     # #   #   #         #   #   #     # #   #       # #     # # # #       #     #   # #     # #           #
 # # # ### # # ### ##### # ### # ########### ### # # ####### # ### # ########### # # # ####### # ####### # ##### # ########### #
 # # #     #     #       # # # # #     #   #   # # # # #     #     # #   #     # #       #     # #     # # #   #         #     #
## # # ######### ######### # # # # ### ### ### # ### # # ########### # # # ### # ####### # ##### # ##### # # # ##### # # # # # #
   # # #   #       #     #   #   #   #   # # # #   # # # #           # # #   # #     #   #       # #     # # # #   # # #   # # #
 ### # # # # ##### # ####### ##### ##### # # # ### # # # ######### # # # # # # ##### # ########### # ##### # # # # # # ##### # #
 #   # # #   #       #         #   #   #     # # #   # #         # # # # # # #     # #       #     #     #   # # # # #   #   # #
 ##### # ##### ##### # ######### ### # ####### # ##### ######### # ### # ### ##### # # ##### ##### ##### ##### # # ##### # ### #
 #   # #   #   #   # #   #   #   # # #   #     #   #   #       # # #   #   # #   # #G#   #   #     #   #   #     #   # # # #   #
 # # ##### ##### # # ### ### # ### # ### # ##### # # ### ##### # # # ##### # # # # # # # # ### ####### ### ######### # # # #####
   #   #   #     # #               # #   #   #   #     #     # # # # #   #   # # #   # # # #   #     #   #   #     # #   #     #
###### # ### ##### # ####### ####### ####### # ############# ### ### # ####### ####### # # # ### ### ### ### # ### # ######### #
     # #   # # #   # #       #       #     # #   #     #   #   #     #       #     #   # #   # #   #     #   #   # #           #
 # ### ### # # # ### # ##### # ####### ### # ### # ### ### ### ####### ##### ##### # # # ##### # # ##### # ####### ########### #
 # #   #   # #   #   # #   #       #   # #   #     # #   #   #     # # #       # #   # # #   #   #   #   #   #     #     #     #
 # # ### # # # ####### # # # ##### # ### ######### # ### ### ##### # # # ##### # ##### # # # ######### ##### # ##### ##### # # #
 #   #   # # #     #   # #   #     #   #         #     # #     #   #   #   #   #       # # # #       #     # #   # #       # # #
 ##### # ### ##### # ### ##### ### ### # ####### ##### ### ### # ##### ### # ### # ##### ### # ##### ### # # ### # ####### ### #
 #     # #   #   # #   # #   #   #   #   # #     #   #     # # #     #   # #   # #     #     #     # #   # # #             #   #
 # ### ### ### ### ### ### # # ##### ##### # ##### # ####### # ##### ##### ### ####### ########### # # ### # ############# # # #
 # #   #   #           #   # # #         # # #   # #   #       #   #     #   #                   # #   #   #     #       # # # #
 ### ### ############### ### ### ####### # # # # # # ### ####### ####### ### ########### # ##### # ##### ####### # ##### ### # #
     #   #           #   # #   # #       # #   # # # #           #     #     #   # #   # #     # #   #   #     # #   # #     # #
###### ### ### ##### # ### ### # # ####### ##### # ### ########### ### ####### # # # # # # ### # ##### ### ##### ### # ####### #
       # # #   #   #   #   # #   #             # # #     #         #   #       #   # #   # #   #       #   #   #   #   #       #
 ####### # # ### # ##### ### ################# # # # ##### ######### ### ########### ##### # ### ####### ### # ### ########### #
         # # # # #     #   # #     #     #     # #   #   # # #     #     #           #   # #   #     #   #   # #   #         # #
########## # # # ##### ### # # ### # ### # ##### # ### # # # # ### ####### ########### ### ### ### ### # # ### # ### ####### ###
   #       #   #     # #   # # #   # #   #     # #   # #   #   # #   #   # #       #   #     #   #     #   #   #   # #     #   #
 # # ##### ######### # # ### ### # # ######### # ### # ####### # # # # # # ####### # ### # # ### ### ############# # # ####### #
 #   #   # #   #     #   # #     # #   #   #   # #   #   #   # #   #   # #   #           # #   #   #   #         #     #       #
 ##### # ### # # ######### ####### ### # # # ### ### ### ### # ######### ### ############# ####### # ### ############# # ##### #
       #     #   #               #       # # # #   #       #       #   # #   #       #     #   #   #   # #     #     # #   #   #
################## ### ### ##### ### ##### # # ### ####### ### ##### # # # ### ##### # # # # # # ##### # ### ### ### # ### #####
           #         #   # #     #   #   #       # #     #   #       # # # #   #   # # # # # # #   #   #   #   #   # #   #     #
 ######### # ### ####### # # ##### ### # ####### # # ### ### # ####### ### # ##### # # # ### # ### # ##### # # ### # ### ##### #
 #       #   #   #       # #       # # #       #     #   # # #   #   # #   #     #   # # #   #     # #     # # #   # #       # #
 ##### # ##### ### ####### ######### # ####### ####### ### # ### # # ### ####### # ##### # ### ####### ##### ### ### # ##### # #
   #   # #   # #   # #   #   #       # #       #   #     #       # #   #     #   # #   # # #   #       #     #   #   # #   # # #
## # ### # ### # ### # # ### # ####### # ####### # ##### ####### # ### ### ### ### ### # # # ### ####### ### # ####### # # ### #
 # #   #       #     # #   # # #       #   #     #     #   #   # # #     #   #   # #   # # #   # # #   # #   #       # # #     #
 # ### # ############# ### # # # ######### ##### ##### ### # # # # # ####### ##### # ### # ### # # # # # # ######### ### #######
 # #   # #     #   #   # # #   # #   #   # #     #   # # #   # #   # #   # # #     #     #   # # #   #   # #     # #     #   # #
 # # ##### ### # # # ### # ##### # ### # # # ##### # # # ##### # ##### # # # # ######### ### ### # ####### # ### # ####### # # #
 # #     #   # # #   #   #   #   #   # # #   # #   #   # # #   #   #   #   #   #   #       #   # #   #   # # # # #         #   #
 # ### # ### # # ##### ##### # ### # # # ##### # ####### # # ##### # ########### # ### # ##### # ### # # ### # # ### ##### #####
 #   # # #   #   #     #   #   #   #   #   #     #         #     # #           # #   # #   #   #   #   #   #   # #   #   #   # #
 # # ### # ####### ### # ####### ####### ### ############# ##### # ########### # ### ##### # ##### ####### ##### # ### # # # # #
 # # #   #   #     #   #   #           # #   #           #     # #     #     #   # #       #     # #   #   #     # #   # # #   #
 ### # ##### # ##### ##### ########### ### ### ######### # ### # # ##### ### ##### ####### ##### # ### # ### ##### # ### ##### #
     # #   # # #   #             #     #   #   #   # #   # #   # #     #   #   #       #     #   #   #   #   #     #   #     # #
#### ### # # # ### ####### ##### ##### # ### ### # # # ### # ### # ### ### ### # # ### # # ### # ### ### # ### ### ### ##### # #
     #   #   #   #     #   #   #       #   #     # #   #   #       #     #   # # #   #   #   # #   #   #   # #   # #   #     # #
 ### # ####### # ##### ### # # ####### ### ####### ####### ####### # ######### ##### ####### # # ##### # ### # # ### ### ##### #
   # # #       #     #   # # # #   #   #   #     #   #   #   #   # # #       # #     #       # # #     # #   # # #   # #     # #
## ### # ### # ### ##### # # # ### # ### ### ### ### ### # ### # # ### ##### # # ########### # ### ##### # ### # # ### ##### ###
 # #   #   # # # # #     # # #   #     # #   # #   #   #       # #   #   # #   #           # #     # #   #     # #         #   #
 # # ##### # # # # # ####### ### ##### # # ### ### ### # ####### # # ### # ##### ######### ######### # ### ##### ######### ### #
 # # #     # # # # #       #   #     # # #     #     # #   #   # # # # # #         #     #           #   # #     #       #   # #
 # # # ##### # # # ####### ### ##### # # ##### # ### # # # # # # # # # # # ### ### # ### ######### # ### # # ##### ### ##### # #
   # #   #   #   #         #   #   #   # #   # #   # # # # # #   # #   # # #   #   # # #       #   #       #     #   #       # #
#### # # ################### ### # ### # # # ##### # # # # ####### ##### # # ### ### # ### ### # ####### ####### ### ######### #
   # # #           #       #   # # #   # # # #   # #     # #   #     #   # # # #     #   #   # #       #       # #   #       # #
 # # # ####### ### # ##### ### # ### # # # # # # ##### ##### # ##### # ### # # ######### ### ######### # ##### # # ### ####### #
 # # #       #   #   # #     # #     #     #   # #   # #   # #     # # #   #               #       #   # #     # #     #       #
 ### ########### # ### # ### # ################# # # # # # # ##### ### # ########### ######### ### # ### # ##### ### ### ##### #
 #   #         # #   #   # # #     #     #   #     # #   # # #   #   # # #     #   #   #     #   # # #   # #   #     #   # #   #
 # ### ####### # ######### # # ### # ### # # ####### # ### # ### ### # ### ### # # ### # ####### # # # # # ### # ##### ### # # #
 #   # #     # # #   #   #   # #   #   # # #   #       #   #   #     #   #   # # # # # # #       # # # # # #   # #   # #     # #
 ### # # ### # ### # # # ### # ####### # # ### ##### ######### ######### ### # # # # # # # ####### # # ### # ##### # # #########
     # #   #   #   # # #   # # #     # # # # #       #         #   #   #   # #   # #   #   #     # # # #   #       #   #       #
## ### ### ##### ### ##### # # # ##### # # # ####### # ######### # ### ### # ##### ######### ### # # # # ############# # ##### #
 # #   #   #     # #   #   # # # #     #   #       # #   #       #       #   #   #           #   # # # #     #     #   #     # #
 # # ######### ### ### ### # # # # ########### ### # ### # # ####### ### ##### # ############# ##### # ##### # ### ### ### ### #
 # # #   #   # # # # #   #   #   # # #   #   # #   #   # # #     #   #       # #     #   #   #       #     # #   #   #   # #   #
 # # # # # # # # # # ### ######### # # ### # ### # ### # ####### # ### ##### ####### # ### ########### ### # ### ### ##### # ###
   #   #   #   #                   #       #     #               #   #     #                           #   #       #       #   #
