################################################################################################################################
   #   #     # #       #     #                 #   #       #   #                 #       #       #   #     #   #   #           #
 # # # ##### # # ##### # ### # ##### # ######### # # # ### # # ################# ####### ### ### # # # ### ### # ### # #########
 #   #       # # #   # # #   #   # # #       #   # # # # # # #     #       #   #   #         #   # # #   #   # # #   #         #
 ############# # # # # ### ##### # # ####### # ### ### # # # ##### # ##### # # ### ####### ##### # # ####### # # # ########### #
 #         #   # # #   #   #   #   # #       # #       #     #   #   #   # # # #       #   #   # # #   #   # # # # #   # #   # #
 # ####### # ### # ##### ### # # ### # ####### ############### ######### # # # ####### # ### # # # ##### # # # # # ### # # ### #
   #     #   #   #   # #     #   #   # #     #       #   #   # #         # # #   #   # # #   # # #       #   #           #     #
## # ### ### # ##### # ##### ##### ### # ### ####### ### ### # # ####### # # ### # ### # # ### # # ############### ########### #
 # # #     # #   #   #         #   #   # # #       #     #   #   #   #   #   # # #   # # # #       #     #         #       #   #
 # # ##### # ### ########### # # ####### # ### # # ####### ####### # # ####### # ### # ### # ##### # ### ######### # ##### ### #
 # #     #   # #   # #     # # #             # # #       #     # # #   # #     # #   #     # #   # #   #         #   #   #   # #
 # ######### # ### # # ### # # ############# # ####### # # # # # # ##### # ##### # # ####### # # # ### ######### # ### # # # ###
 # #       # #   # #   #     #             # #   #     # # # #   # #     #     # # #         # # #   # #       # # #   # # #   #
 # # ##### # # # # ##### ####### ######### # ### ######### # ### # # ######### # ######### ### # ### # # ####### # ##### ##### #
   # #   # #   # #   # # #     #   #   #   #   # #     #   #   # # #   #       # #       # #   #   # #   # #   # #   # #       #
#### # ### ##### ### # # # ### ##### # ##### # # # ### # ##### ### ### # ####### # ##### # # ##### # ##### # # # ### # #########
   # #         # #   #   # # #     # #   #   # #   # # # #     #   #     #       #   # #   # #     #       # #   # # #         #
 # # ### ##### # # ### ### # ##### # ### # ######### # # # ##### ####### # ######### # # ### # ##### ### # # ##### # ####### # #
 #   #   #   #   # #     #   #     # #   #           # # #   # # #       # #     # #   # #   # #     # # # # #     #         # #
###### ### # # ### # ######### ##### # ########### # # # ### # # ### ### # ##### # ##### # ### # ### # # ### ### ############# #
     # #   # #     # #       # #     #   #   #     # # # #   # # #   #   #     #         #   # #   # # #   #   #   #         # #
 ### ### ### # ##### # # ### # # ####### # # # ##### # # # # # # # ### ####### ######### ##### ### # # ### ### ### # ####### # #
   #     #             #   # #   #       # #   #   # #   # # # # # #   #     # #   #       #   #   #     #     #   # #     # # #
## ####### ####### ####### # ##### ####### ##### # # ##### ### # # # ### # ### # # # ##### # ########### ####### ### # ### # # #
 # #   # #   #   # #   #   #   #   #       #   # #       #     # # # # # #   #   # #     # #   #       #         #   #   # #   #
 # ### # # ### # ### # ####### # ### ####### ### ### ### ####### # # # # ### ##### ####### ### # ##### # ##### # # ### # #######
 # #   #   #   # #   # #   #   # #   #     #     #     #     #   # #   # #       #   #   #   #   #     # #     # # # # #     # #
 # # ### ### ### # ##### # ##### ####### ######### ####### # # ##### ### ##### ##### # # ### ##### ##### ####### # # # ##### # #
 #   # # #   #   # #     #     #       #           #     # # # #   # #   #   # #   # # #   #     #     #   #     # # #   # #   #
 ##### # # ### ### # ######### ####### ### ######### ### # ### # # # # ### # # # ### ##### ##### ##### # # # ##### # ### # #####
       # #   #   #   #         #   #   #   #     #   #   #   # # # # #   # # # #   #  S  # #   #   #   # # # #   # #           #
 # ##### ### ### ##### ######### # # ### ### ### # ### ##### # # # # ### # # ##### ##### # # # ### # ### # # # # # # ####### # #
 #       # #   # #     #         # # #     # #     # #     # # # #         #     # #     #   #     # #   # #   #   #   #   # # #
 ######### ### # # ##### ########### # ### # ####### ##### ### # ### ##### ##### # # ######### ##### # ### ### ##### # ### # # #
   #     #   # #   #   # #           #   # #       #     #   #   #   #   #     # # #     #   # #   # #   #   #       #   #   # #
## # ### # # # ##### ### # ############### ####### # ####### ##### # # # ##### ### ##### # # # # # # # ##### ########### ##### #
 # # # #   # # #     #   # # #           #       # #       #   #   # # #   #     #   # #   #   # #   # #   # # #       # #     #
 # # # ##### # ##### # ### # # ### ##### # ####### # ##### ### # ### # ### ##### ### # ####### # ##### # ### # # ##### # ##### #
 # # #                   # #   #   #   # # #       #   # #     #   # # # #     #               #   #   #     #   #   # #     # #
 # # ### ######### ##### # ##### ### # # ### ######### # ######### # # # ##### # ####### ##### ### ############### # # ### # # #
 #   #   #     #   #     #     #   # # # #   # #     # #           # # # #   # #     #   #   #   #       #         # #   # # # #
 ##### # # ### ### # ### ##### # # ### # # ### # ### # # # ######### # # # ### ##### # # # # ### ####### # ####### # ### # # ###
       # # #     # #   # #   # # #   #   #     #   #   # #   #       #   #     #     # # # # # #   # #   # #     # #     # #   #
###### # # ##### ####### # ### ##### ### ######### ######### # ######### ####### ##### ### # # ### # # ### # ### ### ######### #
   #   # #   # #       #     #     #   #     #   #         # #   #       #   # # #     #   # #       #   # #   #   # #   #     #
 # # ####### # ####### ##### ##### ### ##### # ########### # ### # ####### # # # # ##### ### # ######### ##### ### # # # # ### #
 #   #       #       #   #     # # #   #     #   #     # #     # #         # #   #   #   #   #   #     #       # # #   #   #   #
 ##### ####### ##### ### ### # # # # ### ####### # ### # ### ### ########### ######### ### ### ### ############# # ######### # #
 #     # #         #   #     #   #   # #   #   # # # # #     #   #         #   #       # #         #       #     # #         # #
 # ##### # ### ##### # ######### ##### ### # # # # # # ### # # # # ##### ##### # ####### # ######### ### # # ##### ### ### # ###
 # #       #   # #G  #       #   #       # # #   #   #     # # #       #     #   #   #     #       # # # # # #   #   # #   #   #
## # ######### # # # ####### # ####### ### # ############### # ####### ##### ##### # ### ### ##### # # # ### ### ### # # # ### #
   # #       #   # # #     # #       # #   #     #   #       #   #     #         # #   # #   # #   #   #     #   #   # # # #   #
 ### # ##### ##### # # ### # ####### # # ####### # ### ### ##### ####### ### ##### ### # # ### # ##### ####### ### ### # ### ###
 #   # #   #     # # #   #             #         #   # #   #   # #     #   # #   # #   # #   #   #   # #       #   #   #   # # #
 # ### ### ##### # ##### ############# ### ##### ### # # ### # # # ### # # # # # # ##### ### ##### # # # # ##### ### ##### # # #
 # #   #         # #   #   #   #         # #           #     # # # #   # # #   # #   #       #     #     # #     # #   #   #   #
 ### ### ##### ### # # ### # # # ####### # # ################# # ### ### # ### # ### ####### # ############# ##### ### # #######
   #   # #   #     # # #   # # # #     #   # #   #           # #   #   # #   # #   #       #   #       #   #     #     # #     #
## ### ### # ##### # # # ### # # ##### ### # # # # ######### ##### ### ##### ##### ####### # ### ####### # ##### ##### # ##### #
 # #   #   #     # # # # #   # #     #     #   # #     #   #       # #   #   #     #   # # #     #   #   # #   #   #   #       #
 # # ### ####### ### # # # ### ##### ### ####### ##### # # # ####### ### # ### ### ### # # ### ### # # ##### # ### ### #########
   # #   #     #   # # #   #       #   #   # #   #     # # # #     #     # #   #         #   # #   #   #   # #   # #   #   #   #
#### # ####### ### # ####### # # ##### ### # # ### # ### # # # ### # ##### # ##### ######### # # ####### # # # ### # ### # ### #
 #   # #     #   # # #       # #     #   # # #   # # #   # # # # # #     # # #       #     #   # #   #   #   #     #     # #   #
 # # # # ### # # # # # ####### ######### # # ### # # # ### ### # # ##### # # # ####### ### ### # # # # ############# ##### # ###
 # # # # # # # # # # # # #   #     #   # #   #   # # # # #     # # #   # # # # #       # #         # # #                 # #   #
 # ### # # # # ### # # # # # ##### # # # # ### ### ### # ####### # # # # # # ### ####### ######### ### # # ####### # ### # ### #
   #   # # # #   #   # #   #       # #   # #   # #   #   #       #   # #   #   # #     #     #   # #   # # #     # # #   #     #
#### ### # # ### ##### ######### ### # ##### ### ### ####### ######### ####### # ##### # ### # # # # ### # # ### # # ###########
     #   # #   #     # #       # #   # #     #     #         #       #   #     #   # #   #   # #   # # # # # # #   #     #     #
 ##### ### ### # ### # # # ### # # ##### ##### ##### ######### ##### ### ######### # # ####### ### # # # # # # ### ##### ### ###
 #   # #     #   # #   # #   #   #   #   #   #     #   #   #       # # #           # # #     #   # # #   # # #     #   #   #   #
 # # # # ### ##### ##### ### ####### # ##### ##### ### # # # ####### # ############# # # ### ### # # ####### # # ##### ### ### #
   #   # # #             # #   #   # # #     # #     #   #   #     # # #               #   #     # # #   #   # #         #   # #
######## # # ### # # ##### ##### # # # # ##### # ############# ### # # # ################# ####### # # # # ### ############# # #
     #   #   #   # #       # #   #   #   #     #   #           #   #         #   #       # #   #   # # # #   # #     # #   # # #
 ### # ##### # ############# # ########### ####### # ########### ######### # # ### ##### ### # # ### # # ### # # ### # # # # # #
 #   # #     # #       #     #   #       #       # # #         #         # #   #   #   # #   #   #   # #   # #     # # # # # # #
 # ### ### ### # ##### # ####### # ### ### ##### # # # ####### ######### # ##### ### ### # ####### ### ### # ### # # # # ### # #
 #     #   #   # #   # #     # #   # #   # #   #   #   #     # #   #     #     # # #     #   #   # #   # # #   # # #   #     # #
 ####### ### ### # # # ##### # ##### ### # # ########### ### # # # # ########### # ####### ### # # # ### # ### # # ########### #
 #   #     #       # #   #   #     # # #   #       #     # # #   # #   #         #   #         #   # #   # #   # # #       #   #
 ### # ### ############# # ####### # # ##### ##### # ##### # ##### ### # ######### ### # ########### ### # # ### # # # ##### # #
     #   #     #   #   # # #     #   # #   # #   #   #   #   #     #               #   # #         #   # #   #   #   #     # # #
############ # # # # # # # # # # ### # # # # # # ##### ####### ####### ####### ### # ### # ####### # # # ##### # ####### # ### #
       #     # # #   #   # # # # #       # # # #             # #     # #     #   # # #   # #     # # # #       # #     # #   # #
 ##### # ##### # ######### ### # # # ##### # # ############# # ##### # # ### # # # # # ### # ##### ### ##### ##### ### # ### # #
   #   #   # # # #   #   #     #   # #   # # #   #       #   #       #   #   # # #   #           #   #     #       #   #   #   #
## ####### # # # # # # ### ######### # # # # ### # ##### ############# ### ### # ### ######### # ### ##### ####### ##### #######
   #     # #   # # # #     #       #   # # # #     #   # #           #   # #   #   #     #   # # # #     #       # #   #       #
 ### ### # ### # ### ####### ##### # ### ### ### ##### # # ######### ### # # ##### ####### # # # # ##### ####### ### # # ### ###
   # #   #   # #   #   #     # #   #   #   # #   #   #   # #       # #   # #     #     #   # # # # #   #   #   #     # #   #   #
## # ### ### # ### ### # ##### # ##### ### # # # # # ##### ### # ### # ### ######### # # ### ### # # ##### # # ####### # ##### #
   #   #     # # #   #   #   #   #   # #   #   # # # #   #   # # #   # # #     #   # #   # #   # # #   #   # #   #     #     # #
 ##### ####### # # ####### ### ##### # # ####### # # # # ### # # # ### # ##### # # # ##### ### # # ### # ####### ######### ### #
   #   #         #       #     #       #     #   # # # #   # # # # #     #   # # # #     #   # #       # #     #   #     # #   #
## # ### ### ######### # # ##### ######### # # ### # # ### # ### # # ##### # ### # ### # # # # ######### # ### ### # ### ### # #
 # # #     # #     # # # # # #     #     # #   #   # #   # #   #   # #     # #   #   # #   # #   #     #   #     # #   #   # # #
 # # ##### # # # # # # ### # # ### # ### # ##### ####### # ### # ### # ####### ##### ##### ##### # ### ##### ##### ####### # # #
 #   #   # #   # # # #     # # # # # # # #   #   #       # #   # #   #       #     #     # #   #   # # #   #       # #   # # # #
 ##### # # ##### # # ####### # # # # # # ##### ### ####### # ### # # ####### ##### ##### ### # ##### # # ########### # # # # # #
 #   # #       # #   # #       # #   # #         # #   #   #   #   #   # #     #   #   #   # #     #   #             # # # # # #
 # # # ######### # ### # ####### ##### ########### # # ### ### ####### # # ##### ##### ### # ##### ##### ########### # # # # # #
 # # # #       # #       #     #       #   #       # #   #   #   #   #     #   # #   #   # #     #     # #         #   #   # # #
 # # # # ##### # # # # ### ### # # # # ### # ####### ### ### ##### # ##### # # # # # # # # ##### ##### # # ####### # ####### # #
   #   # #   #   # # #       # # # # #     # #     # #   # #       #       # # #   #   # # #   #   #   # # #       # #     # # #
######## ### ####### ### # # # # # ####### # # ### ### ### ############### # ########### # ### ### # ##### ### ##### # # # # # #
   #     #       #   #   # # # # #       # #   # # #   #       # #                 #     #       # #     #   # #   # # # # # # #
 # # ##### ##### # ### ### # ### ##### # # ##### # # ### ##### # # ############# ### ########### # ##### ### # # # # # # # # ###
 #   # #   #   #   #   # # #     #   # # #     # #   # #   #   # # #   #   #   #     #     #   # #     # #   # # # # # # # #   #
 ##### # ##### ####### # # ####### # ### # ### # ##### ##### ### # # ### # # # ### ### # ### # ####### # # ### # # # ### # ### #
   # #   #             #       #   #   # #   # #     #         # #   #   # # #   #     # #   # #     # # # # # # #       #     #
## # ##### # # ############### # ##### # ### ####### # ####### # ##### ##### ### # ##### # ##### ### # # # # # ############### #
 # #   #   # # #               #     #   #   #       #       # # #   #       # # # #   # # #     # #   #   # #     #     #     #
 # ### ##### # ##### # ############# ##### ### ####### ##### # # # # ######### # ### # # # # ##### ######### ##### ##### # ### #
   # #       # #     # #   #         #         #     #   # # #   # #           #   # #     # #   #   #   #   #   #     #   #   #
#### ####### # # ##### # # # ############# ##### # ##### # # ##### ######### # ### ##### ### ### # # # # # ### # ##### ##### # #
     #       # # #   # # # #   #       #         # #   # # #     #   # #   # #   #   #   #   #   # # # # # #   #     #     # # #
 ### ####### # ### # ### # ### # ##### # ### # ### # # # # ##### ### # # ### ### ### # # # ### ### # # # # # ############# # # #
   #   #     #     #   # #     #     # # #   # #   # #   #   # #         #   # # #   # # # #   # # # # #         #         # # #
## ### # ### ######### ############# # # ##### ### # ##### # # ##### ##### ### # # ### # # # ### # ### ### # ### # ########### #
 #   #   #   # #     #   #           # #     #   # # #   # # # #   #     # #     # #   # #   #   # #   # # # #   # # #   #     #
 # # ##### # # # ### ### ### ######### ##### ### # # # # ### # # # ##### # ####### # ### ##### # # # ### # # # ### # # # ### # #
 # # #   # # # # # #     #   #       # #   #   # # #   #   #   # # #   # #     #   # #   #     #   # # #   # #   # # # # #   # #
 ### # ### # # # # ####### ### ##### # # # ### # ######### ### # ### # ####### # ### # ### ######### # ### # ### # # # # # ### #
     #     #   #   #       #       #     #     #               #     #         #     #               #     #   #   #   #   #   #
