################################################################################################################################
# #     #   #   #   #     #       # #         #                   #                     #   #   #   #     # #     #           # 
# # ### # ### # # # # ### ### ### # # ######### ####### # ####### ### # # ##### ####### # # # # # # # ### # # ### # ##### # # # 
# # #   #   # #   # # #   #   # #   #   #     # #       # #     #     # # #   # # #     # # # #   # # #   #   # #   #   # # #   
# # ####### # ##### # # ### ### ### ### # ### # ##### ### ##### ####### # # ### # # ##### # # ##### # # ##### # ##### ### # ####
# #   #     # #   # # #     #   #   # # # #   #     #   #     #         # #   # #         # #   #     # #   #         #   # #   
# ### # ##### # # # ######### # # ### # # ######### ### ##### ##### # ### ### # ########### # # ####### # # ##### ##### ##### # 
#     # #     # # # #   #     # # #   # #   #   #   #   #   #     # #   #   # #           # # #   #   #   # #     #   # #   # # 
# # ### # ####### # # # ####### # # # # ### # # # ### # # # ##### ######### # ########### # ##### ### ##### # ### # # ### # ### 
# #   #   #   #   # # #       #   # # #   #   #   #   #   #     # #       #   #       #   #   # #   # #     #   # # # #   #   # 
# ### # ### # # ### ######### # ##### ### ######### ### ##### # # # ##### ########### # ##### # ### # ### ### # ### # # ##### # 
# # #   #   # # # #     #     #         #   # #     #       # # #   # #   #     #     #   #   #   # #   # #   # #   #   #   #   
# # ######### # # ##### # ############# ### # # # ### # ##### # ##### # ### ### # # ####### ##### # ### # ### ### ####### # ####
#   # #   #   # #   # #   #   #     #   #   # # # #   # #   # # #   #   #   #   # # #     # #     #     #   #     #     # #     
# ### # # # ### # # # ##### ### ### # ### ### # # ##### # # # # ### ####### # ##### # ### # ### ########### # ##### ##### ##### 
#   #   # # # #   #   #   #     # # # #   # #   # #     # #   #   #   # #   #   #   # #   #   # #           # #     #     #   # 
# # ##### # # ####### # ######### # # # ### ### # # ##### ####### ### # # ##### # ### # ##### # # ######### # # ##### ##### ### 
# #       #   #       # #         # #   #       # # #   # #       #   #   #   # # #   # #   # # #   #     #   #             #   
# ######### ### ####### # ### ##### # ####### ### # # # # # ####### ####### # # # # ### # # # # # ### ### ### # ############# # 
#   #   #               #   #   #   #       # # # # # # # #     #   #     # # # # # #   # #   #   #   # #   #       #         # 
# # ### # ########### ##### ### # ######### # # # # # # # ##### # ### # # ### # # # ##### ##### ### ### ### ####### # ##########
# #     #   #     #   #     # #   #     #   #   # # # # # #     # #   # #   # # # # #   #         # #     #     #   #   #       
# ######### # ### ##### ##### ##### ### # ##### # ### ### # ##### ##### ### # # # # # # ##### ##### # # # ##### # ##### # ##### 
#     #   # # # #       #     #     #   #     # #   #     # #   #       #   # # # #   # #     #     # # #   #   #   # #   #   # 
# ### ### # # # ############# # ############# # ### ####### # # ######### ### # # ##### # ### # ##### # ##### ##### # ##### # # 
#   #     #   #         #   # # #         #   #   # #         # #     #   #   #     #   #   # #     # #     # #   # # # #   # # 
# # ####### ### ### ### # # # # ### ##### # ### # # # ##### ### # # ### ##### # ##### ####### ##### # ##### # # # # # # # ### # 
# #               #   # #G# #   #   #   # # #   # # # # #     #   #     #   #       #   #   #   #   # # #   #   # #     #   # # 
# ### ##### ##### # # ### # ### # ##### # # ####### # # # ### ####### ### # ### ### ### # # ### # ### # # ####### ######### # # 
#   # #     #     # #     #   #   #     # #         #   # # #   #   #   # #   #   #   #   # #   # #     #     # #   #       # # 
# ### # ########### ######### ##### ##### ########### ### # ### # # ### ##### ### ######### # ### # ####### # # ### # ####### ##
# #   # #   #   # #     #   # #   # # #   #             # #     # #   # #     # #         # #       #   #   #   #   # #     #   
### ### # # # # # # ### # ### # # # # # ### ########### # ##### # ### # # ##### ######### # ####### # # ######### ### ##### ### 
#   #   # #   # # #   # #     # # #   # #   #           # #     # # # #       #         # #   #   # # #         #     #   #   # 
# # ##### ##### # # # # ####### # ### # # ### ######### # ### # # # # ### # ### # ### ### ### # # # # ######### ####### # ### # 
# # #   # #     #   # # #   #   #   #   #   #         # #   # # # #     # #     # #   #   # #   #       # #     #   #   # #   # 
# ### # # # ######### # ### ####### # ####### ####### # ### ### # ##### # ####### ##### ### ########### # # ##### # # ### # ### 
# #   #   #     #     #     #       # #     # #   #   #   # #   # #   # #       #       #       #       #   #     #   #   #   # 
# # ######### # # ### ####### ####### ### # ### # # ####### # ### # ### # # ### ######### ####### ##### ##### ######### ##### # 
#   #   #   # # #   #   #     #     #     #     # #   #   # #   # # #   # #   #   #       #       #     #     #   #   #     # # 
##### # # # ### ##### # # ######### ############# # ### # # ### # # # ####### # # ####### # ####### ##### ####### # ####### # # 
#   # #   #   #   #   #   #   #   #   #     #     # #   #   #   #   #     # # # #         # #     # #   #       # # #       #   
# # # ####### ### # ### ##### # # # # # ### # ####### ####### # ######### # # # ########### # ### # ### ####### # # # ######### 
# # # #     #   # # #   #   #   # # #   #   # #     #     #   # #         #   #     #   # #   #   # #   #     # #   #   #     # 
# # # # ### ### # # # # # # ##### ### ### ### ##### # ### # ##### ############# ##### # # ##### ### # # # ##### ### ### ##### # 
# # # # # #   #   # # # # #   # #   # # #     #   # #   # #   #   #         #   #   # #     # #   #   #   #     # #   #       # 
# # # # # ### ##### # # ##### # ### # # ####### # # ##### # ### ### ####### # # # # ####### # ########### # ##### ### ##########
# # # #   #   #     # # #     #   # # #       # #   #   # # #   #   #   #   # #   #           #   #   #   #     #   # #   #     
# # # ##### ##### ### # # ##### ### # ### ### # ##### # # ### ### # ### # ############# ####### # # # # ####### ### # # # # ### 
# # # #   #       #   #   #         #   # # # # # #   # # #   #   #   # #     #   #   # #       # # # #                 # #   # 
# # # ### ########### ##### # # ####### # # # # # # ### ### ####### # # ##### # # # # ### ####### # # ############# ######### # 
# # # #   #       #     #   # #       # #   # # #   # #     #     # # #   #   # #   #   # #       # #     #   #     #         # 
# ### # ### ##### # # # # ### # # ### # ### # # ### # ####### ### # # # ### ### ####### # # ############# # # # ##### ######### 
# #   # #   #   # # # #   #   # #   # #   # # #   #   #   # # # # # # #   # #   #     #   # #   # #   #   # #   #     #     #   
# # ### # ### # # # ### ### ### # ### ### # ##### ### # # # # # # ### # # # # ##### # ##### # # # # # # ##### ### ##### ### # # 
# # #     #   # # #   # #   #   #   #   # #     #   #   # # #   #     # # # #       #   #   # # #   #         #   #       # # # 
# # # ##### ### # ### # # ######### ### # # ### ### ##### # ########### ### ########### # ##### # ####### ##### ### ##### ### # 
# # #     # # # # #   # # #       #   #   # # # # # #   # # #   #   #       #     #   # # #     #       # #     #   # #   #   # 
# # ##### # # # # # ### # # ##### # # ##### # # # # # # # # # ### ### ####### ### # # # # # ##### ##### ### ##### ### # ### ####
# #     #   # # # # #   #   # #   # # #       #   # # # # #           #         #   #   #   #     #   #   # #   #   # #   # #   
# ##### ##### # # # ### ##### # ##### # ### ####### # # # ####### ##### ##### # ####### ######### # # ### # # ### # # # # # # # 
# #     # #   # # #   #       #     #   # #         # # #       #     # #   # #   #   #           # #   #   #     # # # # #   # 
# # ##### # # # ##### ####### ##### # ### ####### ### # ####### ##### # # # # ### # # ##### ####### ### # ### ##### # ### ##### 
# # #       #   #   # # #       #   #     #     #     # #     #   #   # # # #   # # #     #       #   # #     #     # #       # 
# # # ########### # # # # ### # # ### ##### ### ##### # # # # ### # ### # # ### ### ##### ########### # ### ### ##### # ### ### 
#   #   #   #   # #   #   #   # # # # #     # #     # #   # # #   # #     #   #   # # #   #     #     # # #   # #   #   #   #   
####### # ### # # ######### # ### # # # ##### ##### ##### # ### ### # ########### # # # ### ### # ##### # # # # # # ### ##### ##
# #     # #   # # #   #     # #   # # # #   #     #     # #                   #   #   #   # #   #   # # # # # # # #     #     # 
# # ##### # ### # # # ######### ### # # ### # ### ##### # ####### ### ####### ### ### ### # # ##### # # # ### # ####### # ### # 
# # #   #   #   # # #       #   # # # #   # # #       # #   #   #   # #     #   #   #   #   #     # # # #     #   #     #   # # 
# # # # ##### ### # ####### # ### # # ### # ### ##### # ##### # # # # # ### ### ####### ######### # # # ######### # ### ### ### 
# #   #       #   #   #   #   #   #     # #   # #   # # #   # # # # # #   # # #       #         # # #   #   #     #   #   #     
# ##### ####### ##### # # ##### ##### # # ### ### # # # # # # # ### ####### # ####### ######### # ### ### ### ######### # ######
# #     #     #     #   # #   #   #   # # #       #   #   # # #   #         # #   # #     #     #   # #   #   #     #   #       
# # ##### ### ##### # ### ### ### # ### # # ### ########### ##### ########### # # # ##### # ####### # ### # # # ### # ### # ####
#       # # #     # #   #   #   #   #   # #   # # #       #       #           # #   #   #   #   # # #   # # # #   # # #   # #   
##### ### # ##### # # ##### # # ### # ### # # # # # ### # ######### # # ##### # ##### ######### # # ### # # ### ### # ####### # 
#   # #   #   #   # #     # # # #   #   # # # #   # #   #   #       # #     # # #         # #   # #   # # #     #   #   #   # # 
# # # # ##### # ### # ##### # ### ####### # # ### # # ##### # ####### ####### # ### ##### # # ### ### # # ####### ##### # # # # 
# #   # #           # # #   #     #       # #   # # #     # # #     #       # #     #   #   #     # #   #   #   #     #   # # # 
##### # # ########### # # ######### ####### ### ### ##### ### # ##### ##### # ##### # # ######### # ####### # ####### ### # ### 
#   # # # #     #       #           #       # #     #   #   # # #   #     # #       # #     #     #   #   #   #     #   # #     
# # # # ### ### # ##### ############# ####### ####### # ### # # # # ##### # # ####### ##### # ####### # # # ### ####### # ######
# # # #   #   # # #   # #   #   #   #   #   # #   #   #   #   #   #     # # #       # #   # # #     #   #       #       # #     
# # # ### # ### # # # ### # ### # ##### # # # # ### ################### ### # # # # # ### # # # ### ##### ####### ####### # ### 
# #   # #   #   # # # #   #   # #     # # #           #   #         #     # # # # # #     # # # # #   #   #       #   #     #   
# ### # ##### ##### # # ##### # ##### # # ### ######### # # ####### ##### # ### ### # ##### # # # ### # ### ####### # ####### # 
# #     #   #       #   #     #     # # #   # #     #   #   #   #   #   #   #   #   # #     # #   #   # # # #   #   # #     # # 
# ##### ### ############# ######### # # ### # # ### # ####### # # ### # ##### ### ### # ##### # ##### # # # ### # ### # ### # # 
#   #           #   # #   #     # # # # #   # #   # # #       # #     #   #   #   #   #       #   #   #   #     # # #   # #   # 
# # ########### # # # # ### ### # # # # ##### ### # # # ################# # # ##### ########### ### # # ######### # ##### ##### 
# #     #       # # # # #   # # #   # # #     # # #   #   #         #     # #     # #       #   #   #   #   #     # #   # #     
####### # ####### # # # ##### # # ### # # ### # # ####### # ####### # ########### # ### ### ##### ##### # ### # # # # # # ### # 
#     # #         # # #   #   # # #   # #   #   #   #   # #       # # #       #   #   #   #     #   #   #     # # #   # #   # # 
# ### # ########### # ### # # # # # ### ##### ##### # # # ####### # # # ##### ####### ### ##### ### # # ##### # # ##### ### ### 
# #   # #   #     # #   # # #   # #   #       #     # #   #       # # # #   #     # #     #   #   # # #       # #     #   #   # 
# # ### ### # ##### # # # ##### # ### ####### # ##### ##### ####### ### ### ##### # ####### ##### ### # # ##### ##### # ##### # 
# #   #     #       # # #     #   #   #     # #       #     #       #   #   #     #     #   #         # #     #   #   #     # # 
# ### ####### ######### ##### # ### ####### # ##### ### ##### ####### ### ### ##### ### # ### ######### ##### ### # ### ##### # 
#   # #     #               # #   # #           #   #   #   # #       # #   # #     #   #     #     #   #     #   # #     #   # 
##### # ########### ######### # # # # ### ##### # ### ##### # # ####### # # # # ##### # ##### # ### # ### ##### ### ### ### ### 
#   # # #     #     #         # #   # #   #   # #   #       #   #       # # #   #     #       #   # # #   #     # #   #     #   
# # # # # # ### ##### ######### ##### ##### # # ### ############# ####### ##### # ##### # ####### # ### ### ##### ### # ##### # 
# #   # # #       #   # #     #       #     # # #   #                           #   #   #   #     #   #   #     #   # #       # 
# ##### # ######### ### # ####### ##### ##### # # ### # # ####### ############# ### ####### # ####### ##### ### # # # ######### 
# #     #       #   #   #       # #     #   #         # #   #   # #       #   #   # #       #       #     # #   # # #       #   
# # ########### # ### ######### # # ##### # # ############# # # ### ##### # # # # # # ##### ####### ##### ### ##### ####### ####
#         #     #   # #       #   # #   # # # #   #         # #     #   #   # # # # # #   #   #   #   # #     #   #       #     
# ####### # ####### # # # ### ### # # # # # # # # # ######### ####### # ##### # # # # # # ##### # ### # ####### # ### ### ##### 
#       #   #     # #   #   #     # # #   # # # #   #   #     #       #     # # # # # # #   #   #   # # # #   # # #   #   #   # 
# ##### ##### ### # ### ### ##### # # ##### # # ####### # ##### ########### # # # # # ##### # ##### # # # # ### # # ### ### ### 
# #   # #     # # # # #   #   #   # # #   # # #   #     #     #   #             # # #   #   # #   # #S  # #   # # # #   # # #   
# # # # # ##### # # # # ##### ### # # # ### # ### # ######### ### # ### ########### ### # ### # ### ##### ### # # # # ### # # ##
# # # # # #   # #   #   #     #   #   # #   #   # # #       # #   # #   #           #   #     # #   #       #   #   # #   #   # 
# # # # # ### # ######### ##### ####### # ##### # # # ####### ##### ##### ########### ######### # ### # ### ######### ### ##### 
# # # # #     # # #     #     # #       #     # # # # #     #   #   #     # #   #   #             #   # #     #       #   #     
# # # ######### # # ### # ### # # ### ####### # # # # # ### ### # ### ##### # # # # ############### ##### ### # ####### # ##### 
#   # #         # #   # #   # #     #       # # #   # #   #   # #   #   # # # #   #               # #   # #   #     # # #     # 
# ##### # ### ### ### # ### # ########### ### # ##### ### ### # ####### # # # ##### ######### ### ### # ### ####### # # ##### # 
#   #   #   # #   #   # #   #   # #   #   #   #     #   #   #   #     # #   #     #   #     #   #   # #   #   #   # #   #   # # 
### # ##### # # ### ### ####### # # # # # # ####### ### ### ### # ##### # ####### ### # ### ### ### ##### ### # # # ####### # # 
#   #   #   #     # #   #       #   #   # #     #     # #   #   #       #       # #   # # #   #   #       #   # #   #       #   
# ##### # ######### # ### ############### ##### # ### # # ############### ### ### # ### # ### # ########### ### ####### ####### 
#     # #           # #   #     # #     #     # #   # # #       #       # # # #   # #       # #                 #       #   #   
##### # ############# # ### ### # # ##### # # # # # ### ####### # # ### # # # # ### # ####### ######### ### # ### ####### # # ##
# #   #       #   #   #   # #   # # #   # # # # # #     #   # #   #   #     #   #   # #     # #   #   # # # #           # # # # 
# # ######### # # ####### # ##### # # # ### # # ######### # # ####### ############### # ### # # ### # # # # # ### ####### # # # 
#               #         #           #     # #           #         #                 #   #   #     #   #   #   #         #     
