################################################################################################################################
   #   #     #       #     #   #   #   #       #     # #   #                     # #     #     #   #   #         #             #
## # # # ### # # ### # ##### # # # # ### ##### ##### # # ### ####### # ######### # # ### # ### # # ### # ####### # ####### ### #
   # # # # #   # #   # #   # # # # # #   #   # #   # # #     #       # #     # # # # # #   # # # #     # # #     #     # # #   #
 ### # # # ### # # ### # # # # # # # # ### # # # # # # ### ### # ##### # # # # # # # # ##### # # ####### # # ######### # # #####
     #   #   # # #   #   # # #   #   #   # # #   # # #     #   # #   # # # #     # #   #   #   #       #   # #       #   #     #
########## ### # ### ##### # ########### # ####### # # ### # ##### # # # # ##### # ### ### ########### ##### # # ####### ##### #
     #   #     #   #       #             #       # # # #   #     # #   # # #   #     # #   #       #   #   # # # #     #     # #
#### # ##### ##### ####### ############### ##### # # # ######### # ####### # # # ### # # # # ##### # ### ### # # # ### ##### # #
     #       #   # #     #             # #   #   # # # #         #       # # # #   # #   #   #   # # # #   # # #   #   #     # #
 ### ### # # # # # # ######### ##### # # ### ##### # # # ############### ### # # # ############# # # # ### # # ##### ### ##### #
   #     # # # #   #       #   #   # # #   #   # # #   #         #     #   # # # # #     #       # #         #   # #   # #   # #
 # ##### # # # ##### ##### # ### # # # ### ### # # ##### ######### ### ### # # # # # ##### # ##### ######### ### # ##### # # # #
 #   #   # # #     # #   #   #   # # #       # # #     # #       # # #   # # # # # #   #   #       #       # #       #     # # #
 ### # ### ####### ### # ### # ### ######### # # ##### ### ##### # # ### ### # # ##### # ########### ##### # # ####### ####### #
 #   #   # #     #   # #   # #   # #       #         #   # #   #   # # #   # #   #     #     #         # # #   #       #   #   #
## ##### # # # ##### # ### ##### # # ##### # # # ### ### # # # ##### # ### # ### # ######### # ####### # # # ### ######### # ###
   #   # #   # #     #   #       #   #   #   # # #     #   # #     #     #   # # # #       # #   #   # # # # #   #       # # # #
 ### # # ##### # ####### ############### ####### ##### ##### ##### ##### ##### # # # ##### # ##### # # # # # # ### ##### # # # #
 #   # #   #   #       #   #             #     # #         #   # #     #   #   # #   #     # #   # #   # # # #   #   # #   # # #
 # ### ### # # ##### # ### # ############# ### # # ####### ### # ######### # ### ##### ##### # # # ##### # # ### ### # ##### # #
 #   #   # # #     # #   #   #       #   #   # # # #       #   #   #   # # # #     # #   # # # # #     # #     #   # #     # # #
 ### ### # # ### # # ### ##### # # # # # ### # ### # ####### ### # # # # # # # # # # ### # # # # ##### # ##### ### # # ### # # #
     #   # #   # # # #     #   # # #   # #   #     # #     #   # #   #   # #   # #     #   #   #       #         # #   # #   # #
#### # ### ### # # # # ##### ### # ##### # ### ##### ##### ### # ##### ### ### # ##### ### ####### ############# # ##### ##### #
   # #   #   # # # # # #     #   # #   # #   # #   #       #   #     # #   #   #   # # #           #           # #   #         #
 # ##### # ### # ### # # ##### ##### # # ### # # # # ####### ####### # # ### # ### # # # ##### # ### ######### # ### ######### #
 # #     # #   #   # # #     #   #   # #   # # # # # #     # #     # # #   # #   # #   # #     # #   #     #   #   #     #     #
 # # ####### ##### # # ### ####### ### ##### ### ### # ### # # ### # # ### ##### # # ### # ##### # ### ### ##### ####### ##### #
 #   #       #     # #     #     #   #     #   #   # # # #   # #   # #   #     # # #     #   #   # #   # #     # #       #     #
 ##### ####### ### # # ##### ### ### ##### ### ### # # # ##### # ### ### ##### # # ##### ##### # # ### # ##### # # ####### ### #
 #   # #       #   # #     # #   #   #   #   #     # #         # #     #         # #     # #   # #     #     # # #       #   # #
 ### # ### ##### # # ### ### # ### ### ############# ########### ### # # # ####### # ### # # ############### # # ####### ### # #
     # #   #     # #   # #   #     #   #                 #   # #   # # # # #       #   #   #               # #         # #   # #
 ##### # ### ####### # # # ######### # # ############### # # # ### ### # # # ### ####### ############### # # ######### # ##### #
 #   # #   #   #   # # # # #     #   # # #   #   #     #   #   # #   # # # # # # #     #       #       # #   #       #   #   # #
 # ### ### ##### # ### # # # # ### ### # # ### # ##### ####### # ### # # # # # # # ### ##### # # ##### # # ### ##### ### # # # #
   #   # #   #   #     # # # #     #   # #     #             # #   #   # # # #   #   # #S  # #       # # #   #   # #   # # #   #
 ### ### ### # ########### # ####### ### ##### ############# # # # ### # ### ### ### # # # ######### # # ####### # ### # # ### #
   # # #     #   #         # #   #   #   #   # #         #   # # #     # #   #   # # #   #         # # #       # # #   #   #   #
 ### # ##### ### # ######### # # ##### ### # ### ####### # # # # ####### # ### ### # ############# ### ######### # # ####### # #
 #   #         #   #   #       # #   #   # #   # # #     # #     #       # #   #   #       #     # #   # #       #   #     # # #
 # ### ### # ####### ### ######### # ### # ### # # # ##### ####### ### ### # # # ######### # ### # # ### # ####### ### ### # # #
 # #   #   #         #   #     #   # # # #   #   # #     #   #   # #   #   # #   #   #     # # #   # #   #       #   #   #   # #
 # ##### ##### ####### ### ##### ### # # ### ##### ##### # ### # # ### # ######### # # ##### # ##### # ######### ### ######### #
 #   # #     #         #   #     #   #   #   # #       # # #   # # #   #       #   # # #     #       #   #     #   #     #   # #
#### # # # # ########### # # ##### ####### ### # # ##### # # ### # # ######### # ### # # ######### # ### ### ########### ### # #
     # # # #   #       # # # # #         # #   # #       # #   # # #     #   #   # # # #         # #   #     #     #   #   #   #
 ##### # # ##### # ### ### # # # ####### # # # # ########### # # # # ### # # ##### # # ######### # # # ##### # ### ### ### # ###
   #   # #       #   #     # #   #   #     # # #   #       # # # # #   # # #     #   # #     #   # # #     # # #     # #   #   #
## # ### ########### # ##### ##### # ####### ##### # ##### ### # # # ### # ##### ##### ### ### ### ####### # # ##### # # ##### #
   #   #       #     #     # #     #       # #   #   #   #     # # #   # # #   # #   #     #   # #     #   # #   # # #   #     #
 ##### ######### ### ####### # ########### # # ####### ######### # ### # # # # # # ####### # ### # ### ##### ### # # # ####### #
 #       #   #   #   #     #   #     #   # #         #         # #   # #   # #   #     #   #   # #   #       #   #   #   #     #
 ####### # # # ####### ### ##### # ### # # ######### # ### ### # ### # ##### ######### # ##### # # # ######### ### ##### # ### #
   #   #   #   #   #   #   #   # # #   # #     # #   #   #   # #     # #   #           # #   # #   #   #     #   # #   # # # # #
 # # # ######### # # ### ### # # # # ######### # # ##### ### ######### # # ####### ##### ### # ######### ### ##### # # # # # # #
 # # # #   #     #   # #     # # # #           # #     # #   #   #     # #       #     #   # # #       #   # #       #   #   # #
 # # # # # # ######### ####### # # ############# ##### # # ### # ### ### ####### ### # ### # # # ##### ### # # ### ########### #
 #   #   # # #         #     #   #   #           #   # # #   # #   #   #       #   # # #   #   # #   #   # #     #           # #
 ######### # # ### ##### ### ####### # ####### # # # # # ### # ### # ######### ### # ### ####### # ##### ##### # ####### # ### #
     #   # # #   #   #   #         # # # #   # #   #   # # # # # # # #     #   #   # #   #       #     #     # #     #   #   # #
 # # ### # # ### ### # ########### # # # # # # # ####### # # # # # # # ### ##### ### # ############### ##### # ##### ##### # # #
 # #     #   #   #   #     #   #   #   # # # # # #         # # # # # #   #       #   # #   #     #     #   # # #   #   #   # # #
 ############### ######### # # # ####### # # # ### ######### # # # ##### # # ######### # # # ### ##### # # # # # # ### ### # # #
 #     #   #     #       #   # #       #   # #   # #       # #   #     # # #     #     # # # # #     #   #   #   #   #   # # # #
 # ### # # ### # # ##### ##### ####### ##### ### # # ##### ########### # # ### # # ####### # # ##### # ############# ### ### # #
   #   # #   # # #   #         #       #   # #   # # #     #   #   #     #   # # # #     # # #       # # #         #   #   #   #
 ### ### ### # # ### ########### ####### # # # ### # ### ### # # # ######### ### # # ### # ### ##### # # # # # ### ### ### # ###
 #   #   # # # # # # #     #     #       # # #     #   #     #   #   #   #   #   # # #   #     #   #     # # #   #       # #   #
 # # # ### # # # # # # ##### ####### ##### # ######### ############# # # # ### # # # ######### # # ##### # # ### ######### #####
 # # #   #   # #   #   #   # #       #   #   #     # #         #   # # #   #   # # #   # #     # # #   #   #   # #   #   # #   #
 # # ##### ####### ##### # # ######### # ### # ### # ######### ### # # ##### # # # ### # # ##### # # # ####### ### # # # # # # #
 # #   #   # #         # #   #   #     #     # #     #   #   #     #   #   # # # #   #       #   # # #       #   # # # #   # # #
 # # ### ### # ####### # ##### # # # ######### ##### # # # # ########### ### # ##### # ####### ### # ####### ### # # # ##### # #
 # # #   #     #       # #     # # # #       #     #   #   #       #   #     #       # #     #   # # #       # # # # #       # #
 # ### ##### ##### ##### ### ### ### # ##### ##################### # ####### ######### # ### ### # ### ####### # ### # ####### #
 #     #     #   #     #     # #         #       #             #   #     #               #   #   #   # #     # #     #   # #   #
 ####### ##### # ### ######### ##### ##### ####### ######### ### ####### # # ### ####### ##### ##### # # ##### ####### # # # ###
 #   #   #     # #   #     #     #   #   #   #             #     #   #   # # #   #     # #     #   #   # # #   # #     #   #   #
 # # ##### ##### # ### # # # ##### ### # ### # ########### ######### # ### ### ### ### ### ##### # ##### # # ### # ########### #
 # # #     #     #     # #   #     # # #   #     #       #     #     #   #   #     # #     #     #     #   # #     #           #
 ### # ##### ##### ##### ##### ##### # ### ####### ##### # ### # ##### ##### ####### ####### ### ##### ### # ####### ###########
   # # #     #   #   # #     # #   # #   #     #   # #   # #   #   #     #   #               #   #   #   # #     #   #     #   #
 # # ### ##### # ### # ##### # # # # ### ##### # ### # ### # ##### # ### # ######### ##### ### # # # ##### ##### # ### ### # # #
 # # #   #     #   # #   # #     #   # #   # # # #   #   # #       # #   # #         #   # #   # # #     #   #   # #     # # # #
 # # # ########### # ### # ##### ##### ### # # # ### ### # ######### # ### # # ####### # ### ### # ##### ### # ### # ### # # # #
 #   #   #         #       #   #         #   # #   #   # #   #       # #   # # # #     #   #   # #   #   #   #G    # # # #   # #
 ####### # ######### ####### # ########### ### ### # ### ### # ####### # ### # # # ####### ##### ### # ### ######### # # ##### #
         #   #   #   #       #       #     #   #   #   #   # # #   #   # # # # # # #     #     #   # #     # #       # # #   # #
 ########### # # # ### ############# # ##### ####### # ### # # # # # ### # # # # # # ######### # ### ####### # ### # # # # # # #
         #   # # #   # #   #     # # # #   #         #   # #   # # #   # #   #   # # #         #     #   #   # #   #   # # #   #
 ### ##### ##### ### # # # # ### # # # # # ######### ##### # ### # ### # ######### # # ######### ##### # # ### # ####### #######
   #       #       # # # # #   #   #   # # # #     #       #   # # #   #   #     # #   #   #   # #     # #   # #       # #     #
 # ########### ##### # # # ### ########### # # ############# # # # # ##### # ### # ##### # # # # ####### ### # ####### ### ### #
 #       #   #       #   #   #   #       #   #     #         # # # # #   #   # # #     # #   # # #       #         # # #   # # #
 ##### # # # # ############# ### # ##### ### ##### # # ##### ### # # ### ##### # ##### ### ##### # ####### ####### # # # ### # #
   #   # # # # #   #       # # # # # #   #       #   #     # #   # #   # #     #       #   #     #   #     #     # # #   # # # #
 # ##### ### # # # # ### ### # # # # # ######### ### ##### # # ### ### # ### ########### ### ####### # ### # ### # # ##### # # #
 #     #     #   # # # # #   #   # # # #             #   # #   # #   # #   #             #   #   # # #   # # #           # #   #
 ##### # ######### # # # # ### ### # # # ##### # ### # # # ##### ### # ### # ### ### ##### ##### # # ### ### # ######### # #####
 #     #   #     #   #   # #   #   # #   #     #   #   # #     #     #     #   #   #       #     # #   # #   # #   #     #     #
## ####### # ### # ####### # # # ### ##### ### ### ####### # # ############# # ### ######### ##### ### ### ### # # # ######### #
   #   #   #   # # #       # # #   #       #     # # #   # # #         #   # #   #         #   #         #   # # # #         # #
 ### # # ####### # # ####### # ### # ### ### ### # # # # ### ##### # ### # # ### ### ### # ### ######### ### # # # ##### ### # #
     # #       # # #   #   # # #   #   #   # #   # # # #   #     # # #   #   #   # #   # #   # #     #   #   # # # #   #   #   #
 ##### ##### # # # ### ### # # # ##### ### # # ### # # ### # ### # # # ####### ### # # ### ### # ### ### # ### # # # # # # #####
     #     # # # # #   #   # # # #   #   # # #   #   # #   #   # # #   #     # #   # #   #   # # # #   #   #   # # # # # # #   #
 ######### # # # # # ### ### # # ### # ### ##### ##### # ####### # ##### ### # # ### ### # # # # # ### ##### ### # # # # # # ###
   #     # # #   #   # # #   # #     #   #     #   #   #       # #     # #   # # #     # # # #   #   #   #   #   #   # # # #   #
## # ### # # ##### ### # # ### ######### ##### ### # ######### # # ##### ##### # ####### # # ##### ##### # ### ####### # # ### #
 # # # # # #         # # # #   #         #     # # #   #     # # # #   #       #         # #   #         # # # #     # # #   # #
 # # # # # # ####### # # # ######### ### # ##### # ### # ### # # ### # ################### ### # ######### # # # ##### # # ### #
   # #     #   #     # # # #   #     # # # #   #   # # #   # # #   # # #                     #   #       #   #   #     # #   # #
## # ######### ####### # # # # # ##### # # ### ### # # ### # # ### ### # ##### ##### # ##### ##### ### # ### # ### ##### ### # #
   #   #     #   #     # #   # #   # #   #   #       #   # # #   #     #     #   #   # #   #     #   # #     # #   #       # # #
###### # ### ### # ##### ##### ### # ### ### ##### ##### # ##### ############### ##### ### ##### ### # # ##### # ########### # #
     # #   #   # # #         # #   #     #   #   #   #   #     # #     #       #     #     #   #     # #     # #   #       #   #
 ### # ### ### # # # ####### # # ##### ### ### # ### # ##### ### # ### # ##### # ### ######### ####### # ##### ### # ##### # ###
   # # #   #   # #   #   #       #     # # #   #   # #     # #   # #   #   #   #   #         #     #   # #       # #     # #   #
## # # # ### ### ##### # # ####### # ### # ####### # ##### # # ### # ####### ##### ### ### # ##### # ##### ####### ##### # #####
   # # # # # #   #   # # # #     # # #   #         #     # # #     # #     #     #   # #   #   #   #     # # #     #     #     #
 ##### # # # # ### # # # # # ### ### # ################### # ####### # ### ##### # # # ####### # ####### # # # ##### ######### #
   #   # # # # #   #   # # #   #   # # #       #         #     #   #   # #     # # # #       # # #     # #   #       #       # #
## # ### # # # # ####### # ### ### # # # ####### ####### ##### # ####### ##### # # ######### # # # ##### ### ######### ##### # #
   # #   #     #   #     #   #   # #     #       #     #     # #     # # #   #   #         # #   # #       #     #   #   # # # #
 ### # # ######### # ########### # ####### ####### # ####### # ##### # # # # ####### ##### # ##### # ########### # # ### # # # #
     # #           #             #                 #       #   #           #         #     #       #             # #     #     #
