################################################################################################################################
     #                 # #   # #         #         #   #     #       #   #     #   #   #     #   #       #       #   #     #   #
 ### # # ##### # # # # # # # # # ##### # # ####### # # # ### # ####### # # # # ### # # # # ### # # # ### ##### # ### ##### # # #
   # # # # #   # # # # #   # # # #     # #   #   # # #   #   # #     # #   # #     # #   # #   # # #   #     # #   #   #   # # #
## # # # # # ##### ### ##### # # # ##### ### # # # # ######### # ### # ##### ####### ##### # ### ##### ##### # ### ### # ### ###
   #   # #   #   #   #           # #       # # #   #           #   #     # # #       #   #   # # #   # # #   # #   # # #       #
 ####### ##### # ### # ########### ### ##### # ##### ########### ####### # # # ####### ####### # # # # # # ##### ### # # ##### #
   #   #     # #   # #   #     # # #   #   # # #   #         #   #     #   # # #   #           #   # #   # #             #   # #
## ### ##### ##### # ##### ### # # # ### # ### # # # ####### # ### ### # ### # ### # ### ### # ##### ##### ### ########### # ###
           #   #     #     #   #   #   # #     # #       #   #   # #   #   # # #   #   # #   # #   # #   #     #   #       #   #
 ############# ####### ##### ######### # ############### # ##### # # ### # # # # ##### # # ##### # # # # ##### # # # ######### #
   #           #       #   #   #       #               # #       # #   # # #   #       # # #   # #   # #   #   # # # #       # #
## # ########### ######### ### ##### # ############### # ######### ### # # ##### ####### # # # # ##### ### # ### # # # ##### # #
   #             #     #     # #   # #       #       #   #         # # # #         # #   #   # # # #     #   #   #   #   #   # #
 ################### # # ##### # # # ##### # # # ##### ### ######### # # ######### # # ####### # # # ######### ######### # ### #
   #         #       # #   #   # #   #   # # # # #   # #   #     # # # #         # #   #     # # #   #   #     #      S  #     #
## # ##### # # ####### ### # ### ##### # ### ### # # # # ### ### # # # ######### # ##### ### # # # ### # # ##### ###############
   # #     # #       #   # # # #   #   #   #     # # # #     # #   # # #         #       # # # # #     #   #   # #   #         #
 ##### ##### ##### # ### # # # ### # ##### ####### # # ####### ### # # # ######### ####### # ### # ######### # # ### # ### # # #
 #     #   #     # # #   # # #     #   # #     #   #       #   #   # # # #     #   #     #   #   #   #   #   # #     # # # # # #
 ### ##### ##### ### # ### # ######### # ##### # ####### # # # # ### # # # ### ### # ### ##### ##### # # ##### ####### # # # ###
     # #   #         #     # #         #       # # #   # #   # # #   # # # #     # # # #     #   # #   # #     #   #   # # #   #
###### # ### ### ######### # # ######### ##### # # # # # ####### # ### # # ##### ### # ##### ### # ##### # ### # # # ### # ### #
 #   #   #   #   #       # # # #   # #   #   #     # # #   #   # #     # #     # #   #   # #   # #     #   #   # #       # # # #
 # # # ### ### # # ##### # ### ### # # # # # ##### # # # ### # # ####### ####### # ##### # ### # ##### ##### ### ######### # # #
   # #     #   # # #   # #   #     # # # # #   #   # # # #   # #     #       #   # #     #   #   #       #   # #     #     #   #
#### ##### ####### # # # ### ####### # ### ### # ### # ### ######### ### ##### ### # ####### ##### ####### ### # ### # ####### #
       #   #   #   # #   #         # # #   # # #   # # #   #       #   #     #   # #   #         #         #       # # #   #   #
 ##### # ### # # ### ############# # # # ### # ### # ### ### # ####### # ### ### # ### ######### # ######### ##### # ### # # # #
 #   # # #   # # # #           #   #   # #   # #   #   # # # #         #   #   #   #             # #     #   #   # #   # # # # #
 ### # # # ### # # ########### # # # ### # # # # # ### # # # ############### # ##### ### ######### ##### # # # # ### # # # # ###
   # #   # # #   #     #     # # #   #   # #   # # # # # # # #   #         # #         #         # #   # # #   #   # #   # #   #
## # ### # # ##### ### # # ### # ##### ### ##### # # # # # # # # ######### # ##### # # ### # # ### # # # # ####### ##### # ### #
 #   #   # #       #   # # #   #     #   # #   # #         # # # #   #     #   #   # #   # # # #   # #           #     # #   # #
 ##### ### # ##### # ##### # ############# # # ### ### ##### # # # # # ####### # ####### # # ### ### ########### ##### ##### # #
 #     #   # #   # #       # #     #       # #   # #   #   #   #   # #         # #     # # #     #   #       # # #   #     # # #
 ### # # ### # # # ####### # ### # # ########### ### # # # ######### ########### # ### # # ####### # # ##### # # # # ### # # ###
     # # #   # # #       # #   # #             #   # # # #         # # #         #   #   #   #     #   #     #   # #   # # #   #
######## # ### # ####### ##### ### ######### # ### ### # ######### # # # ########### ##### ### ### ##### ######### ### ### ### #
     #   #   # #       #   # # #   #       # #   #   #       #   #   #   #     #   # #           # #     #         # #     #   #
 ### # ##### # ##### ##### # # # # # ##### # # ##### # ####### # ######### ##### ### ############# # ##### ### ### # ####### # #
   #   #   #   #   # #   #   # # # #   #   # #   #           # #   # #       #   #   #     #       # #     #   #   #         # #
## ##### # ### # # ### # ##### # # ### # ####### # ######### # ### # # ##### # ### ### ##### ####### ####### # # ############# #
 #   #   #   # # # #   # #   #   # #   #       #   #   #     #   # # #     # #   # # #     #   #     #       # # # #           #
 ### ####### # # ### ### # # ##### # ######### # ### # ##### ##### # ##### # ### # # ##### ### # ### # ######### # # ##### ### #
     #     #   #     #     #     # #     # #   # #   #     # #     # #   # # # #   #     #     # #   # #   #     #   #   # #   #
###### ### ### ################# # ##### # # ##### ####### ### ##### # # # # # ##### ### ####### # ##### # # ##### ### # # # # #
   #   #   #   #         #   # # #     #   #       #     #   # #     # #   # # #   #   #   #   # # #     # # # #   #   #   # # #
## # ####### ### ####### # # # # # ### ##### ########### ### # ##### # ##### # # ##### ##### # ### # ##### # # # ### ######### #
   #     #   #   #       # # #   # #             #     # # # # #   # #     #         # #     # #   #   #   # # # #   #   #     #
 ####### ### # ######### # # ### ### # ##### ### ##### # # # # # # # ##### ####### ### # ##### # ### ### ### # # # ### # # # ###
       #   # #         #   #   #     #     #   # #   #     # #   # #       #   # # #   # #   # # #   #   #   #   #   # #   # # #
 ### ##### # ######### ####### ##### ##### ### ### # ### ### ##### # ####### # # # # ### # # # # # ### ### # ####### ####### # #
   # #   #       # #   #   #   #     #   #   #     #   # #   #     # #     # # #   #     # #   #   #   #   #   #     #     # # #
 # ### # ####### # # ##### # ####### # # ############# # # # # ##### # ### # # ########### ##### ### ##### ### # ##### ### # # #
 # #   #       # # #     # # #     # # # #         #   # # # #     #   #   # # #         #   #     # #       # #       #   #   #
 ### ##### # ### # ##### # # # ### # # # # ####### # ### # # ##### ##### ### # # ##### ##### # ##### # # ##### ##### ### ### ###
   # #     # #   #   #   # # # # # #   # # #   #   # #   # #     # #   # #   # #   # # #     #   #   # # #   #     #   # #     #
## # ######### ##### # ### # # # # ####### # # # ### # # # ##### # # # # # ### ### # # # ####### # ### # # # ##### ##### ### # #
   #   #   #   #   # # #   #   # #         # # #     # # #   #   # # #   #   # #   # # #       # # #   # # #     # #   # #   # #
 ##### # # # ### # # # # ####### ########### # ####### # ### ##### # ######### # ### # ####### # # # # ### # ##### # # # # ### #
     # # #   #   #   # #     #     #         #   #     # # #       #     #     #   #   #   #   # # # #   # # #     # #   #   # #
#### # # ##### ####### ##### # ### # ##### ##### # # ### # ########### ### ######### ##### # ##### # ### # # # # ########### ###
       # #   #   #   #     # # # # #   # # #     # # #   # # #     #   #   #     #   #     # #     #   #   # # # #     #   #   #
 ##### # # # ### # # ### # # # # # ### # # # ##### # # # # # # ##### ### ### ##### ### ### # # ##### # ####### # # ### # # ### #
 #         # #   # #     # # #   #     # # #       # # # #     #       #   #     #     # # # # #     #     #   # # #   # #   # #
## ### ##### ### # # ####### ### ####### # ######### # ##### ### ######### ##### ####### # # # ### ##### ### ### # # ####### # #
   #   #   # #   # # #     # #       # #   #     # # #       #   #         # #   #     #   # # #   #     #   #   # #     # #   #
 ####### # # # # # ### ### # # ##### # ##### ### # # # ####### ### ######### # ### ### # ### # # ### ##### ### ### ##### # ### #
     #   # #   # #     #   # # #   #       #   # #   # #       # #     #     # #   #   # # #   # #     # # #   #   #   # #     #
#### # ### ##### ####### ### ### # ####### ### # # ##### ####### ##### ### # # # ### ### # ##### # # # # # # ### ### ### # #####
     # # #     #       #   #     #   #   # # # # # #     #   #       #   # #   # #   # # #   #   # # # # # #   #   # #   # #   #
#### # # ##### # ##### ### ######### # ### # # # ### ####### # ### ##### # ##### # ### # # # # ### # # # # # ##### # # ##### # #
   # #   #     # #   #   #           #     # # #     #   #   #   # #   # # #     # #   # # # # #   # #   # # #     # # #     # #
 # ####### ##### # ################### ##### # ######### # ####### # # # # # ####### # # ### # ##### ##### # # ##### # # ##### #
 #       #   #         #   #     #   #   #   #     #   # # #   #   # # #   #         # # #   # #     #   # # # #     #   #   # #
 ####### ### # ######### # ##### # ##### # ####### # # # # # # # ### ##### ### ####### # # ### # ### ### # ### # # # ##### ### #
   #   #     #   #     # #   #   #     # #     #   # #       #           #     #   #   # # #   #   # #   #     # # # # #   #   #
## # ########### # ### # ### ### # ##### ##### # ############# ####### ##### ### # # ### # # ##### # # ########### # # # ### # #
   # #   #       #   # #   #   # #   #   #     #       #       #       #   # #   # #   # # # #   # # #     #     # # #   # # # #
 ### # # # ######### # ####### # # ### ### ########### # ####### ##### # ### # ### ### # # # ### # ####### ##### ### # ### # ###
   # # #     #   #   #         #   #   #         #     # #       #   # #     #   #   # # # #     # #     # #     #   #     #   #
## # # ##### # # # ############# ### ### ####### # ####### ####### # # ##### ####### # # # ####### # # ### # ##### ### ####### #
   #   #   #   # #         #   # #       #       #         #   #   # #       #   #   #         #   # #     # #     #   #     # #
 ####### # ### ########### ### # # ####### ################# # # ### ### # ### # # ##### # ### # # # ####### # ##### # # ##### #
 #     # #   #       #     #   # # #     #   #               # # #   #   #   # #   #     #   #   # # #     # # #     #     #   #
 # ### # ### # ### ### ##### ### # # ### ##### ############### # # # ### ### # ##### ####### ####### # ##### # ### ######### ###
 # #   # #   # # #     #   # #     # # #   #   #       #     # # # #       # # #     #     #   #   # #     # #     #       #   #
 # # ### ##### # ######### # ### ### # ### # ### ##### ##### # # # ####### # # # # ### ### ### # # # # ### # ##### # ##### ### #
 # # #   #   # #   #   #   #     #   #     # #   #   #       #   #   #   # # # # # # # # # # # # #   #   # # #     #   # #   # #
 # # # ### # # ### # # # ####### # ######### # ### # ### ### ### ### # # ### # # # # # # # # # # ##### # ### ##### ### # ### # #
   # #     # # #   # # #   #     # #         # #   #     #   #     # # # #   # # # #   # # # #   #   # #   # #   #   # #   #   #
#### ####### # # ##### ### # ##### ### ####### # # ####### # # ##### # # # ### # # # ### # # ##### # # ### # # # # # # ### #####
   #   #                     #   #     #       # # #     # #   #     # # #   # # # #   # #   #   # # # # #   # # # # #   # #   #
 # ### # ####### ########### # # ####### # ##### # # ### # ##### ### # # ### # ### ### # ##### # # # # # ####### ### # ### # # #
 #       #     #   #     #   # #   #     # #   # #   #   #     # #   # # #   #     # # #     # #   # # # #     #   # #   # # # #
 ######### ### # ### ### ##### ### # ### # # # ####### ####### # ##### # # ######### # ##### ##### ### # # ### ### # ### # ### #
     #     #   # #   # #       # #   #   # # # #     # #   #   #     # # #         #   #   #       #   #     # #   #   #   #   #
## ### ##### ### # ### ######### ### # ### ### # ### # # # # ####### # ######### # # ##### ####### # ####### # # ### ####### ###
 # #   #     #   # # #   #     #     #   #   # #   #   # # # #   #   # #         # #   #   #   #         #   #     # #     #   #
 # # ### ######### # # # # ### ##### ### ### # ### ##### # ### # # # # # ### ######### # ### # # ####### ### ##### # # ####### #
 # # #             # # # #   #         #   # #   #   #   #   # # # # # #   # #   #   # # #   #   #     # #   #   #   # #     # #
 # # ############### # ##### ### ####### ### ### ##### ##### # # # ### ### ### # # # # # ### ### # ### # # # # # ##### # ### # #
   #     #           #   #   #   #       #   #   #     #       #   #   # #     #   # # #     # # # #   #   # # #     # #   #   #
 ####### # ######### ### # ##### # # ##### ### ### ####### ####### # ### ########### # ####### # # ### ##### # ##### # ### #####
       # #   #   #     #   #     # # #  G  #   # #       # #     # #   #   #   #     #     #   # #   # #     # #   # #   #     #
###### # ### # # ##### ####### # # ### ##### ### ####### ### ### ##### # ### ### ### ##### # ### ### # ### ### # # ##### ##### #
       #   #   #   # #         # #   #   #   # #     # #     # # #     #   #   # #   #     #   # #   #   #       # #   # #     #
 ######### ####### # # # # ##### ### ### # ### ##### # ####### # # ##### # ### # ##### ####### # # ##### ######### # ### # ### #
     #   #       #   # # # #       #   #   #       # #   #     #   #     # #   # #   #   #   #   # #   #   #   #           #   #
#### # # ####### ####### # ####### ### ##### ### # # # # ### # ##### ##### # ### # # ### # # ##### # # ### # # ##### # ##### # #
   #   #       #       # # #     #   #     #   # # #   #   # # #       #   #   #   #   # # #       # # #   # # #   # #   #   # #
 # ### ### ##### ##### # # # ##### ##### ### # # ######### ### # ##### # # ### ##### # # ########### ### ### # # # ####### ### #
 #   # #   #   # #     # # #       #   #     # # #       # #   # #   # # #   # #   # # #   #         #   #   #   #   #   # #   #
 ### # ##### # ### ##### # # ####### # ####### ### ##### # # ### # # # # ##### # # # # ### # ####### # ############# # # ### ###
   # # #   # # #   #     # # #       #     # #     #   #   #     # #   # #     # #   # #   # #     #         # #       #       #
## # # # # # # # ### ##### ### ####### ### # ####### ####### ### # ####### ##### ##### # ##### ### ######### # # # ######### # #
   #   # #   # # #   #     #   #     #   #         #   #       # #         #     #     # #     # #     #     #   # #   #   # # #
 ##### # ####### # ### ##### ### ### ### ############# # ##### ##### ####### ##### ### # # ##### ##### ##### ####### # # # # # #
 #     # #       # # #       #     # #   #     #       # #   # #   #       # #   #   # # #     #   #       # #       # # # # # #
 # ##### ##### ### # ############# ### ### ### # ####### # # # # # ### ### # # # ##### # # ### ### ####### # # ####### # # # ###
 #   # #       #     #   #       # #   #   # # # #     #   # # # # # # #   #   # #   # # #   #   #     #   #   #     # # # #   #
 ### # ######### # ### # # ##### # # ### ### # # ##### ##### # ### # # # ####### # # ### ####### ##### # ####### ### # # # ### #
 #               #   # # # #   # # # #   #   # #   # #     # #   # #   # #       # #   #     # #       # #     #   # #   #     #
 ########### ##### ### # # ### # # # # ### # # ### # ##### # ### # ####### ####### ### ##### # ######### # ### ### ########### #
   # #       #   #   # # #   #   # # #   # # # #   #   #   # #   #       #   #   # # #       # #         #   # #   #   #     # #
 # # # ####### # ### # # ### ##### # ### ### # # ### # # ### # ######### ### # # # # ######### # ############# # ### # # # ### #
 #   #         #   #   #           #         #       #       #             #   #                                     #   #     #
