################################################################################################################################
#   #                           #     #           #     #         #   #   #   #   # #   #             #               #   #     
# # ####### ### ### ### # ##### ##### # ######### # ### # # ####### # ### ### # # # # # # ######### # # # ##### # ### ### # ### 
# #         #   #   #   # #   #     #     #       # #   # # #   #   #   # #   # # #   # # #   #   # # # #   #   #   #     # #   
# ############# # ### ### # ####### # ##### ####### # ##### # # # ##### # # ##### ##### # # # # ### ### ### ####### ### ### # ##
#     #   #     # # #   # # #     #   #   #   #   # # #   # # #   #   #   # #   #         # # #   # #   # #       #   #   # #   
##### # ### ### # # ##### # # ### # ### # ### # # # # # # # # ##### # ##### # # # ### ##### # ### # # ### ####### ### # ### ####
#     #     #   # #   #   # # #   # #   #   #   # # #   # # # #     # # #   # # #   # #     # #     # # #   #   # #   #   #     
# ### ######### # ### # ### # # ### # ##### # ### ####### # # # ##### # # ##### # # ### ##### ####### # ### ### # ####### ##### 
#   # #     #   #     #     # # #   #   # # #   # #       #     #     #   #       #     #   #         #   #   # #   #       #   
### # # ### # # ############# # ### ### # # ### # # ############# ##### ### ##### ####### # ############# ### # ### ### ##### ##
#   # #   # # #           # # #   #   #   # #   # #         #                   #         #             # #   #   #   # #   # # 
# ######### # ### ####### # # ### # ##### # # ### ######### # ################# ### ######### # ##### # # # ### ##### # # # # # 
# #         #   # #     #   # #           # #   #           #   #         #   # #   #   #     #   #   #   # #   #     # # #   # 
# # ######### # # # ####### # ### ######### ### ############### # ####### # # # # ### # # ####### ######### # ### ####### ##### 
# # #   #     # #   # #   # #   # #     #   #                 # #   #     # #   #   # #   #     #           #   #         # #   
# # # # ##### # # ### # # ##### # # ### # ################# # # ### # ##### ####### # # ### ### ### ########### ########### # # 
# # # #  G    # # #   # #       # # # # # #               # #   #   #   #   #       # # #   # #   #             #           # # 
# # # ######### # # ### ######### # # # ### ############# # ##### ##### ### # ### ### ### ### ### ##### ### # ### ##### ##### # 
#   #       #   # # #   # #   # # #   #     #   #       # # #   #     # #   #   #   #     # #   #   #   #   #   # #   #       # 
##### ####### ### # # ### # # # # ########### # # # ### # ### # ####### # ####### # # ##### ### ### ##### ### # # # # ######### 
#   #     #   #   # # #   # # # #   #       # #   # # # # #   #   #     #       # # #             #   #     # # # # # # #     # 
# # # ##### ### ### # # ### # # ### ### ### # ##### # # # # ##### # ########### # # # ##### ######### # ### # # # ### # # ##### 
# #     #   #       # # #   #   # #     #     #     # # # # #   #     #     # # # # # #   # #       # # #   # #   #     #     # 
# ### ### ### # ##### # # ##### # ### ######### ##### # # # # # ####### ### # # ### ### # ### ##### # # # ### ##### ### ##### # 
#   #   #   # #   #   # # #     #     #         #       # # # #       # #   # #   # #   #     #   # # # # #     #     #     #   
### # # ### ##### # ### # ##### # ### # ########### ##### # # ####### # # ### ### # # ######### ### # # # ### ### ### ##### ####
#   # #   # #   # #   #   #   #   #   #   #   #   #   #   # #       # # #   #   # #   #   #   #     # # #   #     #   #   #     
# ### ### # # # ##### ##### # ############# # # # ### # ### ####### # # ### # # # ##### # # ######### # ### # ##### ### ####### 
# #   #   # # #   # # #     #               #   #   #         #   # # # #   # # # #   # # #   #     # # #   #     # #   #       
# ##### ### # ### # # # ########################### # ### # ### # # # ### ### # # # # # ##### # ##### ### ####### # # ### ##### 
# #   #   # #   #   # #   #               #         # #   #     # # #     #   # # # # # #     # # #   #   #     # # #   # #     
# # # ### # ##### ### ### # ############# # ########### ######### # ########### # ### # # ##### # # ### ####### # # ### # # ### 
# # # #   #   #   #     # # #         #   #         #   #   # #   #   #   #   # #     #   #       # #     #   #   #   # # # #   
# # # # ##### # ### ##### # # ######### ########### # ### # # # ##### # ### # # ######### # ### ### # ##### # ### ### # # ### ##
# # # #     # #   # #   #   # #       # #         #   #   #   #     # #     #           # #   #   # # #   # #   # # # # #   # # 
# # # # # # # ### # # # ##### # ##### # # ####### ##### ########### # ############# ### # ### ### # ### # ##### # # # # ### # # 
# # # # # # # #   #   #   #   #     #   # #     #                 #   #     #     # #   # #   #   #     #       #   # #     #   
### # # # ### # ####### ### ####### ##### # ### # # ### ######### ##### ### # ### # # ### # ######################### ####### ##
#   # # #   #   #   # #     #       #   # # #   # #   # #     #   #   #   # #   #   #   # #   #   #           #       #       # 
# ### # ### ####### # ####### ####### # # # ########### # ### # ### # ### ##### ####### # # # # # # ######### # ####### # # # # 
#   # #   #         #     # #       # # # #         #   #   #   #   #   #       # #     #   # # # #   #     #   #       # # # # 
##### # ################# # ##### # # ### ######### # ######### # ############### # ####### ### ##### # ### ####### ####### # # 
# #   # #   #     #     #   #   # # #     # #       #   #       # # #     # #   # #     #   #   #   # #   #   #     #       #   
# # ### # # # # ### ### # ### # ### ##### # # ########### ##### # # # ### # # ### ##### # ### ### # # ####### ####### ##### ####
#   #   # #   #   # # #   #   #   #     # # #   #     #   #     # # # # # #     #     # #   #     # #         #       #       # 
# ### # # ##### # # # ##### ##### ##### # # ### ### # # # ##### # # # # # # ### ##### # ### ####### ########### ##### ####### # 
# #   # # #   # #         #     #       # #   #     # # # #         #   # # #     # # #   # #       #   # #     # #   #     #   
# ### # # # # ### ####### ##### ######### ### ####### # ### ####### ##### ### ### # # ### # # ####### # # # # # # # # # ### ### 
#   # #   # #   #   #   #     #   #   #       #     #   #   #     #     #     #       #       #     # #   # # # #   # # #     # 
### ####### ### ##### # ######### # ### # ##### ######### # # ### ##### ####### ##### # ##### # # ### ##### # # ####### ##### # 
#   #   #   # #   #   # #     #   # #   #     #     #     # #   #   #           #   #   #   #   # #   #     # #     #   #   # # 
# ### # # ### ### # ### # ### # ### # ##### ####### # ### ##### ### # ######### # # ##### # ##### # ### ### # ##### # ### # # # 
#     #   #     #   # #   #   #   # #     #     #   # #   #     # #   #         # #       #       # #   #   #     # # #   # # # 
############# ####### ##### ##### # ### # ##### # ### ##### ##### ##### ####### # # ############# # # ##### ####### # # ### # # 
#       #   # #       #   # #     #     #     # # # #     #   #   #     #       # # #         #   #   #       # #   #   #   # # 
# # ##### # # # ##### ### # # ####### ######### # # ##### ### # ### # ####### ### # # ####### # # ##### ##### # # # ##### ### # 
# # #   # #   #     #     #   #       #         #   #   # # #   # # # #   #   #   # #   #     # #       #     # # # #   # # # # 
# ### # ### ####### ##### ##### ### # # ########### # ### # ##### # ### # ### # ### ### # ##### # ####### ##### # # # # # # # ##
# #   #     #     #   # #     # #   # #         #   #     #     # #     # #   #   #   # #     # # #   #         # # # # #   #   
# # ######### ####### # ##### ### ### ######### # ######### ### # ####### # ##### ##### ####### # # # ########### ### # ####### 
# #     #   #         #   # #     #   #       # # #   #     #   #   #     #     #     #   #     # # # #     #     #   #         
# ##### # # ########### # # ####### ### ##### # # # ### # # # ##### # ######### ##### ### # ##### # # # ### # ### # ############
#         # #       #   # #         #   #  S# #   #   # # # #     # #   #     #     #   # # #     # #   # # # #   # #           
########### # # # # # # # # ##### # # ### ### ####### # # ######### ### # ### ##### # ### # ##### # ##### # # ##### # ######### 
#         #   # # #   # #   #     # #   # #   #   #   # #             # #   #     # #     #     # #       # # #     # #         
# ####### ##### # ### # ##### ##### ### # # ##### # ### ############### ### ##### # ########### # # ####### # # ##### # ########
#   #   #   #   #   # # #     #   #   # # # #   # #   # # #           #   # # #   # #   # #     # # #       #   #     #   #     
### ### ### # # ### # # ####### # ### # # # # # # ### # # # ####### # # ### # # ### # # # # ##### # # ################### # ####
# #     # # # #   # # #     #   # # # # # #   # #   # #   # # #   # # # #   # #   #   #   #     # # # #   #   #   #       #     
# ##### # # # # # # ####### # ### # # # # ##### ### # ### # # # # ### # # ### ### ### ######### ### # # ### # # # ### ######### 
# #   #   # # # # # #   # #   # #   #   #   #   #   #     # #   #     #   #     #   #     #   # #   # #     #   #   #           
# ### ### ### # ### # # # ##### ########### # ### ### ##### ############### ### ### ####### ### # ### ############# ########### 
#   #   #     #   #   # # #     #       #   # #   # #   # # #     #   #     #   #   #     #   #   #   #       #     #           
### ### ####### # ##### # # ##### # ### # ### # ### ### # # # ### ### ####### ### ### ### ### ##### ### ##### # ##### ######### 
# #   #         # #   # # # #   # # # # # # # # #     #   # # # #   # #     #   #   #   #   #     # #   # #   #   #   #   #   # 
# ### # ### ##### # ### # # # # # # # # # # # # ### ##### # # # ### # # ### ### ### ### ### ##### # # ### # # ### ##### # # # # 
#   # #   # #     #     # # # #   # #   #   # # #   #   # # #     #   # #   #     #   #   #       # # #   # #   #     # # # #   
# # # ### # # ########### # ##### # # ##### # # # # # ### # ##### ##### # ### ### ### ### ####### # # # ### ### ##### # # # ### 
# # #     # # #           #   #   # # # #   #   # # #   # # #           # #   #     #   # #     # # #   #   #   #   #   # # #   
# # ### ##### # ### ######### ##### # # # ####### # ### # # ############# # # ### # ### # # ### ### ##### ### ##### ##### # ### 
# #   # #     # #     #     #       # # #   #     # # # # #             #   # #   #   #   #   #   # #     #         #     #   # 
# ### # # ####### # ### ### ######### # ### ### ### # # # ############# ####### ##### ####### ### # # ##### ######### ####### # 
#   #   #   #   # # #   # #     #     #   #     #   #         #       # #     #     # #       # #   # #   #   #   #   # #     # 
### ####### # # # # # ### ##### # ##### # ####### ### # ### # # ####### # ### ##### # # ####### ##### # # # ### # # ### # ##### 
# #       # # #   # #     #   # #       #       # #   # #   # #       # #   #   #   # #   #           # #   #   #   #   #   #   
# ####### # ####### ####### # # ####### ##### # # ##### # ### ####### # ####### # ### ### ### ### ##### ##### ####### ##### # ##
#         #   #             #           #     # # #     #   # #   #   #     # # #   #   #   #   #     # #     #     #   #   # # 
######### ### # ####### ####### ##### # # ##### # # ### ### # # # # ####### # # ### ### ### ##### ##### # ##### ### # # ##### # 
#         #   #   #   # #     # #   # # #     #     #   #   #   # #     #   #     # #     #     # #   #   #   #   #   #     #   
# # ####### ##### # # # # ### ### # # # ############# ### ####### ##### # ####### # ##### ##### ### # ### # # ### ######### ### 
# #     # # #     # # # #   #     # # #     #     #   #   #   #   #   # #       # # #   # #   #   # #   # # #   # #       #     
# ##### # # ####### # # ### ####### # ##### # ### ##### # # # # ### # # ####### # # # # # # # ### ##### # ##### # # ##### ######
#     #   # #       #     # #     # # #     #   #       # # # #   # # #       # #   # # #   #   #       #   #   # #   #   #     
# ######### # ############# # ##### # ############# ####### # ### # ##### # # # ##### # ####### ########### # ### ### ### # ### 
#   #     # # #         #   #     #   #         #   #       # # #         # # #     # #       #     #     # #       #   #   #   
### # # # # # # ######### ####### ### # ####### ##### ####### # ### ### ### # ##### ######### # ### # ### # ### ####### ##### ##
#   # # # # #     #       #           # #     #     # #   # # #     #   #   # #   #   # #         # # # #   # # #     #   #     
# ### # # # ##### # ####### ########### ### ####### # # # # # ##### # ### ### # ##### # # ####### # # # ##### # # ### # # ##### 
# #   # # #     # #   #     #   #     # #   #   #   # # # # # #   # #   #   #   #     #   #     # #   # #     # # #   # #   # # 
# # ### # ##### ##### ### ### # # ### # # # # ### ### # # # # # # ############# # ##### ### ### # ##### # # # # # ######### # # 
#   # # #     # #   # #   #   #   #   #   # # #   #   # #   #   # #     #   #   #     #     #   #         # # # # #         # # 
##### # # ### # # # # # # # ####### ####### # # ### ####### ##### # ### # # ### ##### # ######### ### # ### ### # # ######### # 
#     # #   # # # # # # # # # #     #   #   #   # # #         #   #   # # #   #         #     #   #   # # #     #   #   #   #   
# ##### ##### # # ### # ### # # ####### # ####### # ######### # ##### # ##### # ######### ### # # ##### # ########### # # # # ##
#   #   #     # #     # #   # #   #     # #       #   #   #   #     # #     # #     #     #   # #   #       #     #   #   #   # 
### # ### ##### ####### # ### ### # ##### # # # ##### # # # ####### # ##### # # ### # ######### ### ### ##### ### # ########### 
#   # #   #   # #   #   #   #   # # #       # #   #   # # #       # #   # #   # #   #       #   #   #   #     # #   #   #       
# ### # # ### # # # ####### # # # # # ####### ### # ### # ####### # ### # ####### # ####### # ### ### ### ##### ##### # # ##### 
# #   # # #   #   #   #   # # #   # # #     #   # # #   #       # #     #     #   # #   #   #   # #   #   #     #   # #   # #   
# # ### # # ######### # # # # ##### # # ### ### # # ##### ##### # ######### # # ### ### # ####### ##### ### ### # # # ##### # ##
# # # # #   #       #   # # # #     #   #   #   # #     #     #   #         # #   #   # # #     #     # #     # # #   #         
# # # # ##### ##### ##### ### # ##### ### ### ### ##### ##### ######### ##### ### ### # # # ### ### # # # ### # # ############# 
#   #     #   #         # #   # #     #   #   #     # #   #     #       #   #     #     #   # #   # #   #   # # #       #     # 
######### # # ########### # ### # ### ##### # ##### # ### ##### ######### ######### ######### ### # ####### # ######### # ##### 
#       #   # #           # #   #   #   #   # #   #     #   #   #       #           #   #   #     #         #     # #   # #     
# ######### # # ########### # ##### ### ##### # # # ####### # ### ##### ####### ##### # # ### ##### ### # ##### # # # ### # ####
# #       # # #     #   #       #   #   #     # # # #     # #   # #           #   #   # # #   #       # #   # # #   #     # #   
# # ##### ### ##### ### # # # # # ### ### ##### # # # ### # ### # ########### ### # ### # # ####### ### # # # # ########### # # 
# #     # #       #     # # # #   # # #         # # # # # #   # # #   #     #   # # #   # # #     # #   # #   #   #         # # 
# # ### # # ##### ####### # # ##### # ########### ### # # ### # ### # # ### ### # # # ### # ##### ### ### ####### # ######### # 
# # #   #   #             # #       #           #   # # #   # #   # # #   #   # #   #     # #   #     #         #   #   #   # # 
# # # ####### ### ######### ######### ######### ### # # # ### ### ### ####### # # ####### # # # ########### # # ##### # ### ### 
# # # #       #   #   #     #       #     #     #   # # #     # # #   #       # # #     # #   #   #         # # #     #   #   # 
# ### # ####### ### ### ##### ##### ####### ##### ### # ####### # # ### ####### # # ### ######### # ########### # ####### ### # 
# #   # # #   # #   #   #   # #   # #   #   #   #     #   #           #       #   # #   #     #   # #     #     #   #     # #   
# # ### # # ### # ### ### # # # # ### # # ### ### ####### # ### ### # ####### # ### # ### ### # ### # ##### # ####### ##### ### 
#   #   #       #     #   #     #     #   #                 #   #   #               #       #   #   #       #                   
