################################################################################################################################
#             #       #               #     #   #                 #     #     #     #         #               #     #   #       
# ######### ### # # ### ##### ### ### # ### # # # ### # ### ### ### # # # ### ##### # ##### # # ### # # ####### ##### # # ##### 
# # #       #   # # #   #   #   #   # #   #   # # # # #   # #   #   # # #   # #       #   # #   #   # #    S#   #   # # # #     
# # # ####### ### # # ##### ### # ### ### ##### # # # ### # ##### ### # ### # # ####### # ####### ##### ### # ### # ### # # ####
# #   #       #   #         #   # #   #   #     # # # #   #   #   # # #     #   #       #       # #   #   #   #   #     # #   # 
# ##### ####### ############# ### # ### ### ##### # # # ##### # ### # ### ####### ############# # # # ######### ######### ### # 
#     #     #   # #     #   #   # #     # #       # # #     #       #   # #             #       #   #     #   #     #   # #     
##### ##### ##### # ### # # ### # ####### ######### # ### ####### ##### ### ########### # ############### # # ##### ### # # ### 
#     #   #       #   # # # #   #     #   #         #   # #     # #   # #         #   # # #       #   # #   #     #   #   # #   
# ### # ######### ### # # # ####### # # ### # ##### ### ### ### ### # # # ######### # # # # ##### # # # ######### ### ####### # 
#   # #         #   # # # #       # #   #   #     #   #       # #   # # #   #   #   # # #   #   #   # #   #         #       # # 
### # ### ######### # ### ####### # ##### ####### ############# # ### # # ### # # ### ####### # ##### ### # ##### # ####### ### 
#   #   #   #     # #   # #     # #       #     # #       #   #   #   # # #   #   # #         #   #   # # #   #   #       #   # 
# ##### ### # ### # ### # ##### # ### ##### ### # # # ### # # ##### ##### # ####### ############# # ### # ### # # ####### ### # 
#     #   # # #   # # # #     # #   #     # # # #   #   # # #     #       #   #   #     #   #     #   # #     # #       #   # # 
# ### ### # # # ### # # ##### # ### ##### # # # ####### ### ##### # ##### ### ### # ### # # # ##### # # ####### # ##### ##### # 
#   # # # # # #     # #   #   # #   #   #     #   # #   #   # #   # #   # #   #   #   # # # # #     # #   #     # #   #   #   # 
# # # # # # # ####### ### # ### # ### # ##### ### # # ### ### # ##### # # # ### ##### # ### # # # ### ### # # # ### # ##### ### 
# # #   #   # #         #   #   #     #     # #   # #   # # # #       # # # #   #   # #     # # #   #   #   # #     # #     #   
# # ####### # # ############# ############# # # ### ### # # # ######### ### # ### # # ####### ##### ### ##### ####### # ##### # 
# #   #     # # #   #   #                   # #     #   # # #   #     #     # #   # # #     #   #     # #   #       # #     # # 
# # ### ### # # # # # # # ################### ####### ### # ### ##### ####### # ##### # ### ### # ##### # # ### ##### ##### # # 
# # #   #   #   # #   # #   #     #     #         #   #   #   #   #   #     # # #       #   # # # #   #   #   # #   #     # # # 
# ### ### ##### # ##### ### ### # # ### ### ####### ### ##### ### # # ### ### # # ####### # # # # ### ####### ### # ####### ### 
# #   # # #     #   # # # #   # #   # #   #       # #   #   #     # #   #         #       #   # #           #     #   #   # #   
### ### # # ####### # # # ### # ##### ### # ##### # # ### # # ##### ### ##### ##### ### ##### # ####### # ########### # # # # # 
#   #   # #         # # # #   #   #     # # # #   # #     # # #       #       #   # #   #     #       # #   # #     #   # # # # 
# ##### # ### ##### # # # # ##### ### ### # # # ### ####### # # ### # ####### # # # # ### ### ####### # ### # # ### # ### # ### 
#     # # #   #   # # #   #     #   # #   # # #   #       # # #   # #   #     # #   # #   # # #     # #   #   # #   #   # # #   
##### # # ### # # # # ######### # # # # ### # ############# # ### ##### ####### ##### # ### # # ### # ######### ##### # # # # ##
#   # #       # # #         # # # # # #   #     #         # #   #     #   #     #   # # #   # #   # # #       #   #   # # # #   
# # # ######### # ######### # # ### # ### ####### ####### # ### ######### # ##### # # # # ### ### ### # ##### ### # ### # # ### 
# #   #         # #   #     # #     #   #       # #       # #   #     #   # # #   #   # #       #   #   #   #     #   # #   #   
# ##### ######### ### # ##### ####### ######### # # ####### # ### ### ##### # # # ##### ####### ### ##### # ######### # ####### 
#   #   #       #   # #     #       #   # #     # #         #     #         # # # #   #   #               #           # #     # 
##### ### ######### # ##### ##### # # # # # ##### ### # ##################### # # # # ### # ########### # # ### ##### # ##### # 
#     #   # #     # #     #       #   #   #   #   # # #             #       #   #   #   # # #     #     # #   #     # #       # 
# ##### ### # ### # # ### ######### ######### # ### # # # ######### # ######### ######### # # ### ##### # ### ##### # ######### 
#     #     # # #   # #         #   #       # #   #   # # #     # # #           #         # # #       # #   #   #   #   #     # 
# ### ##### # # ##### # # ##### # ### ##### # ### ##### # ##### # # ##### ##### # ######### # ####### ### # ### # ####### # ### 
# #   #     # #       # # #   #     # #     # #   #   # #         # #     #     #   #       #   #   #   # #   # #       # #   # 
# # ##### ### ######### # # # ##### # ####### # ### ### # ######### # ##### # ####### ### ##### ### ### # ### # ####### # ### # 
# # #       #   #       # # #       # #     #   # # #   #   #   #   # #     # #       #   #   #     # #   #   # #     #   # #   
### # ### ##### # ####### # ##### ### # ### ##### # # ##### # # # ##### ##### # ####### ### # ####### ##### # # ##### ##### ####
#   # #   #     # #     # # #     #   # #   #     #   #     # #   #     # #   #   #     # # #   #           # #     # # #       
# ### # ### ####### ### # # # ### # ### ##### ### ##### ### # ##### ##### # ##### ### # # # ### ######### ######### # # # ##### 
#   # # # #       # #   # # #   #     # #     #         #   #     # # #   #     #   # # # #   #   #       #   #     # #       # 
### ### # ####### # ### ### ####### ### # ### # # ############### # # # ##### # ### ### # ### ### ######### # # ##### # ####### 
# #   # #     # # #   # #     #   # #   # #   # #   #           # # #       # #   #   #   #   #   #   #     # # #       #     # 
# ### # # ### # # ### # # ##### # # # ### # ### ### # ####### ### # ####### # ### ### ##### ### ### # # ##### # # # ### # ### # 
#     # # # #   # #   # # #   # #   #     #   #   #   #     # #   #   #   #   #     #     #   #   # #   # #   # # #   #   #   # 
####### # # ### # # ### # # # # ### ####### ####### ### ### ### ##### # # ##### ######### ### ### # ##### # ### # ### ######### 
#     # # #   # # #   #   # # # #           #     #   # # #   #     # # #   #   #       #   # #   # #     #     #   #   #   #   
# ### # # ### # # ### ##### ### # ####### # # ### ### # # ### ##### # # ### ##### # ####### # ##### # ### ####### ##### # # # # 
#   # # # #         #     #     # #       # # #   #   # #   #       # # # # #     # #       # #     #   #           #   # # # # 
### # # # # # ##### ##### ####### ######### # # ####### # # ######### # # # # ##### # ##### # # ##### # ### ####### # ##### ### 
# # # #   # # #   #       #       #         # # #       # #           #   #   #   # #   # # # # #     #   # #   #   #       #   
# # ####### ### # ####### # ####### ######### # # ####### ### ####### ### ##### # # ### # # # # # ##### # # # # ############# ##
#   #       #   #       # # #     # #       # #   #   #     # #         #     # # #   # # # #   #     # # # # #     #         # 
# ### # ##### ######### # # ##### # # ####### ##### # ##### # # ############# ### ##### # # ##### ### ### ### ##### # ##### # # 
#     # #     #   #   # # #   #   # #       # #     #     # # #       #           # #   #         #   #   #   #   # # #     # # 
######### ##### # ### # ##### # ### ####### # ########### # # ####### # ####### ### # ####### # # ##### ### ### # # # # ### # # 
#       # #   # #     # #     # #   #       #           #   #   #   #     #   #     # # #   # # #     #     #   #   # #   # # # 
# ##### # # # ### ### # # ##### # ##### ############### ##### ### # ####### # ### # # # # # # # ##### ############### ### ### # 
# #     # # #   #   # #   #   # # #   #   #       #   # #   #     #   #     # #   # # #   # # #   # #         #         #   # # 
# ####### # ### # # ####### # # # ### # ### ##### ### # # # ### ####### ##### ####### # ##### ### # ######### ########### # # # 
#   #     # #     # #       # # #   #       #   #     #   #   #   #   #   #   #       # #     #   #     #     #     #   # # #   
### # ####### ####### ####### # ### ### ##### # ############# ##### # ##### ### ####### # # ######### ### ##### ### # # ### ####
# #   #       #   #   #     #   # #   #     # #       #     #       #     # #   #   #   # #         #   # #     # #   #   #     
# ##### ### # # # # ### ####### # ### ##### # ####### ### ####### ####### # # ### # # ######### ### # # # # ##### ####### ##### 
#     #   # # # # #     # #   # #   # #     # #     #   # #     # # #     # # #   # #         # #   # # # # #     #       #     
##### ### # ### # ####### # # # # ### ##### # ##### ### # # ### # # # ##### # ##### ######### # # ### # # # # ### # ####### ### 
#   #   # #     #   #     # #   # #   #   #   #       # # # #   #   #     # # #             # # #   # # #   #   # # #     # #   
# # # ### ######### # # # # ##### # ### # ##### ####### # # ##### ####### # # # ######### ### ##### # ####### # # # ### # # # ##
# #   #   # #   #   # # # #   #   #     #   # #         # #     # #       #   # #     #   #   #     # #   #   # # #   # # # #   
##### # ### # # # ### # ##### # ########### # # ######### ##### ### ########### # ##### ### ### ##### # # # ### ##### ### # ### 
#     # #     # #     #     # #     #   #   # # #         # #   #   #   #     # #       # #   # #       # #   #     #   # #   # 
# ##### ### ####### ####### # # ### # ### ### # # # ##### # # ### ### # # ##### # ####### ### # ######### ### ##### ### # # # ##
#       #   #     # #     #       # # #   # #   # # #   #   # # #   # #   #   # # # #       # # #   #     # #     #   # # # #   
# ####### ### ### ### ### ##### # ### # ### # ### # # ### ### # # # ##### # # # # # # ### # # # # # # ##### ##### # ### # ### # 
# #       #   #   #   # #     # #     #   # #   # # #   # #   #   #     # # #   # #   #   # #   # # #           # # #   #   # # 
# ### ##### ### ### ### ##### # ######### # ### ### ### # # ########### # # ##### ##### ### ####### ########### # ### ##### ### 
# #   #   # #   #   #   #     # # #   #   #   #   #   # # # #     #     # # #   #     # # #   #   #   #       #     #     #   # 
# # ### # # # ### ### # # ##### # # # # ### ##### # ### # # ### # # ##### # # # ##### # # ### # # ### # ##### ##### ##### ### # 
# # #   # # #   # # # #   # #   # # # # # # #     #     # #     #   #   # # # #   # #   # #   # # #     # #   #   #   # # # # # 
# # # ##### ### # # # ##### # # # # # # # # # ########### ########### # # # # ### # ##### # ##### ####### # ### # ### # # # # # 
# # # #     # #   #   #   #   #   # #   # # # #     #   #   #   #     # # # #   # #       #     #   #     # #   #       # # #   
# # # # ##### ##### ### # ######### ##### # # # ##### # ### ### # ##### # # # # # ### # # ##### ### ##### # # ####### ### # ### 
#   # # #   #     #     #     #     #     # # #     # #     #   #     #   # # # #   # # # #     # #   #       #   #   #   #     
### # # # # ### ############# # ######### # # ##### # ####### # ##### ##### ### ### ### # # ##### ### ######### # # ### ### ### 
#   # # # #     #       #   #   #   #   #   # #     # #     # # #   #     #   # #       # #     #     #         #     #   # #   
# ### # # ####### # ### # ####### # # # # ### ##### # # ### ### # # ##### # # # ######### ##### # ##### ######### ####### # # ##
# # #   #         #   # #   # #   #   # #   # #   #       #     # # #   # # # # #           # # #       #   #   # #     # # # # 
# # ######### ####### # ### # # ####### # ### # # # ############# # # # # ### # # ######### # # ### ##### # ### # # ##### # # # 
# #         # #       # #   # # #   # # #   #   # # #     #   #   #   # # #   # #         # # #   # #   # #     # #       # # # 
# ######### # ########### ### # # # # # # # ##### # # ### # # # ### ##### # ### ######### # # ### ### # ####### # ######### # # 
# #     #   # #       #   #   #   # #   # #     #   #   # # #   #   #   #   #     #     # #     #     #       #             #   
# # ### # ### # ##### # ### # ##### ##### ######### ### ### ##### ### # ######### # ### # ##### ############# ##### # # # ######
# #   #G#     #   #   # # # # #   #   #     #     #   #     # #   #   #     #   # #   #   #   #   #   #     # #   # # # # #   # 
# ### # # ####### ##### # # ### ##### ##### # # # ### ####### # ### ####### # # ##### ##### # ### # ### ### # # # ### # # ### # 
#     # # #     #   # # #     #     #     #   # #   # #     #   #   #       # #   #   #   # # # # #   # #   #   #     # # #   # 
# ##### # # ### ### # # ##### ##### ##### ##### ### # ##### # ### ########### ### # ### # # # # # ### # # ############# # # ### 
# #   #     #     # #                   #       # # #   #   #   #   #         # # # #   # # # # # # # # # #       #     #   # # 
### # ### ####### # ### ######### ### # ######### # ### # ##### ### # ######### # # # ##### # # # # # # # # ##### # ### ##### # 
#   #   # #     # #     #   #     #   #   # #     # #   # #   #   #   #             #       # # # #     # #     # #   # #   #   
# ##### # # ### ####### # # ##### # ##### # # ##### # ### # # ### ##### ### ################# # # ####### ##### ##### # # # # ##
# #     # # # #   #     # #   #   # # #   #   #     #   #   #   # #       #   #             # # #             # #     # # # #   
# # ##### # # ### # ### # ### ### # # # ##### # ####### ####### # # # ####### # ########### # # ############# # # ##### ### ### 
# #   #   # #   # # #   #   #   # #   #       # #     #   #         #   #     #       #   #   #   #           # # #   #     # # 
# ##### # # ### # # # ##### ### ############# # ##### ### # ##### ##### # ########### # ######### # # ##### ### # # # # ##### # 
# #     # #   #   # #     # # #   #           #     #   # # # #   #     #         #   #             # #         #   # #       # 
# # # ### ### ##### ##### # # ### # ####### ####### # # # # # # # # ############# # ####### # ####### # ### ######### # ##### # 
# # #   #   #     #   #   # #     # #     # #   #   # # # # # # # #       #       # #     # #     #   #   # #         # #   #   
# ##### ### ##### ### # ### # ####### ### # # ### ##### # # # # # ##### # # ####### # # # # ####### ####### # ######### # # ####
#       #       #     #   # #   #   # # #     #   #     #   #   # # #   # #     #   # # #       #   #   #   #   #   #   # # #   
######### # ### ##### ##### ### # # # # ### ### ####### ####### # # # ### ####### ##### ######### # # ### # ### ### # ##### ### 
#     #   # #           #   #     #   #     #   #         #     #   # #       #   #     # #     # # # #   #   # #   # #     #   
# ##### ### # ### # ### # ################# # ### ####### # ### ##### ##### ### ##### ### # ### # ### # ##### # # ### # ##### # 
#       #   # # # # #   # #   #             #     #   #   #   #     #   #   #   #     #   #   # #     #   #   #   #   # #     # 
######### # # # # ### ### ### # ########### ####### ### ##### # ####### ##### ### ##### ##### # # ######### # ####### # ####### 
# #       # #   #   # # # #   #   # #     # #     #   #       #   #   #     #   #   #   #   # # # # #     # #         #   # #   
# # ####### ####### # # # # ##### # # ### # ##### # # ####### ### # ####### ### # # # ### # # # # # # ### # # ### ####### # # ##
# #     #     #   # # # # # #     #   #   #     # # #     #   #   #       #   # # #   #   #   # #   # # #   #   #     #   # #   
# ##### # ##### # # # # # # # ########### ##### # # ##### ### # ######### ### # ####### ####### ##### # ### ### ##### # ### ### 
# #   # #   #   #   # # # # # #     #   # #   #   #   #   #   #     #   # #   # #   #   #     #       #   #   #     #   # #   # 
# # # # ### # ####### # # # # ##### # # # # ##### ### ##### # ##### # # # # # # # # # ### ############# # ### ##### ##### # # # 
#   #   #   #       #   #   #       # #                     #     #   # #   # #   #   #                 #         #         #   
