################################################################################################################################
################################################################################################################################
         #         #   #   #   #           #         #   #   #   #     #     #             #       #   #   #   #   #         # #
 ### ### # ####### # ### # # # ######### # ##### # # ### # # # # ##### # ### # ########### # ##### # # # # # ### # # ##### # # #
   # # # #   #   #   #   # # #           # #   # # #   #   #   # #     #   # # #         # # #     # # # # # #   #   #     #   #
## # # # ### # # ##### ### # ############# # # ### ### ######### # ####### ### # ####### ### # ##### # ### # # ##### # ####### #
   # # #   # # #     #   # # #         #   # #     # #   #     # #       #   # #       #     #       #   #   #   #   # # #     #
#### # ### # # ##### ### ### # # ### # # ### ####### ### ### # # # ##### ### # ####### ################# # ##### ##### # # #####
     #     # #     #   #     # #   # # # #   #       # #   # #   #     # #   # #       #               # #       #  G  # # #   #
 ##### ##### ##### ### ####### ### ### # ########### # ### # ######### # # ### # ####### ### ########### ####### # ##### # # ###
 #     #   # # #   #         #   #   # # #   #     #   #   #       #   # #   # # # #   #   # #           #       # # #   # #   #
 # ##### # # # # ############# # ### # # # # # ### # ### ######### # ####### # # # # # ### ### ########### # ##### # # ### ### #
 #   #   # #   # #   #         # # # # #   # #   #             #     #       #   # # #   #   #   #         # #     #   #   #   #
#### ##### # ### # # # ######### # # # ##### ####### ######### # ##### ########### # ### ### ### ##### ### ### ##### ### ### # #
     #     #   # # #   #       # #   # #   #       # #       #   #     #         # # #   #     # #   #   #   # #     #   #   # #
 ##### ### # # # # ##### ####### ####### # ####### # # ##### ##### ##### # ##### # # ##### ### # # # ### ### # # ##### ####### #
 #       #   # # # #           # #       #     #   #   # #   #   #   #   # #   # # # #   # #   #   # #   #   # # #   #   #   # #
 ##### # # ### # # ########### # # ####### ##### ### ### # ### # ### # ### # # # # # # # ### # ##### # ### ### # # # ### # # # #
     # # #   #   # #         # #   #     #     # #       #   # #   #   #   # # # # # # #   # #   #   #   #   # #   # # # # # # #
#### # # # ####### # ####### # ######### ##### # # ######### # ######### ### # ### # # ### # ### # ########### ##### # # # # # #
     # # # #     # # # #   #         #   #   # # #   #     # # # #       #   # #   # #   #   #   # #         #   #     #   # # #
 ##### # ### ### # # # # ########### # ### # ### # ### ### ### # # ####### ##### ### ### ##### ### ### ##### ### # ######### # #
 #   # #     #   #   # #             # #   #     #       #   # # #       #         #     # #   # #     #         #             #
 ### # ############### ####### ##### # # ######### ######### # # ####### ##### ### ####### # ### ##### ########### ########### #
 #     #           # # #       #   #   # #             #   #           #   #   #   #     # #           #     #       #       # #
 # # ### ######### # # # ####### # # ### # ##### # # # # # ##### ######### ### # # # ### # ##### ####### ### # ### ### ##### # #
 # # #   #     #   # # # #       # # #   # #   # # # #   # #   # #     #       # #   # #   #     #     #   # # #   #       # # #
 # # # ### ### ##### # # # ####### # # ### # # # # ####### # # ### ### # # ##### ##### ### # ##### ### ### # ### # # ####### # #
 # # #     # #   #   #   # #   #   #   #   # #   # #   #   # #     #     # #     #   #       #     #   # # # #   # # #   #   # #
 # # ####### ### ### ### # # ### ### ### ### ##### # # ##### ####### # ### # ####### # ####### ##### ### # # # ### # ### # ### #
 # #   #       #         # #   #     #   #   #   # # #       #       # #   #       #   #       #     #   # #   #   #   #   #   #
 ##### # ##### ### ##### # # # ####### ### ### # # # ### ############# # ######### ##### ####### ##### # ####### ##### ####### #
   #     #       # #     # # #   #     #   #   # # # #   #     #     # # #       #   #   # #     #     #       # #   # #     # #
## ####### ##### # # ##### # ### ### ####### ### # # ##### ### # ### # # # # ####### # ### # ##### ####### # ### # # # # ### # #
 #         #   # # #     # # #   #   #       #   # #       # # #   #   #   # #   #   # #   #   #   #     # #     # # #   #   # #
 ########### # # # ####### # # ### ### ####### ############# # ### ########### # # ### # ##### # ### ### ##### ### # ##### ### #
   #         # #       #   # #     # #       #     #       #   # # #   #       #   #   #       #       #     #     #     #   # #
 # ########### ### # # # ### ####### ####### ##### # # ### ##### # # # # ####### ### ############### # ##### ### ##### ##### # #
 #     #       #   # # #   #         # #     #     # #   # #     # # #   #     # #   #         #   # # #   #   # #   #     # # #
 ### ### ####### ### ##### ######### # # ############### # # ##### # ##### ### ### ####### ### # # # ### # ### # # ####### # ###
 # #   #       # #   #     #   #   #   #                 # #       #       # #   #         #   # # # #   # #   # #         #   #
 # ### ####### # # ### ##### # # # ### ################### ####### ######### ### ########### ### # # # ### # ################# #
     #         # # # #   # # # # #     #   #   #     # #   #   #           #     #     # #   #   #   # # # #         #         #
#### ########### # # ### # # # # ####### # # ### ### # # ### # ### # ############# ### # # ####### ### # # ######### # #########
   # #           # # #   #   # # # #     # #   #   # # # #   #     # #     #     # #   # #         #   # #         #         # #
 ### # ### ### # # # # ### ### # # # ######### # # # # # # # ####### # ### # ### ### ### # ######### ### ######### ######### # #
   # # #   #   # # # # #   #   #   #         # # # # # # # # #       # # #   # #     #     #       #   # #       #         # # #
 # # ### ### ### # # # ### ####### ######### # ### # # # ### # ##### # # ##### ######### ### ##### ### # # ### # ######### # # #
 # # #   #   #   #   #   # #     #       #   #     #   #     #   #   #   #     # #       #   #   #     #   #   #       #   #   #
 ### # ### ### # ####### # # ### ####### # ######### ########### # # ### # ##### # # ##### ### # ####### ########### # # # #####
     #   # #   #   #   # #   # # # #     #     #   # #     #     # # # # #         # #   # #   #         #     #   # # # # #   #
 ######### # ### ### # # ##### # # # ####### ### # # # ##### # ### # # # ### ### ##### # # ### ######### # ### ### # # # ### # #
 #         #   # #   # #   #     # #   #   # #   # # # #   # # #   #   # #   #   #     # #     #   #     # # #   #   # # #   # #
 # ########### # # ### ### ##### # # ### # # # ### # # # # # # ### ##### ##### # # ############# # # ##### # ### ####### # ### #
   # #   #     #   # # #   #   #     #   #   # # #   #   # # #   #     #     # # #               # # # #   #   #       #   # # #
#### # ### # ####### # # ### # ##### # ####### # ######### # ### # ######### ### ####### ####### # # # # ### ######### # ### # #
     #   # # # #     # #   # #     # #   #   # #             #   # #       # #           #     # #   # # # #       # # #   # # #
#### ### # # # # ##### ### # ##### # ### # # # ### # ##### ### # ### # ### # # ##### ##### ### ##### # # # ####### # # ##### # #
   #   #   # # # #       # # #   #     # # #   #   #     # #   # #   #   # #   #   # #   #   #     #     #       #   # #     # #
 # # # ### # # # # # ##### # # # ##### # # ##### # ##### # # ##### ##### ####### # ### # ### ##### ### ### ### ##### # # ##### #
 #   #     # #     # #     # # # #     # #   # # # #   # # #   #   #   #       # # #   #     #   #   #       #       # #       #
 ########### ####### # ##### # ### ### # ### # # # ### # # ### # ### # ### ##### # # ######### ##### # ### ######### # ####### #
     #     #       # #   #   #     #   # #   #   #     # #   #       #   # #     #   #       # #   # #   # #       # #   #     #
#### # ### ##### # ##### # ######### # # # ####### ##### ### ############# # ### ########### # # ### # # ### ##### ##### # #####
   # #   #     # # #     #   #       # # #   #     #     #   #         #   # #   #       # # #     # # #         #   #   # #   #
 ### ### ##### # # # # ####### ####### # ### # ##### ##### ### ####### # ### # # # ##### # # ##### # # ############# # ##### # #
       # #     # # # # #   #   #       # #   # #     #   #   # #     # # #   # # # #   # # #       #             #   #       # #
#### # # ######### # ### # # ### ####### # ##### ##### ##### # # ##### ### ##### # # # # # # ##### ### ######### # ####### ### #
   # # #     #     #   # # #   #     #   #       # #   #   # # # #   # #   #     # # #   #   #   #     #       # # #     # #   #
 # ### ##### # ### ### # # # # ##### # ########### # ### # # # # # # # # ######### ########### # ### ### ##### # # # ### ### # #
 #         # #   # # #   # # #     # #             #     # # #   # #   #         #   #   #     #   #   # #   # # # # #   #   # #
 ##### # ### ### # # ##### ### ##### ### # ##### ######### # ### # ### ######### ### # # # ####### ### # # # # # ### ##### #####
   #   # #   #   #   #   #   # #         #   #   #     # #     # # #   #   #   #   #   # #   #     #   # # #   #   #   #   #   #
## # # # # ### ####### ##### # # ##### ####### # # ### # ### # # # ##### # # # # ####### ### # ####### # ##### ### ### # ### # #
   # # # #   #   #     #   # # #     # #       # #   # #     # # # #     #   # #       #   # # #     # #     #   #   # # #   # #
 ##### # ### ### # ##### # # ####### ### ####### ##### # # ### # # # ######### ####### ### # # # ### # ##### ### ### # # # ### #
 #   # #   #     # #     #   #   # # #   #         #   # #   # # #   #     # # #   #     #   # #   # #   #   # #   #   # # #   #
 # # ### # ####### # ######### # # # # ### ####### # ####### ### ##### ### # # # ### ### ##### ##### ### # ### ### ### ### # # #
 # #   # #   #   # # #   #     # #   #   # #       #       #   #   #   # # # # #     #       # #   #   # #     # #   # #   # # #
 # ### # # # # # # # # ### ##### ####### # ##### ######### ### ### # ### # # # ####### ####### # # ### # ####### ### # # ### ###
   #   # # #   # #   #     #   #   #   # #     #     #   #       # #   # # # #     #   #       # #   #       #       # #   #   #
#### ### # ### # ########### ##### # # ####### ##### # # ##### # # ### # # # ##### # ### ########### # ##### # ########### ### #
   # #   #   # #S#               # # #   #     #       #     # # # #   #     #     #   #   #               #   #           #   #
## # # ##### ### # ### ####### ### # ### # ####### ######### # # # # ####### # ########### # ### ##### ### ##### ########### ###
   # #     #   # #   #     #   #   # # #   # #     #     # #   # # # #       #           # #   # #   #   #     #   # #     #   #
 ### ##### # # ##### ##### ##### ### # ##### # ##### ### # ### # # # # ##### ########### # # # ### # ### ##### ### # # ### ### #
 #   # #   # #     # #   #       #   #   #   # #     #   #     # # # # #     #   #     #   # # #   # #       #       # # #   # #
 # ### # ### ##### # # ################# # ### # ##### ####### # # # # # ##### # ##### ##### ### ### ############# ### # ##### #
   #   # #   #   #   #   #   #     #   # #     # #   # #       # # # # #   #   #     # # #       # #   #         #   #   #     #
#### ### # ### # ##### # # # ##### # # # ##### # # # # # # ##### # ### ### # ####### # # # ####### ### # ####### ### ### # ### #
 #   #   # #   #   #   # # #       # #         # # #   # #   #   #     # # #       # # # #     #   #   #     # #   #     # #   #
 # # # ### # ### # # ### # ######### # ####### # # ##### ### # # ####### # ####### # # # ##### ### # ####### # ### ####### # ###
   # #   # #   # # #   #   #   #     # #       # #     # #   # #         #       # #   # #   #   # #   #     #   #   #     #   #
 ####### # ### # # ### ##### # ### ### # ##### # ##### ### ### # ##### # ####### # ##### # ##### # ### ####### ##### # ##### # #
 #     # #     # #   # #   # #     #   # #     #   #   #   #   #     # #       # #             # #   #     # #   # # #   #   # #
 # # # # # ##### # # # ### # ####### # # # ####### # ### ### ######### ####### # ####### ##### # # ####### # ### # # ### # ### #
   # # # #     # # # # #   #   # #   # # # # #   # # #     # #   #   # #   # # #       # #   #     #       #             # #   #
 ### ### # ### # # # # # ##### # # # ### # # # ### # # ### # ### # # ### # # # ####### ### # # ##### ####################### # #
   # #   #   # # # # # #   #   #   #   # #   #     # # #   #     # #   # # # #     #   #   # #     #           #       #     # #
 # ### ##### # # ### # ### # ######### # ########### # # ######### ### # # # # ### # ### ### # ### # ######### # ##### # ##### #
 # #   #   # # #   # # #   # #       # #       #     # #       #   # #   # #   #   #   #   # #   # #     #     #   # # #     # #
 ### ##### # # ### ### # ##### ##### ######### # ############### ### ##### ####### ### ##### ### # ####### ####### # # ##### # #
   # #   # # #   #     #       #   #   # #     # # #     #       #   #   #       #   #     # # # # #   #   #       # #   #   # #
## # # # # # ################### # ### # # ### # # # ### # ####### ### ######### ### ##### # # # # # # # ########### ### # ### #
   #   #   #       #   #       # #   # #   #   # # # # # #   # #   #   #   #     #     #   # # # # # # # #     #     #   #   # #
 ########### ### ### # ### # ### # ### ##### ### # # # # ### # # ##### # # # ########### ### # # # ### # # ### # ### # ##### # #
   #     #     #   # #   # # #   #   #     #   # # #   #     #   #   #   # # #           #   # # # #   # #   #     # #   #   # #
## ### # # # # ### ##### ### # ##### ##### # ### # ### ####### ##### # ##### # ########### ### # # # ### ### ####### ### # #####
       #   # #   #   #   #   # #   #     # # #   #     #     #           #   #   # #           # # #   #       #     #   #     #
############ # # ### # ### ### # ####### # ### ##### ### ### ##### ####### ##### # # ### # ### # # ### ### ##### ##### ####### #
           # # #   #   # #     #   # #   # #   #   #     #   #   # #     #       #   #   # # #   #   #   # #     #     #       #
 ######### # # ### ##### # ####### # # ### # ### # ####### ### ### # ### ######### ### ### # ####### ### # # ##### ##### #######
         #   #   #     #   #   # # # #     #     #     #   #       # # # #     #   # # #       #   #     # # #     #       #   #
######## ##### ####### # ##### # # # ################# # ### # # ### # # # ### # ### # ######### # ####### # # ######### # # # #
 #     # #     #   #   # #     # # # #     #       #         # #   #   # #   # # #   # #         #     #   #   #       # # # # #
 # ### # # ##### ### ### # ##### # # ##### # ##### ##### ##### ######### ### # # # # # # ############# ######### ##### # # # ###
 # # #   #     #     #           # #   # # #     #   #   #   # #   #     # # #   # # # #   #         #       #   #     # # #   #
 # # ######### ####### ### ####### ### # # ######### # ### # # # # # ##### # ##### ### ### # ########### ### # ### ##### # ### #
   # #                   # #       # # #     #             # #   #   #   #   #     #   # #       #     #   # # # #   #   #     #
#### ### ####### ####### # # ####### # # ##### ######### ### # ####### # # ### ##### # # ### ##### ### ##### # # ### ### #######
   #     # #   #     #   # #     #   # # #     #       #   # #         # #   # #   # #     # #     # # #   # # #   #   # #     #
 ######### # # ##### # ### ##### # ### # # ##### ##### ### # ##### # # ##### # # # # ####### # ##### # # # # # # ##### # # ### #
     #   # # # #   # #   #     # # #   #       # #   #   # #   # # # #         # # #     #   # #       # #   # #       #   # # #
#### # ### # # # # # ### # # ### # # ##### ### # # # ### # ### # # # ######### # # ##### # ### ####### # ##### # ########### # #
     #   #   # # #   #   # # #   # #     # # # # # #   # #   # #   # #     # #   #     #   # # #     #   #   # # #           # #
 ####### ##### # ##### ### # # ### ##### # # # ### # ### ### # ####### ### # ######### ##### # # ### ##### # ### # ########### #
                 #     #   #                 #     #     #   #         #   #                 #     #       #     #             #
################################################################################################################################
