################################################################################################################################
################################################################################################################################
     #         #   #   #   #   #     # #     #   #           #     #     #   #                 #         #     #     #         #
#### # ####### # ### # # # # # # ### # # ##### # ####### ### ### # # ##### # # ############# # # ####### # ### # ### ######### #
     #   #     #   # #   #   #   # #   #       #         #     # # # #   # # # #         #   # # # #   # # # #   # #   #   #   #
 ####### # ####### # ############# ### ### ################### # # # # # # ### ### ####### ### # # # # # # # ##### ### # # ### #
 #   #   # #     #   #                     #     #G        #     #     #           #     #   # # #   #   # #   #   #   # # #   #
 # ### ### # ######### ### ### ### ### # ### ### # ####### ####### ####### ######### ### ### # # ####### # ### # ### ### # # # #
 #   # #   #         #   # #   #   #   #   # #   #     #   #       #     # #   #     #   # # # # #   #   #     #   #   # # # # #
 ### # # ########### ### # # ##### # ####### # ####### ##### ### ### ### # # # # ##### ### # # # # # ########### ##### # # ### #
   #   #   #   #     #   # # #     # #     # # #         #   #   #   #     # # # #   # #   # #   # # #         # #   #   # #   #
## # ##### # # # ##### ##### ##### # # ### # # ######### # ####### ### ##### # # # ### # ### ##### ### ######### # ####### # ###
 # #   #   # # # # #     #   #   # # # # #   #         # # #       #   #     #   #     #     #   # #   #         #       # #   #
 # ### ##### # # # # ##### ### # ### # # ############# # # # ####### ### ######### ####### ### # # # ### ############### # ### #
 # #       # # # #   #   # #   #     # #   #         # #   # #       #   #     #   #       #   #   # #   #               #   # #
 # ####### # ### ##### # # # ######### # ### ####### # ##### # ##### # ### ##### ### ####### ####### # ##### # # ####### ### # #
 # #       #   #       #   # # #     # #       #   #   #   # #   #   #     # #   #   #       #   #   # #   # # # #       #   # #
 # # ##### ### ### ######### # # ### # ####### # # ##### # ##### ### ####### # ##### # ####### # # ### # # # # # # ##### # ### #
 # # # #   # #     #       #   #   # #   #   #   #       # #     #   #   #   #     # #         #         #   # # #   #   #     #
 # # # # ### ##### # ##### ####### # ### # # ############# # ### # # # # ### ##### # ############# ### ####### # ##### # ##### #
 #   # #     #     #   # #       # #   #   # #     # #   #   #   # # # #   # #   # #   #   #     # #   #   #   # #   # # #   # #
 ##### ##### # ####### # ####### # ######### # ### # # # ### ##### # ##### # # # # ### # ### ##### # ### # ##### # # ### ### # #
   #   #   #   #       # #       #           # # # #   #     #     #     #   # # # #   #   # #     # #   #     # # #   #       #
## # # # ##### # ####### # ################### # # ######### # ######### ### # # # ####### # # ### # # ####### ### ### ####### #
 # # #       # # #     # # #         #   #     # #     #   # #   # #     #   # # #             #   # # #   # #     # #     #   #
 # # ##### # # # # ### # # # ####### # # # ##### ##### # # # ### # # ##### # # ######### ####### ### # # # # ####### # ### # # #
     #     # # #   #   #   # #       # #   #   #   # #   # #   # # #     # # #     #     #   #   #   #   #     #   # #   # # # #
###### ##### # ##### ### ### ##### ### ##### ##### # ##### # ### # ##### # # ##### # ##### # ##### ########### # # # ##### # # #
     #   #   #     # # # #   #   #     #   # #   #     # # # #   #     # # #     #   #   # # #     #       #   # # #       # # #
 ### ### # ### # ### # # ### # # ######### # # ####### # # # # ####### # # # ### ### # # # ### ##### ##### # ### # ######### # #
 #   #   # #   # #   #       # # #   #   #   #   #   # # # # #         #   # #       # #   #   #   # #     #   # #   #     # # #
 ### # ### ### # # ########### ### # ### # ##### # # # # # ####### ########### # ##### ##### ##### # # ####### ##### # ##### # #
   # #   # #   # #     #     #     #   #   #     # # # # # #     #   #   #     #     #     # #   # # # # #     #   #         # #
## # ### # # ### ##### # ### ######### ### # ##### ### # # # ### ##### # # ### ##### ##### # # # # # # # # ##### # ### ####### #
 # #   # #   #       # # # #         #   # # #   #   #   # #   #       #   #       #   # # # # # # # #   #     # #   # #   # # #
 # ### # ####### ##### # # ######### ### # # # ##### ### # # ####### ############# ### # # # # # # ##### ##### # ### ### # # # #
 #   # #   #     #   # #   #     # #   # #           #   # # #   # # #   # #     #   #   #   # #         #   # # # #     # # # #
 ### # ### # ##### # # ### # ### # ### # # ########### ### ### # # # # # # # ##### # ########### ##### ### # # # # ####### # # #
   # # #   # #     #     # # #   #   #   #       #     # #     # #   # # #   #     # #       #   #   #     # #   #         # # #
## # # ##### # ########### # # ### # ##### ##### # ##### ####### ##### # ### # ##### # # ### # ### # ### ######### ######### # #
   # # #   # #   #         # # #   #           #     #   #     #       #   #   #   # # #   #   #   # #   #       # #         # #
 ### # # # ### # # ######### # ########### ####### # ### ##### ########### ####### # # ### # ### ### ### # ##### # # ##### ### #
   # #   #   # # #         # # #           #     # # #   #   # #         #     #   #   #   # #   #     # # # #   #       #     #
## # ####### ### ######### # # # ######### # ### ### # ### # # # ##### ####### # ####### ### # ####### ### # # ### ##### #######
   # #   # #           # #   # #   #   #   # # #   #   #   # # # #     #     # #         #   #       # #   # #S#       #   #   #
 ### ### # ##### ### # # ##### ### # # # ### # ### # ### ### # # # ##### ##### ########### # ######### # ### # # ##### ### # # #
 #   #   #         # # #   #   #   # #   #   # # # #       #     # #     #   #       #     #   #       # # #   # #   #   # # # #
 # # # ####### ### # # ### # ########### # ### # # ### ### ####### # ##### # ####### ####### ### ####### # ##### # ##### ### # #
 # # # #   #   #   # #     # #         # #     # #   #   #       #   #   # #     #   #       #   #     # #       #     #     # #
 # ### # # ##### # ######### # # ##### # ####### ### ### ####### ##### # # ### ### ### ####### ####### # # ##### # ### ####### #
 #   # # #     # # #         # # # #   #           # # #   #   # #     #   # #     #         # #   # # # # #   #   #   #   #   #
 ### # # ##### # ### ########### # # ##### ######### # ### # # # # ######### ####### # ####### # # # # # # # # ##### ### # # ###
 #   # #     #   #   # #       #   #     #   #       #     # #   #   #         #     # #       # #         # # #   #   # #   # #
 # ### ##### ### # ### # # # # ######### ### # ##################### # ####### ######### ######### ######### ### # ##### ##### #
 #     #     #   #   #   # # # #           # #   #   #     #       # # #       #         #         #   #   #     # #     #     #
 ####### ### ####### ##### # # ########### # ### # # # ### # ##### # ### ####### ######### ######### # # # ####### # ##### #####
 #         # #     #   #   # #         # # # #   # # # # # # #   #   #   #     #       #         #   #   #     #   #           #
 ### # ### ### ### ### ##### ######### # # # # ### ### # # # # ####### ### ### ####### # ####### # ####### ##### ### ######### #
 #   #   #   #   #   # #   # #   #     # # #     #   # # #   #               #     #   # #       #   #   #     # #   #       # #
 # # ### ### ### ### # # # # # # # ##### # ##### ### # # ##### ### ######### ##### # ### # ######### # # ##### # # ### ##### ###
   #   #   #   # #   #   # #   # # #       #   #     # #     #   #         # #   #       #   #       # # #   #   # # # #   #   #
######## # ### ### ####### ##### # ### ##### # # ##### # ####### ######### ### # ##### # ### # ######### ### ##### # # # # ### #
         #   # #   #     # #     #   #       # #       # #               #     # #   # #   #   #   #     #     #     # # #     #
 ######### # # # ### # ### # ####### ######### # ####### # ########### # ####### # # # ### ##### ### ##### ### # # ### # # #####
 #     #   # # # # # # #   # # #   #     #   # #       # #     #   #   #   #   #   # #   #     # #   #     #     #   # # # #   #
 # ### # ### # # # # # # ### # # # ##### # # # ####### # ### ### # ### ##### # ##### # # ##### # # ############### # # # ### # #
 # #   # #   # # #   # #     # # #     # # #       # # # #   #   #   # #   # # #     # # #     # #   #     #     # # # #   # # #
 # # ### ### # # ### ######### # ##### # ######### # # # # ### ##### ### # # # # ##### # # ##### ### # ### # ### # # # ### ### #
   # #     # # #   #     #     #     # #   #   #   #       #   #     #   # # # # #   # # # #       #   # # # # #   # #   # #   #
#### ##### # # ### ##### ##### ##### # ### # # # ### ####### ### ##### ### ### # # # # ### ####### ##### # # # ##### ### # # ###
   #   #   # #     #   # #   #     # #   #   # #     #       # # #   #   #   #   # # #   #       #         # #       # # # # # #
 ### # # ### ####### # # # # ### ### ######### ##### # ####### # ### ### ### ##### # ### ####### ######### # # # ### # # # # # #
   # # #   # #       # # # #   # #     #   #         #       # #     #   # #     # #     #       #   #   #   # #   #   # #   # #
## # # ### ### ####### # # ### # # ##### # ######### ####### # ####### ### ##### # ####### ####### # # # ####### # ##### ##### #
   # #   #   # #     #   #   #       #   #     #       # #   #       # # #   #   #     #   #       # # #       # # # #   #     #
 ####### ### # # ### ######### ####### ####### ####### # # ######### # # ### # # ####### ### ####### # ####### ### # # ##### # #
 #     # #   # #   # #         #         #   # #     # # # #       # #       # # #     # #   # #   # #   #   #   #   # #     # #
 # ### # # # # ##### # # ##### # ######### # # # ### # # # # # ### # ### ##### ### ### # # ### # # # ### # # ### ##### # ##### #
   # #   # # #   #   # #     # #     #     # # # #   #   # # # # #   # # #     #   #   # #   # # # #   # # #       #   # #   # #
#### ##### ##### # ### ##### ####### ####### # # ### ### # ### # ### # # # ##### ### ####### # # # ### # ######### # ##### # # #
   #       #   # # #     # #       #   #   #   #   # #   #     #   # # # #       # #       # #   # #   #         # # #   # #   #
 # # # ### # # # # ##### # ##### ##### # # ##### # # # ########### # # # ######### ####### # ##### # ############# # # # # #####
 # # # #   # #   #     #       #     #   #     # # # #             #   #     #   #   #     #       #   #           #   # #     #
 # ### # ### ######### # ########### ######### ### # ##### # ### # ### ##### # ##### # ############### # ############### # ### #
 #     # #   #   #     # #               #   #   # #     # #   # #         # #     #   #         #   # # #   #   #         #   #
 ####### # ### # # ##### # ######### # ### # ### # ##### ####### ######### # ##### ####### ##### # ### # # # # # # ######### ###
 # #     # #   # #   #   #       #   #   # #   # #     # #       #   #     # #   #         #   #   #   # # #   #   #     #   # #
 # # ### # # ### ### # ######### ##### # # ### # ##### # # # ##### # # ### # # # ##### ### # # ##### ### # ######### ### # ### #
 #   #   #   #   #         #     #   # #   #   #       #   # #   # #   #   # # # #     #   # #   #   # # # #         #   #     #
 ##### ####### ### ####### # ##### # # ##### ################# # ####### ### ### # ##### ### ### # ### # # # ############# #####
     # #       # #       # #   #   # # #   #     #       #     # #       #   #   #   #     # #   #   # # # #           #   #   #
 ### ### ####### # ##### # ### ##### # ### ##### ##### ### ##### # ##### # ### ##### # ##### ####### # # # ########### # # # # #
   # #   #     #   #     #   #   #   #   # #   #     # #   #     # #   # #   #       # # #   #   #   #   #       #     # #   # #
 # # # ### ### # ### ####### ### # ##### # ### ### ### # ### ##### # # # ### ######### # # ### # ### ### # ##### # ##### ##### #
 # #   #     #   #   #   #     #   #   # # #   # #   # #   #       # # #   # #   #   # # #   # #   #   #   #     #   #     #   #
## ##### ### ### # ### # ########### # # # # ### ### # ### ##### ### # ### # # # # # # # ### # ### ### # ### ####### ### ### # #
   #       #   # #     #   #         # #   # #     #   # # #   # #   # #   #   # # # #   #   # # # #       # #     #   # #   # #
 ### ##### ### # ######### # ######### # ### # ######### # # # ### ### # ####### # # # ### ### # # # ##### ### ### ### # # ### #
     #   # # # #       #   # # #     # #       #   #     #   #       # #   #   # # #   #   # #   # # #   #     # #     # #   # #
 ##### # # # # # ####### ### # # ### # # # ##### # ##### ############# ### # ### ### ### ### ##### # # # ####### ####### ### ###
   #   # # #   # #   #   #   # # # # # # #   #   #     # # #           # # #   #   #   #       #   #   # #     #           #   #
 ### ##### ####### # # # # ### # # # # # ##### ####### # # # ########### # ### ### ### ####### # ####### # ### ##### # # # ### #
     #   #         # # # #     # # #   #       #     #     #   # #         #     # #     #     #   #     # #   #   # # # # #   #
###### # ########### # ######### # ##### ######### ######### # # # ######### ##### # ### # ####### # ##### ##### # ### # # # ###
     # #             #       #   #   #             #       # #   #   #       #   # # #   #       #   #   #   #   #     # # #   #
 ### # ##################### # ### # ####### ### ### ##### # ##### ### ####### # # # # ######### ##### ##### # ######### ##### #
 #   #     #   # #   #     #   #   #   #   #   #   #   #   # #   # #   #       # # # #         #   #     #   # #         #   # #
 # ####### # # # # # # ######### ##### # # ### ### ### # ##### # # # ### ######### # ######### ### ##### # ### ##### # # # ### #
 #   #     # #   # #   #           #     #   #   # #   #       #       # #   # #   # #   #       #     # #   #     # # # #   # #
 ### # ##### ##### ####### ##### # # ####### ### # # ################# # # # # # ### # ### ########### # ### ##### ### # ### # #
   #   #   #     #         #     # #   #   #     # # #   #     #       #   #   #     #     #         # #   # #   #   # #     # #
 # ##### # ##### ######### # ##### ### # # ####### # # # # ### # ##### ##### ######### ##### ##### ### # ### # # ### # ####### #
 #   #   #     #         # # #   #   # # # #     # # # #   #     #   #     # #             # #     #   # #   # #   # #       # #
 ### # ####### # # ##### # # ### ### ### ### ### ### # ########### # ##### # # ########### # # ##### ### # ### ##### ### # ### #
   # # #   # # # #   #   # #   #   # #   #   # #     #         #   #         #   #     #   # # #   # #   # # #       #   # #   #
## # # # # # # # ### # ### ### # ### # ### ### ############### ####### ##### ### # ### ##### ### # # # # # # ##### ######### # #
 # #   # #   # #   # # #   #   # #   #     # # #   #         #     #   #           #   #     #   # #   # # #   #   #         # #
 # ##### ##### ### # # # ### ### # # ####### # # # # ####### ##### # ### ######### ##### ##### ### ### ### ### # # # ######### #
 #     # #     #   # # #   #     # #         #   # #   #   # #   # #   #     #     #   #     #   #   # #   #     # #     #     #
 # # # # # ### # ### # ### ####### ######### # ####### # ### ### # ########### ### # # ##### ### ### # # ######### ##### # #####
   # # # #   # # #   #           #         #   #       #   # #   # #       #   #   # #     #   #   #   #   #     # #     #     #
#### ### ##### # # ############# ######### # ### ####### # # # ### # # ##### ### ### ######### ### ####### # ### # # ###########
 #     #   #   # # #           #   #   #   # #   #     # # #     #   # #   #   #             #   # # #   #   #   # #   #       #
 # # # ### # ##### # ######### # # # # # ##### ### ### # ####### ####### # ############# ### ### # # # ####### ### ### # ##### #
 # # # # # #     # # #         # # # # # #   #   #   # # #     #   #   # #       #     # #   # # # # #       # #     #   #   # #
 # # # # # ##### # ### ######### # ### # # # ### ##### # # ### ##### # # ####### # ### ### # # # # # ####### # ########### # # #
   # #   #       #     #         #     #   #             #   #       #   #         #       #                               #   #
################################################################################################################################
