################################################################################################################################
################################################################################################################################
   #     #   #   #           #     #       #                 #       #       #   #     #         # #               #           #
 # # # # # ### ### # ####### ### # # ##### # ####### ####### # ##### ### ### # # # ##### ####### # # # ### ##### ### ######### #
 #   # # #   #   # #       # #   # #     # # #     # #     # #   # #   #   # # # #       #     # # # #   # #   #   # # #       #
 ##### # ### ### # ####### # # ### ####### # # ### # # ##### ### # # # ##### # ########### # ### # # ### ### # # # # # # #######
 #     #   # # #         # # # # #     #       #   # # #   # #   # # #     # #   #         # #   # # # #   # # # # #   #   #   #
 # ####### # # ### # ##### # # # ##### # ##### ##### # # # # # ### # ##### # # # # ######### # ### # # ### # # ### ##### ### # #
 # # #   # #       # #     #   # #   # # #   # #   #   # # # #   # # #     # # # #         #           #   # # #   #   # #   # #
## # # ### ### ### # # ######### # # # # # # # # # ##### # ##### # ### ##### # ### ################### # # # # # ### # # # ### #
   #           #   # #       #     # # # # #   # #       # #   # #     #   #   #   #     #   #     #   # # # # #     #   # # # #
 ### ####### # # ### ####### # ####### ### ### # ########### # # ####### # ### # ### ### # # # ### ### # ### # ########### # # #
 #   #   #   # # # #       # # #         # #   #   #     #   # #   #     #     # #   #   # #   # #   # #     #           #   # #
 ##### # # ### # # # # ### # # # ####### # ### ### ### # # ####### # # ######### # ### ### ##### ### # ################# ##### #
     # # # #   # # # # #   # #   #     #   #   # #   # # #     # #   # #     #   # #       #       # # #       #       #     # #
 ### # # ### ### # # # ##### ### # ### # ### # # ### ### ##### # ##### # ### # ### ############### # # # ##### # ##### ##### # #
   # # #   #   # # # # #   #   # # #   # #   #     #     #   # #   #   # #   #   # #   #     #   # # # # #   # # #   # #     # #
 ### # ### ##### # # ### # ### # # # ### # ####### ##### # ### # ### ### # ##### # # # # ### # # # # ### # ### # ### # # ##### #
 #   #   #     # #   #   #   # # # #   # #   #   #   #       #   #     # #     # #   #   # #   # #       #   # #   # # #       #
## ##### ##### # ### # ##### # ### ### # ### # # # # ### ### ### # ##### ####### ######### ##### ########### # ### # # ####### #
   #   #   # # # #   #     # #     #   #   # # # # #     #   # # #   #   #                     #   # #   #   #     # #       # #
 ### # ### # # # ######### # ##### # ##### # # ### ####### # # # ### # ### # # # ### ######### ### # # ### ######### ####### # #
 #   #   # # # # #     #   #     # #     # # # #   #       #   # #   # #   # # # #   #     #     # #           #   #   #   # # #
 # ####### # # # # ### # ####### # ##### ### # # ### ######### # # ### # ##### # # ### ##### ### # ########### # # ### # ### # #
 # #       # #   # # # # #     # #     #   #   #   # #   # #   # # # #   #     # #     #     # # #         #   # # #  G# #   # #
 # ### ##### ##### # # # # ### # # ####### ######### ### # # ### # # ### # ##### ####### ##### # ######### ### # # # ### # ### #
 #     #         # # #   #   # # # #     # #   #   # #   #               # #   #     # # #     #     #   #   #   # #     # #   #
 ####### ##### # # # ####### # # # # ### # # ### # # # ### ### ### ####### ### ##### # # # ######### # # ### # ######### # # # #
             # # # # #   #   # # # # #   #   #   #   #     #   #   #     #     #     # #   #   # #S  # #     #         # # # # #
 ########### # # # # # # ##### # # ### ####### ####### ##### ### # # ### ##### # ##### ##### # # # ### ####### ######### # ### #
 #   #   #   # # # # # #       # #         #   #   #   #   # #   # # # #     # #         #   # #     #     #       #     #   # #
## # ### # ### # # # # ######### ####### ### ### # ##### # ### # ### # ##### ########### # ### ### ####### ##### ### ####### ###
   #   #   #   # # #   #       # #     #   #     # #   # #   # # #   # #   #           # # #     #   #   #     # #   #     #   #
 ##### ##### ### # # ######### # # ### ### ####### # # # ### # # # ### # # ########### # # ##### # # # ####### # # ### ####### #
   # # #     #   # #           # # # #   #   #     # #   #   # # # #   # # #     #   # # #     #   # # #       #     #   #     #
## # # # # ##### # ### ####### # # # ### ##### ##### ##### ### # # # ### # ### # ### # ######### ##### # ########### ### # #####
   #   # #     # # # # #       #   #   # #     #     #   #   # # # #     #     #     #     #     #     # #             # # #   #
 ############# # # # # # # ### ####### # # ### # ####### ### # # # ####### ######### ##### # ##### ##### ##### # ### ### # # # #
   #     #     # # #   # # #           #   # # #   #   #   #   # #   #     #     #     #   # #     #   #     # # # # #   # # # #
## # ### # ##### # ### # # # ######### ##### # ### # # ### ### ##### # ##### ### ##### # ### # ####### ##### # # # # # ### # # #
 # #   # #   #   #   # # # # #       #   # # #   #   #   #     #   # # #   #   #   #   # #     #     #   #   # # # # # #   # # #
 # ### # ### ####### ### ### # ##### # # # # ### ####### ####### # # # # # ####### # ### # ######### # ### ### # # # # # ### ###
   #   #   #       #   #   # # #   #   # #             #   #   # #   # # #       # # #   # #   #   # # #   #   #   # # # # #   #
 ### ##### ######### # ### # # # ####### # ########### ### # # ####### # ####### # # # ### # # # # # # # ########### # # # # # #
 #   #     #       # # # # # # #           #         #   # # #     #   # #   #   #   # # # # #   #     #     #     #   # # # # #
 # ### ##### ##### ### # # # # ############# ####### ##### # ##### # ### # ### ### ### # # # ######### ##### # ### # ### # # # #
 # #   #       #   #   #   # #             #       #   #   #   #   # #   #     #             #     #       # #   # # #   # # # #
 # # ### ##### # ### ### ### ############# ########### # ##### ####### ######### ############# ### # ##### # ##### # # ### # ###
   # #   #     #     #   #     #     #           #     #     #       #       #   #         #   #   #   #   #   #   # #   # #   #
#### ##### ########### # # ##### ##### ##### ### # ######### ####### ####### # ### ####### # ######### ####### # ### ### # ### #
     #     #           # #       #   # #   # #   #   #     #       #   #     #     #     #   #     # #     #   #     #   #     #
 ##### ####### ### ##### ######### # # # # # ####### ### # ####### ### # ##### ##### ### # ### ### # ##### # ### ##### ### #####
       #       #   #       #       #   # # #       #   # #     #   #   #   # #       #   # # #   # #       #   # #     #       #
######## ##### # ### ####### # ######### # ##### # ### # ##### # ### ##### # # ####### ### # ### # ##### ##### # # ####### ### #
     #   #     #   # #   #   # #   #     #     # #   # # #   # # #   #     #   #   #   #   #   # #     # #     # # #     #   # #
 ### # ### ### ### # # ### ##### # # ######### # # # # # # # # ### ### ##### ### # # ### ##### # ##### # # ##### # # ### ### ###
   # # #     #   # # #   # #     # # #   #   # # # # # # # # #   # #   # #   #   # # #       # #   # # # #     #   # # # #     #
#### # ######### # # ### # # ##### # # # # # # # # # # # # # ### # # ### # ####### # ##### ### ### # # ######### ### # # ##### #
   # # #         # #     #   #   # # # # # #   # # # # # # #   # #     #   #     # # #   #       # # #     #     #     #     # #
 # # # # ####### # ##### ##### ### # # # # ##### # # # # # ### # # ### # ####### # # # # ######### # ### ### ############### # #
 #   # #   # #   #     #       #   # # #   #   # # # # # #   # # #   #     #     # #   #           #   #     #     #   #       #
#### # ### # # # ##### ##### ### ### ####### # # # ### # # # ### # # ### # # ##### ################# # ####### ### # # ####### #
     # #   #   #     #     #   # # #       # #   #   # # # #     # #   # # # #   #   # #   #     # # #   #   #   # # #       # #
 ##### # ####### ######### ### # # ####### ######### # # # ####### ### # # # # # ### # # # ##### # # ### # # ### # # ####### # #
 #   # #   #   #       # #   # # # #   #   #       # # # #   #     #   # #     #   # #   #     # # #   # # #   # #     #     # #
 # # # ##### # # ##### # ### # # # # # # ### ##### ### # ### # ##### ######### ### # ######### # # ### # # ### # ####### ##### #
   # #     # # #     # #   # # #   # # # #       #   #   # # #   # #         # #   #   #     # #   #   # #   # #   #   # #   # #
#### ##### ### # ### # ### # # ##### ### # # ### ### ##### # ### # ######### # # ##### ### ### # ### ### ##### ### # # # # ### #
     #   #     # #   #     # #   #   #   # # #     #         # # #     #   # # #     #   #             # #   # #   # # # #   # #
#### # ######### # # ####### # # # ### ### # ##### ########### # # ### ### # ####### ### # ############# # # # # ##### # # # # #
   # #           # #   #     # #   #   #   #     #   #   #       #   #     # #     #             #     # # #   # #   #   # #   #
 # # ### # ### # # ### # ##### ##### ##### ##### ### # # # ### ### # ### ### # ### ####### # ### # ### # # ##### # # ##### #####
 # #     # #   # #   # # #   # #   # #   # #   #   # # # #   #     #   # #   # # #     # # #   #   #   #   #   #   # #         #
 # ##### # # ### ### ### # ### # # # ### # # # ### # ### # # # ####### ### ### # ##### # # ######### ### ##### ##### ### ##### #
 #     # # #   #   #   # #     # # # #   # # #     #       # #     #   #   #   #     # # # #     #   #         #   #   # #     #
 ##### ### ### # ##### # ### ### # # # ### ############# ### # ### ##### ### ### ##### # # # ### # ##### # ##### # ### # # #####
 #     #     # # #   # #   # #   #   # #   #   #       # #   #   #   #   # # #       # # # # #   # #   # #       #     # #     #
 ####### ##### ### # # ### # # ####### # ### # # ##### # ####### ### # ### # # ##### # # # # # ### # # # # ### # ####### ##### #
   #         #   # # #   # # #   #   #     # # # #   # #       # #   #     # # #   # # #   # #   #   # # # #   #         #   # #
## ### ##### ### # ####### # ### # # ### ### # # # ### # ##### ### ######### # # # # # ##### ### ##### # # # ### ######### # ###
 #   #     #   # #   #     #   #   #   # #   #   #   # #     #   #   #     # # # # # # #     # #       # # # #   #         #   #
 ### ########### ### # ####### ####### # # ######### # ######### ##### ### # # # # ### # ##### ######### # # # ### ########### #
   #           #     #     #   #     #   #     #     #       # #     #   # # # # # #   #   #   #         # # #   #   #   #     #
 ############# ########### # ### ### ### ##### ### ####### # # ##### # ### # # # # # ##### # # ######### ### # # ### ### # ### #
 #   #     #   #     #     # #   #   #       #   # # #   # # #   #   # #   #   # # # #     # #     #   #   # # #     #   #   # #
 # # # ##### ### ### # ##### # ############# ### # # # # ### ### # # # # ##### # # # ####### ##### # # ### # ### ##### ##### ###
   #   #   #     # # # #     #             #   # #   # #   #   # # # # # #     # # #     #   #   #   #     #   #           #   #
 ####### # ####### # # # # ############### # ### ### # ### ### # # ### # # ##### ####### ##### # ############# ### ##### # ### #
 #     # #     #   #   # #       #   #   # #   #     # #       # #     # # #   #       #   #   # #           #   # #     #   # #
 # ### # # ### # # ##### ### ##### # # # # ### ##### # ######### ####### # ### ####### # # ##### # ######### ### # # ##### # # #
   #     # #   # #         #     # # # # #       #   #     # #       # # # #   #     # # #   #   #   # #     #   # # #     # # #
#### # ### # ######### # ####### ### # # ####### # ####### # # # ### # # # # ### ### # # ### # ##### # # # ### ### # ######### #
 #   # #   #           #       #     # # # #   # #     #   #   #   #   #   #   #   # # #   # # #   # #   # #   #   #     #   # #
 # ##### ##### ########### ############# # # # # ##### # ### ##### ### ####### ### # # ##### # ### # ##### # ### ####### # # # #
   #     #     #   #       #           # # # # #   # # # #   #   #   #   #   # #   # #   #   #       #   # # #   #   #   # # # #
## # ######### # # # ####### ######### # # # # # # # # # ##### # ### ### # # # # ####### # ### ####### # ### ##### # # # # ### #
 # # #       # # # # #   #   #             # #   #   # # #   # #   #   # # # # #       # # #   #     # #   # #     #   # #   # #
 # # # ##### # # # # # # # ##### ########### ####### # # # # # ### ### # # ### ##### # # # ### # ### # ### # # ####### ##### # #
   # # #   # # # # #   # #     # #         #       # # #   # #   # #   #     # #     # #   #   # # #   # #   # #     # #   #   #
#### # ### # # # # ##### ##### # # ####### ######### # ##### ### # # ####### # # ##### ##### # # # ##### ##### # ##### # #######
   #       # # # #     #   #   # #   #     #     #   #     #     # # #   #     # #     #     # #   #     #     # #     #       #
 # # ####### ### ######### # ### ### # ##### ### # ### ########### ### # ##### # # ##### ### # ####### # # # # # # # ######### #
 # # # #     #   #   #     # #   #   #       #         #       #   #   #     # # #       #   #         #   # # #   # #       # #
 # # # # ##### ### # # ####### ### ########### ######### ##### # ### ####### # # ### ##### ### ############# # ##### # ### ### #
 # #   # #     #   # #         # #         #   #         #     #     #   #   #   #   #   # #   #       #   # # #     # # #   # #
 # ##### # ##### ############### ########### ### ######### ##### ##### # # ########### # # # ### ##### # # ### ####### # ### # #
 # #   #   #                 #   #   #       #   #   #   # #   # #     # #         #   # # #   # #     # #   # #       # #   # #
 # # # ### # ######### ### # # ### # # ##### # ### # # # # # # ### ##### ######### # ### ##### # # ######### # # ####### # ### #
 # # #   #     #     #   # # #   # # #     # # # # #   # #   #     #     #     # #     #     #   #   #     # #   #       #     #
 # # ### ##### # ### ##### ##### ### ####### # # # ##### ########### ##### ### # ########### # ##### # ### # ##### ##### #######
 #   # #     # #   #     #       #   # #   # # #   #   #           # #   # #   # #   #       #     #   # #   #     #     #     #
 ##### ##### # ### ##### ##### ### # # # # # # ### # ##### ##### # # # # # # ### ### # ####### ### ##### ##### ##### ##### ### #
   #       # #   # #     #   #   # # # # # #       #       #   # # #   #   # # #     # #     #   # #       #   #   #   #   #   #
 # ##### ### # ### ##### # # ### # # # # ### ############### # # ########### # ##### # ##### # ### # ##### # ### ##### # ### ###
 #   #   #   #   #     #   # #   # # # #     #     #         # # #         # #       # #     # #   # # #   #   #       # # #   #
#### # # # ##### ##### ##### # # ### # ####### ### # ######### # # ####### # ####### # # ##### # ### # # ####### ####### # ### #
     # #       # #   # #     # # #     #     # #   #   #       # #   #   # #       # # #     # #     #   #     #   #     # #   #
 ### ######### # # # # # ##### ### ##### ### # # ##### # ####### ### # # # ####### # # ##### # ############### # # # ##### # ###
 #   #     # # #   # # # #   #     #   # # # # #   #   # #   #     # # #   #       # # #     #               # # #   #     #   #
 ##### ### # # ####### # # # ####### # # # # # ### # ### # # ####### # ##### ####### # # ##### ##### ####### # # ##### ### ### #
 #     # #   #         #   #         #   # #   # # # # # # #       # #   #     # #   #   #         #   #   #     #       # #   #
 # ##### ################################# ##### # # # # # ####### # ### # # # # # ####### # # ####### # # ##### # ##### ### # #
   #   #         #     #     #                   #   # # # #     #   # # # # # # #   #     # #       # # # #   #   #   # #   # #
#### # # ######### ### ### # ### # ##### ##### # ##### # # # ######### # ### # # ### # ### # ####### # # # # # ### # # ### #####
     # #   #       # #     #     # #   # #     #     # # # #       #   #   # # # # #   #   #   #   # #   #   #   # # #   # #   #
 ######### ### ##### ########### # ### # # ######### # # # ####### # ##### ### # # ### # ####### # # ########### ### ### # ### #
               #                 #     # #         #       #                   #       #         # #           #     #   #     #
################################################################################################################################
