################################################################################################################################
################################################################################################################################
# #   #       #   #       #         #   #         #     #                             #             #     #   #     #   #   #   
# # # ##### # # ### ##### # ##### # # # # ##### # # # # # ### ############### ######### ########### # ### # ### ### # ### # # # 
#   #       # #   #     #     #   #   #     #   #   # # # #   #     #   #   #   #       #   #       # #   #   # # #   #   #   # 
############# ### ##### ####### # ########### ####### # # # ### ### # # # # ### # ####### # # ####### ####### # # ##### ####### 
#     #   # # #   #   # #   #   # #   #     # #     # # # #   # # # # # # #   # # #   #   # # # #   # #     # #   #     #       
### # # # # # # ### # # # # # ##### # ##### # # # # # # # ### # # # # # # ### ### # ### ##### # # ### # ### # ### ##### # ######
#   #   #   # #     # #   # #   #   #     # # # # #   # #   #   # #   #   # #     #       #   #           #     #       # #     
# ######### # ##### ####### ### # ####### # # ### ######### ##### ######### ####### ##### # ### ######### ############### # # # 
# #       # # #   #       # #   # #   #   #   #   #       # #     #   #     #       #   # # #     #     # #     #     #   # # # 
### ##### # # # # ##### # # # ### # ### ####### ######### # ### ### # # ##### ### ### # ### # ### # ### # # ### # ##### ##### # 
#   # #   # # # # #     # # #   # #     #       #     #   #   # #   #   #     #   #   # #   # #   #   #   # # #   # #   #     # 
# # # # ### # ### # ##### # ### # ####### # ##### # ### ##### # # ####### ##### ### ##### ### # ##### ### # # ##### # ### # ### 
# # # #     #   # # #       #   #     #   #       #     #     # #   #   # #   #   #     #   # #   # #   # # #       # #   # # # 
# ### # ####### # # ##### ########### ### ############### ##### ### # ### # # ### ##### ### # ### # ### # # ##### # # ##### # # 
# #   # #     # #   #   #           #   #               # #         #     # #   #   # #     #   #   #   # #       # #     # #   
# # ### # ##### ##### # ### ########### ####### # ####### # ################# ##### # ############### ### ######### ##### # # ##
#   #   #     # #     #   # #         #   #     #   #     # #   #   #         #   # #           #   #   # #   #         #   #   
# ### # ##### # # ####### # # ########### # ####### # ##### # # ### # ####### # # # # ##### ### # # ### # # ### # # ### ####### 
# #   #       #   #     # #   #   # #     # #     # #     #   #   # # #         # # # #     #   # #   # # # #   # #   #     #   
# # # ####### ##### ##### # ### # # # ##### # ### # ##### ####### # # ######### # # ### ##### ####### ### # # # # ### ##### # ##
# # # #       #           #     # # #   #   # # # #     # #       # #   #     # # #     #     #     # #   #   # #   # #   # # # 
# # ### ##### # ##### ########### # ### # ### # # # ##### # ####### ### # ### # # ####### ####### # # # ##### ####### # ### # # 
# #   #     #   #   #   #       # #   # #     #   # #     #     # #   # #   # # #       #S#   #   # # #       #   #   # #   #   
# ### ##### ##### # ### # ##### # # # # ############# ######### # ### ####### # ### ##### # # # ### # ####### # # # ### # ##### 
# #   #     # #   #   # #   # # # # # # #             # #   #   #   #   #         # #   # # # # #   #       # # #   #         # 
### ### ##### # ##### # # # # # # # # # # ############# # # ### # ##### # ##### # ### # # # # # # ######### # # ############# # 
#   # #       # #   # # # # # # #   #   # #   #   #   #   #   # #         #   # # #   # # # #   # # #   # # # #       #     #   
# ### ######### # # # # ### # # # ##### # # # # # # # ####### # # ####### # # # # # ##### # ##### # # # # # ######### # ####### 
#           #   # #   #   # # # # #   #   # #   # # #   #     # # # #   # # # # #     #   #   #   #   #   #   #     #   #       
# ########### ### ####### # # # ### # ### # ##### # ### # ##### # # # # ### # # ####### ####### ### ######### # ### ##### ##### 
#     #       #   #     # #   #   # #   # # #   # # # # #   #   #   # # #   # #         # #   # #     #       #   # #   #     # 
# # ### ####### ####### # ####### ##### # # ### # # # # ### # ##### # # # ### # ######### # # # # # ### ########### # # ####### 
# # #   #   #   #   #   #       #   #           #   #   #   #       # # # #   #             #   # # #   #         #   #   #     
# ### ##### # ### # ### ####### ### ##### ####### ####### ######### # # ### ### ####### ######### ### ########### ####### # ####
#   #       #     #   #       #   #   #   #     #       # #   #   # # #     #   #     #               #         # #       #     
# # ################# ####### ### ### # ### ### ##### # # ### # # # # ######### # ### ### # # ######### # ### # # # ####### ### 
# #           #       #                   # #   #     # #   # # #   # #     #   # #   #   # #     #     #   # #   # #         # 
######### # ### ####### ######### ##### ### # ######### ### # # ##### # ### # # # ######### ##### # ####### ##### # # ####### # 
#       # #   #     #   #       #     #     #   #   #         #       #   # # # #         # #     #   #   #     # # # #     # # 
# ##### # # # ##### # ### ##### # ### ######### # # ####### ### ########### # ########### # # ####### # ####### # # # # # ### # 
# #     # # #   # # # #   #     #   #   #   # #   #       #         #     # #   #         # #         #       # #       # #   # 
### ##### ##### # # # # ############### # # # ########### ##### ### # ### # ### # ######### ####### ### ##### # ##### ##### ### 
#   #     #   # # #     #   #       # #   # #     #     #     # #   # #   #     #     #   # #     #   # #     #     # #     #   
# ### ##### # # # ##### # # # ##### # ##### # # # # ### ##### # # ### # ############# # # # # ### # # # # ##### ### ### ########
# #   #     # #   #     # # # #   # #       # # # #   #     # # #     # #         #   # # #   # # # #   # #   # #   #   #   #   
# ### # ##### ##### ### # # # # # # # ######### # ### ####### ######### # ####### # ##### ##### # ####### # # ### ### ### # # # 
#     #     # #   # #   # #   # # # # #       # #   # # #     #       #   #     #   # #   # #   # #     # # #     #   #   # # # 
##### ##### # # # # # ### ##### # # ### ##### ##### # # # ##### ##### ####### # ##### # ### # ### # ### ### ####### ### ### # # 
#       #   #   # # #   #       # # #   #   # #   # #   # #     #   #   #     #       #   # # #   # #   #   #         #   # # # 
### ##### ####### ##### ######### # # ### # # # # # ### # # ####### ### ######### ####### # # # ### ##### ### # ### # ### # ### 
#   #     #     #   #       #     # #   # # # # # #     # # #   #     #       #   #   #   #   # # #       #   #   # #     #     
# ### ######### ### # ####### ##### ### # ### ### # ##### # ### # # ######### # ### # # ### ### # ############### ##############
#   #   #   #     #     #     #     #   #   #   #   #   #   #   # # #   #     #     # #   # #   #   #         #   #             
####### ### # ##### ##### ##### ##### ##### ### ### # # ##### ##### # # # ##### ##### ### # # ##### # ####### # ### # # ####### 
#     #   # # #     #   # #     #   # #   #   # #   # # #           # # # #   #     #       # #   # #   #   # #     # #   #     
# ### ### # # # ##### # # # ##### # # # ##### # # ### # # ########### # # # # # ##### ##### # # # # ### ### # ####### # # # ### 
#   # # # #         # # # #     # #   # #     # # #   # #   # #       # #   # #     # #   # # # # #   #   # #         # # #   # 
# # # # # ####### ### ### ####### ##### # ##### # # ### ### # # ####### ##### # ### ### # ### ### ### ### # ########### # ### # 
# # # #   #     # #   #   #   #             #   #     #     # #   #     #   # # # #     #   #   #   # # #   #     #   # #   # # 
# # # ##### ### # # ### ### # # ##### ####### ####### ####### ### # ### # ### # # ######### ### ### # # ##### ### # ### ### # # 
# # #       # # #           #   #   #   #     #   #     #     #   # #   #     # #   #     # # # #     #   #     # # #   #   # # 
# # ######### # # ##### ##### ### # ### # ##### # ##### ### # # ### ### ####### ### # ### # # # ### ##### # # # # # # ### ### # 
# # #   #   #   # #   # #   # #   #   # #   #   #   #       # #   #   #       #   # #   #   # #   #     #   # # #     #     # # 
# # ### # # ### ### # ### # # # ##### # ### ####### ######### ### ### # # # ##### # ### ##### ### ##### # ### # ########### # # 
# #     # #   #     # #   # # # # #   #   #       #       # # #   # # # # # #   #   # # #   # #   #     # #   #   #       # # # 
# ####### ### ####### # ### # # # # ##### ####### ####### # # # ### # # # ### # ### # # # # # # ### ####### ####### ##### ### # 
# # #     # #   #   # #   # # # # #     #     #   #     # #   #   # # # # #   #   #   #   # # # #   #   #   #     #   #     # # 
# # # ##### ### # # # ##### # # # ##### # ### # ### ##### # ##### # # ### # ##### ### ##### # # # ### # # ### ### ### ##### # # 
#   #   #   #     #             #       # #   #   #     # #         #   # # #   #   # #   # # # # #   # #   # # #   #   # #   # 
####### # ### ####### ####### ############# ##### ### # # # ########### # # # # ### # ### # # # # ### # # # # # ### ### # ##### 
#       #     #     # #   # # #   # #     #     #   # # #   #   #   # # # #   # # # #     # # # #     # # # # # #   #   #   #   
# ####### ##### ### ### # # # # # # # ### ######### # ### ### # # # # # # ##### # # # ##### # # ####### ### # # # ### ### # # # 
# #   #           # #   # #   # # #   # #     #     #     #   #   # # # #     # # #   #   #   #       #     # # #     #   # # # 
# # ### ####### ### # ### ##### # ##### ##### # ######### # ####### # # # ##### # ##### # ########### ### ### # ####### ### # # 
# #     #     # #   # # #       # #           #   #     #   #     # #   # #     # #   # #         #   #   #   #         # #   # 
# ####### ### # # ### # ######### # ############# # ### # ### ##### ### ### ##### # # # ########### ### ### ########### # ##### 
#   #   # #   # #               # # #     #       # #   # #       # #   #   #     # # #       #     #   #   #   #       # #     
# # # # # # ### ################# # ### # # # # ### ##### ####### # ##### ### ### # # ####### # ##### ### ##### # ####### # # # 
# # # # # #   #   #   #         # #     # # # #   #   # #     #   #       # # # # # # #   #   #     #   #     # #   #     # # # 
# # # # # ### ### ### # ####### # ####### # # ### ### # ##### # ########### # # # # # # # # ####### ##### ### # ### # ##### # ##
# # # # #   # #   #   # #     #   #   #   # #   # #   #   #   #   #     #   #   # # #   # #         #   # #   # #   #     # #   
### # # ##### # ### ### # ### ##### # # ### ##### # ### # # ### # ##### # ##### # # ##### ########### # ### ### # ####### # ### 
#   # #   #   # #     # # #   #   # # #   # #   # #     # #     #         #   # #   #   #           # #     # # # #   # # #   # 
# ### ##### ### ##### # ### ### # ### ### ### # # # ##### # ##### ####### # # # ##### # ########### # ####### # # ### # # # ### 
#   #     #   #     # #   # #   #       #     #   # #   #   #   # #     #   #         #   #   #     #   # #   #   #   # # #   # 
### ##### ### ##### # ### # ######### ############# # # # ### # # # ### ######### # ####### # # ####### # # ####### ### # ### # 
# #   #   # # #       #   #   #     #     #   #     # # # #   # # #   #     #   # # #   #   # # # #   # # #     # # #   # #   # 
# ### # ### # ##### ### ##### # ### ### ### # # ##### # ### ### ##### ##### # # # # ### # ##### # # # # # ##### # # # ### # ### 
#     # #   # #   # #   #       # #   # #   # #   #   #     # #       #   #   # # #     #     # # # # # #   #     # #   # #   # 
####### ### # # # # # ########### ### # # ### ### # ######### ########### ##### # ########### # # # ### # ### ##### ### # ##### 
#     #   # # # #   #         # # #   #   #   #   #   #     # #     # #   #     #           #   # #   # # #   #     #   #     # 
# ### ### # # ### ########### # # # ### ####### # ### ##### # ### # # # ### ############# # ##### ### # # # ### ##### ####### # 
# # # # # # # #   #       # # #   # #   #     # #   #     #       # # # # # #   #     #   #   #   # #   #     # #     #   #   # 
# # # # # # # # ### ##### # # # ### # ##### # ### ####### ######### # # # # # # # ### ##### # # # # ######### # ### # # ### ### 
#   # # #     #   #     # #   # #   #       #   #       # #   #           # # # # #     # # #   # #   #     #   #   #     #     
##### # ### ### # # ##### ##### # ##### ####### ### ### # # # ########### # ### # ##### # # ##### ### # ### ### # ### ### ##### 
#   #   #       #   #   #   #   # #     #   #     # #   #   # #   #   #   #     #     # #     # # #   # # #   # #   # #         
# ##### ### ### # ### # ### # ### # ##### # ##### ### # ##### # # # # ### ########### # ### # # # # ### # ### # ### # # ####### 
# #   #   # #   # #   #   # # #   # #     #     #     # #   # # #   #     #           #   # #   #   # #   #   #     # # #     # 
# # # ### # # ##### ####### # # ##### ######### ####### # # # # ######### # ##### ####### # ######### ### ########### # ### ### 
# # #   #   # #     #       #   #     #       #     #   # # #   #       # #   #   #     # #   #   #     #         #   #   #     
# # ### ##### ### ### ####### ### ##### ##### ##### # ##### ##### ####### ### # ### ##### # # # # ### ########### # # ### ######
# #   #     #   # #       #   #     #   #         # #     #           #   #   #   #     # # # # #   # #     #   # # #   # #     
# ### ##### ### # ####### # ####### ### # # ##### # ##### ### ####### # ### ##### # ### # # # # ### # # # ### # # # ##### # ### 
#   # #         #         # #     # #   # # #   # #   #     #   #   # # #   #     #   # # # #     #   # # #   #   # #     # #   
### # # ################### # ### # # ### ### # # ### ##### ### # # # # ##### ####### # # # ##### ##### # # ####### # ### # ####
#   # #   #     # #       # # #   # # # # #   # #   #     #     # # # #       #     # # # #     # #   # #   #       # #   #   # 
# # # ### # ### # # ### ### # ### # # # # # ### ### ##### ##### # # ########### ##### ### ##### # # # # ##### ##### # ####### # 
# # #   # #   # # # # #     #   #   # # # #   #       #   #   # # #     #     # #     #   #   # #   # #   #   #   # #         # 
### ### ####### # # # ######### ##### # # ### ##### # # ### # # # ##### # ### # # ##### ### # # # ####### ### # # # ########### 
#   # #     #   # # #           #       #   #   #   # # #   #   # #     # #   # #   # # #   #   #   #   #   # # #   #   #   #   
# # # ##### # ### # ### # # ##### ############### ### # # ####### ##### # ##### ### # # ############# ##### # # ### ### # # # ##
# # #     # #   #   #   # # #     #     #         #   # #       # #   # #   #   # #   # #         #   #   #   #   # #   # # #   
# # # # # # ### # ### ##### ####### ### # ######### # # ####### # # # ##### # ### ### # # ####### # ### # ##### # ### ### # ### 
# # # # # #   # # # # #     #       #     #     #   # #   #   #   #G#   # # # #     # #   #   #   # #   #       #     #   #     
# # ### # ### # # # # # ##### ####### ##### ### # ### ### # # # ### ### # # # # ##### ##### # # ### ### ##### # ######### ##### 
# #     #   #   # #   # #     #     # #   # #     #     # # #     # # #   # #   #     #     #     #     #     # #       # #   # 
# ####### # ##### ##### # # # # ### # # # # # ######### # ### ##### # ##### # ### ##### ### ##### ########### # ####### # # ### 
# #     # #     #   #   # # #   #   # # #   # #   #               #           #   #   # #   #   #         #   #       #   #     
# # ### ### ####### # ### # ##### ### # ####### # # ######### ### ##### ##### # ### # # # ### # # ##### # # ##### ######### ####
# # # #   # #   # # # #   #     # #   # # #     # # #   #   #   # #   # #   # #     #   # #   #   #   # # #     #         #     
### # ### # # # # # # # ### ##### # ### # # ##### # # # # # ### ### # # # # # ########### # ####### ### # ##### ####### ####### 
#   #       # #   #   #   #   #   #   #   #   #   # # #   # #   #   # # # #   #     #     #         #   #       #   # #   #   # 
# ######### # ########### ### # ############# ####### ##### # # # ##### # ### # ### # ### ########### ########### # # ### # # # 
#         #               #   #             #         #       #         #   #   #     #             #             #     #   #   
################################################################################################################################
