################################################################################################################################
################################################################################################################################
     #   #                               #   #         #         #   #   #     #             # #   #   # #   #     #     #   # #
## # # # ####### ##### ################# # # # # # ### # ####### # # ### # ### # ### ##### # # # ### # # # # ### ### ##### # # #
   #   #   #   #     #             #   #   # # # # #S  # #     #   #   # # # # #   # #     # # # #   # # # #   #           #   #
 ######### # # ##### ############# # # ### # # # ### ### # ### ####### # # # # ### # # ##### # # # ### # # ### ######### ##### #
   # #   # # #     #       #     #   #   # # # #   #   #   #   #     # # #   #   # # #   #   #     #   # #   # #   #     #     #
## # # ### # ##### ####### # ### ####### ### # ### ### ##### ### ### # # ####### # ##### # ####### ##### ### # # # ####### ### #
 # # #   #   #   #   # #   # # # #     #   # #   # #     # #     #   # # #     # # #   # #       #         # #   #       #   # #
 # # ### ##### ##### # # ### # # # ##### # ##### # ##### # ########### # ##### # ### # ######### ####### # # ########### ### # #
   # # #     #     # # #       #   #   # #       #   #   # #       #   #           # #   #     #   #   # # # #         # #   # #
#### # ##### ### ### # # ########### # # ########### # ### # ##### # ############# ##### ##### ### # # # ### # ####### # ##### #
     #     #   # #   #   #   #     # # #     #     # #   # #     #   # #   #     #     #     # #   # # #   # # #   #   #   #   #
 ####### # ### # # ### ### # # ### # # # ### ##### # ### # ##### ##### # # # ### ##### ##### # # ##### ### # ### # # ##### ### #
     #   #         # # #   #   # #   # #   #     # #   #   #   #   #     #   #                 #     # #   # #   # # #     #   #
#### # ######### ### # # # ##### ##### ####### # # ### # ### ##### # ######### ######### ##### ##### # # # # # ### # # ##### # #
   # # #       # #     # # #   #     #       # # #   # #   # #     # #   #       #     #     #       #   # # #   # #   #     # #
 # # # # ##### # # # # # ### # ### # ####### ### ### # ### # # ####### # ####### # ### # ### # ########### # ##### # ### ##### #
 # #   # #   # # # # # #     #   # #       #   #    G# #   # # #   #   # #   #   #   # # #   #             #     # # #   #     #
 ### ### # ### # # # ########### ##### # # ### # ##### # ### # # # # ### # # ### ##### # # ### ### # # ######### # # # ### #####
     #   #     #   # #     #   # #   # # # # # #     # #     # # #   # #   #   # #     # # #   #   # # #   #   #   #   #   #   #
###### ### ##### ##### # # # # # # # ### # # # # ##### ####### ####### ####### # # ####### ##### ### # # # # ########### ##### #
       #   #     #   # # #   # #   #   # #   # # #   #       #       # #     # # #       #   #   #   #   #   #     #     #     #
 ####### ### ### # # # # ##### ####### # ### # # # # ##### # ####### # # ##### # ####### ### ### # ########### ### # ##### ### #
   #   # # # # # # #   # #   #       # #   # # # # # #   # # #       #     #   #   #   # # # #   #   #         # #   #   # #   #
## # ### # # # # # ##### # # ####### # ##### # ### # # # ### # ########### # ### ### ### # # # ##### # ######### ##### ### # ###
   #   # #   #   # #   #   #   #   # #     # #     # # #     #     #     #     #   # #   #   # #   #                 #     #   #
 ##### # # ####### ### ####### # # ####### # ####### ############# ### # # ### # # # # ####### # # ##### ######### # ######### #
 # #   # #     # #   #       #   #   #   # #   #     #     #   # #     # #   #   #   # #     #   #     #     #     #         # #
 # # # # ##### # ### ### ### ####### # ### # ### ##### ### # # # ####### # # ### ##### # ### ######### ####### ####### ### ### #
 #   # # #   #   # #     #   #   #   # #   # #   #     # #   # #     #   # #   # #   # #   # #       #   #     #     #   #   # #
 ##### # ### ### # ####### ### # ##### # ### # ### ##### ##### ##### # ### ### ### # # ### # ##### ##### # ##### ### ### ### # #
     #     #           # # #   #   #   # #   #   # #   #     #     # # #   # #     # # #   #     # #   # #       #   #   #   # #
 ### ##### ########### # # # ##### # ### # ##### # ### ##### ##### # # # ### ####### # # ####### # # ### ############### # ### #
   #     #         #       # #   # #     #       #     #         # # # # #     #     # # #     # # # #   #   #         # #     #
 ####### ######### ####### # # # # ####### ##### ######### ### # # # # # # ### # ### # # ##### # # # # ### # # ####### # #######
 #     #     #             #   # #     #   #   #     #     #   # # # # #   #   #   # # #     # #     #     # # #   #   #       #
 # ######### ####### ##### ##### ##### ### # # ### # ### ### ### # # # ##### ##### # # ##### # ##### ####### # # ### ### ##### #
   #       # #     # #   #     # #     #   # #     #   # #   #   # # #   #     #   # #   #   # #     #     #   # #   #   #     #
#### ##### # # ### # # # # ### # # ##### ### ######### ### ### ### # ### ##### # ####### # ### # ### # ######### # ### ### #####
     #   # #   #   # # #   # # # # #   #   #       # #     #   #       #   #   # #     # #   # #   # #   #     #   #   #       #
 ##### ### # ### ### # ##### # # ### # ### ####### # ####### ### ######### # ##### ### # ### # ### # ### # ### ##### ### # ### #
 #     #   # #   #   # # #     #     #       #   #   #   #   #   # #       # #     # # #   #   #   #     # # #   #   #   #   # #
 # ### # ##### ##### # # # ### ##### ######### # ##### ### ### ### # ####### # ##### # ### # ### ####### # # # # # ########### #
 # #   # #   #     # # #   #       # #         # #   # #   #   #   #   #   #       #   #   # #   #     # # #   # # #   #       #
 # # ### ### ##### # # ### # ##### # # ######### ### # # ### ##### ### ### # ########### ### # ### ### # # ####### ### # ##### #
 # #   #   # #     # # #   # #   #   #   # #   # #   # #   #     #   #   # # # #       #   # #   # # # #   # #   #   # #   #   #
 # ####### # # ##### # ##### ### ####### # # # # # ### ### ##### # ##### # # # # ##### ### # ##### # # # ### # # ### # ### # # #
 # #     # # # #   # #     #   # #       #   #   # #   #   #   # #     # # #   # #   #     # #   #   # # #   # #   #   #   # # #
 # # # ### # # # ### ##### ### # # ############### ### # ### # # # ##### # ### # # # ####### # # ##### # # # # ### ##### ##### #
 # # #   #   # #         #   #   # #           #             # # #   #   #     # # # #       # # #     #   # # # #     #   #   #
 # # ### ##### # ####### ######### ##### ##### ######### ##### # ### # ####### # # ### ##### # # # ######### # # ##### ### # # #
 #     # #     # #     #   #     #     #     #   #       #   # #   # #       # # # #   # #   # #   #         #   #   #     # # #
 ##### ### # # ### ### ##### ### ##### ######### # ### ### # # ### # ####### # # # # ### # # # ######### ### ##### # ####### ###
   #     # # # #   # # #   # #   #             # #   # #   # #   # #   #   #   # #   # #   # #         # #     #   #     #     #
## ##### # # ### ### # # # # # ### ########### # ##### # ### # ### # # ### ### # ##### ##### ######### # ##### # # ##### # ### #
 #     #   #   # #   #   #   #   #       #   # # #     # #   # #     #     #   #   #     #   #         #     #   # #   #   #   #
 ##### ####### # ### ########### ### ### # # # # # ##### # ### # ########### ##### # ### # # # ############# # ##### # ##### # #
     #   #   # # #     #   #   #   #   # # # # # # #     #   # # #     #     #   # #   # # # # #             # #     #       # #
 ### ### # # ### # ### # ### # ### # ### # # # # ### ####### # # # ### # ##### # # ### ### # # ################# ############# #
 # #   #   #   # #   # #   # #     #   # # # #   #     #     #   # #   #       # #   # #   # #       #         # #             #
 # # ######### # ##### ### # ####### # # ### # ### ##### ####### # # ### ##### ##### # # ### ####### # ####### # # ### # # ### #
 # #           # #   #     #   #     # #     #     #   #       # # #   # #   # #     #   #     #     # #     # # # #   # #   # #
 # ############# # # ##### ### ### ### ####### ##### # ####### # # ##### # # ### ########### ### ##### # ##### # # # ### ### # #
 #           #   # #   #     #   # # # #     #     # #     #   #         # #     #   #       #   #     # #   # # # # #   #   # #
 ####### # # # ####### # ####### # # # # ### # ### # ####### ### ####### # ####### # ### ##### ### # ### # # # # # ### ### ### #
       # # # #     # #     #       # # #   #   #   # #     # # # #       # #   # # #   #   #   #   #   # # # #   # #   #   # # #
###### ### # ### # # # ##### # ### # # ######### # # # ### # # # # ##### # # # # # ### ##### ##### ### # # # ##### # ### ### # #
       #   #   # # # # #     #   # #   #   #   # # #   # #   # # # #   #     #   # # #     # #   #   # #   #       # # # #     #
 ####### ##### # # # # # ####### # ##### # # # # # ##### ##### # # ### # ####### # # ##### # ### ##### ##### ####### # # ##### #
   #     #   # # # # # #     #   # #     # # # # # #   #         #     # #     # # #   #   #   # #     #   #       #   #   #   #
## # # ### # # ### # # ##### # ##### ##### ### # # # # ################### ### # # # ### ##### # # ##### # ####### ####### ### #
 # # # #   #   #   #   #   # # #   # #   #     # # # # #               #   #   # #   #   #     #   # #   #       # #     #   # #
 # ### # ####### ### ##### # # # # # # # ####### ### # # ############# # ####### ### # ### ######### # # ####### # # ### ### # #
 #   # # #       # #   #   # #   #   # # #           #   #       #     #     #     # #     #     # # # #       #   #   #   # # #
 ### # # ##### ### ### # ### ######### ### ##### ######### ####### # ####### # ##### ####### ### # # # ####### ### ### ### # # #
   #   #       #     #   #   #       #     #       #     #       # # #     # #   #   #     #   # # #       #   #     #   # # # #
## ############# ####### # ### # ### ####### # # # # ### ####### # # # ### # ### # ### ### ##### # ### # ### ####### ### # # # #
   #     #   #     #     # #   #   #   #     # # # # #   #     # # # # # #   #   #     #   #   # #     # #   #         # #   # #
 ### ##### # # # ### ##### ########### ####### # # # # ##### ### # ### # ##### ######### ### # # # ####### ##### ####### #######
   # #     # # # #   #   #     #     #     #   # # # #   #   #   #     # #   #     #   #   # #   # #     #     # #       # #   #
## # # ##### ### # ### # ##### # ### ##### # ### # # ### # ### ######### # # ##### # ##### # ##### # ### ##### # # ####### # # #
     #     # #   #   # #     #   # #     #   # # # # # # #   #     #       #   #   #     # # #     # # # #     # #       #   # #
 ##### ##### # ##### # ########### # ### ##### # # # # # ### ##### ####### ##### ##### ### # ##### # # # # ##### ####### ##### #
   #   #   # # #       #         # #   # #   #   #   #   #       #       #   #         #   #       # # # #     # #     # #   # #
## # ### # # # # ####### ### # # # ### # # ##### ######### ##### ####### ### # # ##### # ######### # # # ##### # # # ### # # # #
   #   # #   #   #   #   # # # # #   # # #   #     #       # #   #     #   #   # #     #     #     #   # #   # # # #   #   # # #
 ##### # ##### ### # # ### # # # ### ### ### ### # ####### # # ### ### ### ####### ### ##### # # ##### ### # # # # ### ##### # #
 #   # #     #     # # # #   # #   #     #   #   # #     #   #     #     #       # #       # # #   # #     #   #   #       # # #
 # # # ##### ####### # # ################# ### ### # ### ########### ########### # ### ### # ##### # ############# # ####### # #
   # # #   # #     # #     # #           # #     #   # # #         # #   #     #   #   #   # #   # # #     #     # #   #   #   #
 ### # ### # # ### # ##### # # ######### # # # # ##### # # # # ##### # # # ### ### # ### ### # # # # # ### # ### ####### # #####
 #   #     # # # # # #   #   #         #   # # #     # # # # # #     # # # #       #   #     # # #   # # # # # #   #   # # #   #
 ######### # # # # # # ##### ######### ##### # ### ### # ### # # ##### ### # ########### ##### # ##### # # # # ### # # # # # # #
       #   #   #   # #         #   # #   # # # #   #   #   # #             # #     #   #   #   #       # #   #   #   #   #   # #
 ####### ########### ### ### # # # # ### # # # # ### ##### ##### ########### # ### # # ### # ########### ####### ############# #
   #     #               #   #   #   #   #   # #   # #   #   #   #   #     # # # #   # #   #   #   #   #     # # #           # #
## # ########### ######### ####### ### ####### ### # # # ### ##### # # ### # # # ##### # ##### # ### # ##### # # # ####### # # #
 # #           # #   #   #   #     #   #         # #   #     #   # # # #   # #   #     #   #   #     #   #       # #     # # # #
 # ########### ### # # # ##### ##### ### ##### ### ########### # ### # ##### ##### ##### # # ########### # ####### ##### # # # #
 # #         # #   #   # # #       #   #     #   #     #       #     #       #   #   #   # # #     #       #       #   # # # # #
 # # ######### # ####### # # ######### ######### # ### # ### # ########### ### # ### # ### # # ### # ####### ####### # # # # # #
 # # #     #   # # #         #       #       # # # # #   #   # # #     #   #   #     # # #   # #   # #   #   #       # # # # # #
 # # # ### # ### # # ######### ##### ####### # # # # ##### ### # # ### # ### ######### # ##### ##### ### # ######### # # # # # #
 # #   # # # # #   # #         # #   #     # # # # #       #   # #   # # # #       #   # #         # #   #         # #   # # # #
 # ##### # # # ##### # ######### # ####### # # # # ######### # # ### # # # ####### # ### # ####### # # # ######### # ##### ### #
   #     # # #     # #       #             # #   #         # # #     # # # # #     #   #   #     # #   # #       #   #     #   #
 ### # ### # # ### # ####### ############# # ############# ### ####### # # # # ####### ##### ### # ##### # # ####### # ##### ###
     #   # # #   # #   #   #             # #       #       #     #   # #   # #   #   #     # #   # #     # #       # # #     # #
 ####### # # ### ##### # ##### ####### # # ####### # ####### ### # # # # ### ### # # ##### # # ### # ##### ##### # # ### ##### #
 #     #   # #           #   # #     # # #       # # #       #   # #   #   #   # # #   #   # # # # # #     #   # # #   # #     #
 # ### ##### ######### ### # # # ### # # ####### # # # ### # ##### ####### ### # # ##### ##### # # # # ##### # # ##### # # #####
 # #       # #       #   # # # # # # # #   #     #   # # # #   #   #   #     # # #   #   #     #   # # # #   # #       #   #   #
 # # ####### # ##### # ### # ### # # ##### ### ####### # # ### # ##### # ##### # ### # ### ##### ### # # # # ################# #
   # #   #   #     #   #   #     #   #   #   # #       # #   #   # #   # #     # #   #   #           # #   # #         #   #   #
#### # # # ########### # ############# # ### # # # # # # # # ##### # ### # ##### # ##### ##### ####### # ##### ####### # # # ###
     # # #         #   #           #   #     #   # # #   # #   #     #         # #       #   #     #     #   # #   #   # # # # #
 ##### # ######### # ############# # ######### ### # ##### ### # ############### # ####### # # ### # ##### # # # # # # ### # # #
 #     #   #   #           #     #   #         #   # #     #   # #   #           # #     # # #   #   #     # # # # # # #   #   #
 # ####### # # # ########### ### ##### ##### # # ##### # ####### # # # ########### # ### ### ### ##### ##### # # ### ### ##### #
   #     #   #   #     #     #   #   # #     # # #   # # #       # # # #       #   #   #   #   # #     #   #   #   # #   #     #
 ####### ######### ### # ##### ### ### ####### # # # # ### ######### # ### ### # ##### ### ### # # ####### ####### # # ####### #
             #   #   #   #   # #   #   #       # # # #   #   #       #   #   #       # # #     # # #   #         # #   # #     #
############ ### ### ##### # # # ### # # ####### # # ### ### # ######### # # ##### # # # ####### # # ### ####### # ##### # #####
 #   #     #     # #       # # #     # #   #   # # #   # #   #   #     # # #   #   # #   #     #   #     #       #   #   #   # #
 # # ### # ##### # ######### ######### ### # # # # ### # # ##### # # ### # ### # ####### ##### # ######### ######### # # ### # #
   #     #                               #   # #   #   #           #       #   #                                       #       #
################################################################################################################################
