################################################################################################################################
   #   #       #           #               # #   #   #           #           #     #       #   #     #           # #   #       #
 # # # # ##### # ######### # # ####### ### # # # ### # # ##### ### ####### ### ### # ### ### # # ### # ######### # # # ####### #
 #   #       # # # #   # # # #   #   #   #   # # #   # # #   # #   #     #   # # # # # #     # # # # #   # #     #   #   #   # #
 ######### ### # # # # # # # ### # ##### ##### # # ### ### # ### ### ### ### # # # # # ####### # # # ### # # ########### ### # #
 # #     #   #       #   #   #   # #     #   # #       #   #   # #   # # # # #   #   # #     # # # #     # # #   #     # #   # #
 # # ### # # ######### ####### ### # ##### # # ######### ##### # # ### # # # ### ##### # ### # # # ####### # # # # ### # # ### #
   # # # # # #       #   #   #   #   #   # #   #       #     # #   #   # # #   # #   #   # #   # #   #     # # #   # #   # # # #
 ### # # # ### ##### # # ### ### # ### # # ##### ##### ##### # ####### # # ### # # # ##### ##### # # # ##### ### ### ##### # # #
   # # # #   # #   # # #     # # # #   # # #   # #     #   # #       # #     # # # #           #   # # #   #   # #     #   # # #
## # # # ### # # # # # ####### # ### ##### # # # ####### # # ####### # ##### ### # # ######### ### ### # # ### # # ### # ### # #
 # # #       # # #   # #       # #   #       #         # #   #     #   #     #   # #       #   #   #   # #     #   #   #       #
 # # ####### # ####### # ####### # ### ### ########### # ####### # ##### ##### ### ######### # # ### ### ########### ######### #
   # #     #   #     #         #   # # #   #     #     # # #     #   #   # #   #   #         # #   #     #           #     #   #
## # # ### ### # ### ######### ##### # # ### ### # ### # # # ### ##### ### # ####### ######### ### ######### ####### ### # # # #
   # #   #     #   #         #   #   # # # #   #   #   # #   # # #   #   # # #       #       # # #     #     #     #   # #   # #
 # # ### ##### ### ######### ### # # # # # ### ##### # # ##### # # # ### # # ######### ##### # # ##### ####### ### ### ####### #
 # #   #     #   # #           #   # # # #   # # #   #       #   # #   #   #       #     #       #   # #     # #   #           #
 ############### # ########### ####### # ### # # # ######### ### # ####### ####### # ### # ##### # ### # ### ### ### ###########
     #         # #   #     # # #   #   #     #   # # #     # #   # #   # # # #     #   # # #   #     # # #     #               #
###### ####### # ### # ### # # # # # ### ######### # # ### # # # # # # # # # # ######### # # # ##### # # ##### ##### ######### #
     #   #   # #   #   #   # # # # # #   # #   # #   # #   #   # # # # # #   #   #     # # # #   #       #   #     # #       # #
 ### ### # # # # # ##### ### # # # # ### # # # # ##### # ####### # # # # ### ### # ### # ### ### ######### # ##### # ### ##### #
 # #     # #     #     # #   #   #   #   #   #     #   # # #   #     #     #   # # #   #   #   #       #   #   # # # #   #   # #
 # ### ########### ### # # ########### ########### # ### # # # # # ####### ### # ### ##### ### ####### # ##### # # # # ### # # #
   #   #   #   #   # # # # #                   #   # # # #   #   # #       #   #   #     #   #       #   #     # # # #     # # #
###### # # # # # ### # # # ### # # ### ##### ### ### # # ######### # ##### # ##### ##### # # ############# ##### # # # ####### #
 #     # # # # # #     #   #   # # #   #   #   #   #   #     #   # #     # #     #     #   #   #                   # # #       #
 # # ### # # # # # ######### ##### # ### # ### ### ### ##### # # ####### # # # # ##### ##### ### ### ######### # ### # # ##### #
 # # #   #   #   #   #       #   # # #   # #   #   #   #     # # #     # # # # #     #   #   #   # # #   #   # #       #   #   #
 # ### ############# # # ##### # # # ##### # ### ### ### ##### ### ### # # # # ##### ### ### # ### # # # # ### # ######### # ###
   #   #         # # # #   #   # # #       #     # #   # #   #     # # # #   #   #     #   # # #   # # # #     # #   #     #   #
## # ### ####### # # ##### # ### # ### ########### ### # ### ####### # # ######### ### ### ### # ### # # ######### ### ####### #
 # #   # #       #   #     #   # #   #         #   #   #   # #       # #   #     #   # # # #   #   # # # #     #   #   # #   # #
 # ### ### ######### # ####### # ### # ### # ### # # ##### # # ##### # ##### ### ##### # # # ### # # # # ### ### ### ### # ### #
 #   #         #   # #   #     #     # #   #   # # # #     # #   #   #   #   # # #       #   # # #   # #   #     #   #   #     #
 # # ########### # # ##### ### ####### ##### # # # # ####### ### # ##### # ### # ### ### ##### # ##### ### # ##### ### ####### #
 # # #   #       # #   #   #   #   #     #   #   # #   # #   #   #     #   #   #   #   # #     # #   #   # # #     # #         #
 # # # # # ####### ### # ####### # ##### # # ######### # # ### ### ######### ##### # # # # ##### # # # ### # # ##### ### # # ###
   #   # #       #   # #         # #     # #   #       # # #   #   #             # # # #     #   # # # #   #   #   #   # # #   #
######## ####### ### # # ######### # ####### # # ####### # # ### ### ### ####### # # # ##### # ### ### # ######### ### # # ### #
         #     # # # # #     #     # #     # # # #     # # #   # #   #   #   #   # # # #   # # #   #   #     #           #   # #
 ### ##### ### # # # # ##### # ##### # ### # # # # ##### # ##### # ### ### # ##### # ### # ### # ### ####### # ####### ### # # #
   #     #   #   #   # #   # # #     # #   # # # # #     #     #   #   #   #     # #     #       #   #   #   #   #   # #   # # #
 # ######### ##### ### # # ### # ####### ##### # # # ######### # ####### ####### # # ############# ##### # ##### # # # # ##### #
 #   #       #     # # # #     # #       #     # #   #   #   # #       # #     #   #   #     # #   #   # #   # # # #   # #     #
###### ####### ##### # # ####### # ####### ### # # ### # # # # ####### # # ### ####### # ### # # ##### # ### # # # ##### # ### #
       #     #     #     #   #   # #       #   # # #   #   #   #   #   # #   #   #     #   #   #     # #   # #   # #     #   # #
 ####### ### ##### ####### # ##### # # ##### # # # # ####### ### # # ### ### # ### ##### ########### # ### # ### # # ####### ###
 #   #   #       # #   #   #   # # # # #   # # # #         # #   # # # #   # # #   #             #   #     # #   # #       #   #
 # # # ##### # # # # # # ##### # # ### # # ### # ### ##### # # ### # # ### # # # ### ############# ####### # # # # ########### #
 # # # #     # # # # # #   #   # #     # #     #   # # #   #     # #   #   # #   #           #     #       # # # #   #         #
 # ### # # ### # # # # ### # ### ####### ######### # # # ####### # # ### ### ### # ########### ##### # ##### # ####### ### #####
 #     # # #   # #   #   # #   # #           #     #   # #     # #   #   #     #   #     #   #       # #   # # #       # # #   #
 ######### # ### ####### # ### # # ### ##### # ####### ### ### ####### ### ### ##### ### # # ######### # # # # # ####### # # # #
   #       #   # #       #   # # # #   #     #   #   #   #   #   #     #     # #     # #   # #         # #   # #   #   #   # # #
## ### ######### # ####### # # # # # ### ####### # ##### ### ### # ##### # ### # ##### ##### # ######### ####### # # # ##### ###
   #   #   #     #       # # # #   #   #       # # #       # # #         #   # #   # #     #   #   #   #       # #   # #   #   #
#### ### # # ### ####### # # # ####### ####### # # # ##### # # ############# ##### # # ### ##### ### ######### # ##### # # ### #
   #   # #   # #   # #   # # #   #   # #   #   # #   #   #       #   #       #   # # #   # #     #   #         #     # # #   # #
 # ##### ##### ### # # ##### ### # # ### # ##### ##### # ### ##### # # ##### # # # # ##### # ##### ### ######### ### # # ### # #
 # #   #   #     # # # #   # #   # #     #     #     # #   #       # #     # # #   #   #         # #   #         #   #   # #   #
 # # # ### ##### # # # # # ### ### ########### ##### # ### # ####### ##### # # ##### ### ####### # ### # ####### # ####### #####
 #   #   # #   #       # # #   # #   #   #   # #   # #   # # #       #   # # # # #   #   #   # # #     #   #     #     #       #
 ####### # # # ####### # # # ### ### # ### ### # # # ### # # # ####### # # ### # # ### ### # # # ########### ##### # ### #######
 #       # # #       # # #               #     # # # #   # # #       # #   #   #   # # # # # #   #   #       #   # #     #     #
 # ######### ####### # ### ######### # # ######### # ##### # ##### # # ##### ### ### # # # # ##### # # # ##### # ######### ### #
 #   #   #   # #   # #   # #       # # #           #   # # #     # # # #     #       #   # # #     # # #       #       #     # #
 ### ### # ### # # # ### # # ##### # # ######### ##### # # # ### # # ### ##### # ####### # ### ####### ############### # ##### #
   # #       #   #   # # #     #   # # #   #   #       #   # # # # # #   #   # #   #     # #   #     #               #   #   # #
#### # ##### ######### # # ##### ### # ### # # ### # ### ### # # # # # ### # # ### # ##### # ##### # ### # ############### # # #
     #     #           # # # #   #   #   # # #   # # #   #   #   # #   #   #     #       # #       #   # #     #       #   #   #
 # ### ### # ####### ### # # # ### ##### # # ### # # # ### # ############### ############# ########### # # ### # ####### #######
 #     # # #     # #     # #   #   #     # #   # # #   #   #       #         #   #       # #         #   # # # #         #     #
 ##### # # ### # # ####### ####### # ##### ##### # # ### # ####### # ######### # # ##### # # # # ######### # # ############### #
   # # # # #   # # # #   #   #   # #         #   # #     # #   #   #         # #   #   #   # # # #   #       #               # #
## # # # # ##### # # # # # # # # # ########### ### ####### # # ########### # # ##### # ##### # ### # # # # ### ####### ### ### #
 # #   # #   #     # # # # # # # #       #   #   #   #   #   #   #       # # # #     # #   # #   # # # # #   # #     # # #     #
 # ##### ### ### ### # # # # # # ####### # # ### ### # # ##### # # ##### # ### # ##### ### # ### # ### # ### # # ### # # #######
   #   #   #   #       # # #   #       #   #   #   # # #     # # # # #   #           #     # #   #     # #   # # #   #     #   #
#### # ### ### # ####### # ########### ##### # ### # # ##### ### # # # ### ######### ####### # ####### # # ### # # ######### # #
     #   #S    #     # #   #       #   #     # #   #       #   #   #   #   #   #     #     # # # #     # #   #   #     #   # # #
 # ##### ########### # ##### ####### ### ####### ####### # ### ######### ### # ####### ### # # # # # ### ### ######### # # # # #
 # #   #   #   #   #               # # #         #   #   #   #   #   # #   # #       #   # # #   # # #   # #     #   #   #   # #
 # # # # ### ### # ####### ####### # # ########### # # ######### # # # ### # ####### ### # # ##### ### ### # ### # # ######### #
 # # # #     #   #   #     #   #   # #   #     #   # # #       #   # #   # # #   # # #   # # #     #   #   #   # # # #       # #
 ### # ####### ##### ####### # ##### # # # ### # ### ### ##### ##### # # # # ### # # # ##### # ##### ### ##### # # ### ##### # #
   # # #     #     # #     # #       # #   #     #       #   #  G    # # # #   #   #   #   #   #   #   #   # # # #     # #   # #
 # # ### ### ##### ### ### # ######### ##### ############# # ######### # # ### ### ##### # ### # # ### ### # # ######### # ### #
 # #     # # #   #     # #   #       #   #   #     #     # #     #     #     #       #   # #   # #     # # # #     #     #     #
 ######### # # ######### ##### ######### ##### ### # ### # # # # ########### ####### # ##### # # ####### # # ##### # ###########
 #     #   # #               #   #     #     #   # # # # # # # #             #     # #       # # #           #   # # #   #     #
 # ### ### # ##### ######### ### ### # ##### ### # # # # # ### ############# ##### # ######### # ### ### ##### # # # # # # ### #
 #   #     # #     #         # #     # #   #     # #   # # #   #         #   #   #           # #   # #   #   # # #   # # # #   #
 ### ####### ### ### ####### # ####### ### ####### ##### # # ##### ##### # ### # ### # ##### # ### ### # # # ### ####### ### ###
   # #     #   # #   # #   # #     #   #     #   # #   #   # #     #     # #   #     # #   #     #   # # # #   # #             #
 ### # ### ### ### ### # ### ##### # ### ##### # # # # ##### ####### ##### # ####### # # ########### # # # ### # # #############
 #   # #     #     # #   #   # #   #     #     #   # #       #   #     #   #     # # # #     #   #   # #   # #   #             #
 # ##### ### ####### # ### ### # ####### # ######### ####### # # ### ### ##### # # # # ##### # # # ####### # ######### ####### #
   #     #         #   #   #     #       #   #         #     # #   # #   #   # # # # #       # #   #     # # # #     #   # #   #
 ### ### # ##### # # ### ####### # ######### ######### # ##### ### # # ### # ### # # ######### ######### # # # # ### ### # # ###
 #   #   # #     # # #   #     # #   #       #   #     # #     #   # # #   #     #       #   # #         # # # # # # #   # #   #
 # ####### # ##### # # ####### # ### # ### ### # # ####### ##### ### # # ############### # # # # ######### # # # # # # ### # # #
 #       # # #   # # #       #   #   #   # #   # # #   #   #   # #   #   #   #           # #   # #       # #     #   # #   # # #
 ####### # # # # # # ####### ### # ##### ### ### # ### # ### # # # ####### ### # # ##### # ##### # ### # # # ### ##### # ##### #
     #   # # # #   #   #     #   #   # # #   # # #     #   # #   # #         # # # #   # #       # #   #   #   #       #       #
#### ##### # ##### # ### ##### ##### # # # ### # ######### # ##### ######### # # ### # ########### # ### ### # ############### #
   #       #     # #   # #     #       #   #   #           #     #       #     #     #             # #       #   #       #     #
 ######### ##### # ### # # ### # ########### ################### ####### ### ##### ########### # ### # ### ##### # ##### # #####
           #     #     # # #   #     #     #   #   #   #   #   # #   # #   # #   #       #   # # # # #   #   #   # #     #     #
#### # ##### ######### # ### # ##### # ####### # ### ### # # ### # # # ### ### # ##### ### # # # # # # # ##### # # ########### #
   # #   #   #       # #     #           #     # #       #   #   # # # # #     # #   #   # #   # #   # #   #   # #   #     #   #
 # # ### # # # ####### ##### ########### # ##### # # ####### # ##### # # ####### # ##### # ##### ######### # ####### ### # #####
 # #   # # # # #       #     #     #     # #   # # # #     # #       # #   #   # # #   # # #     #         #   #   #     #     #
 # # # # # ### # ##### # ### # ### # ### # # # # # ### ### # ######### # # # ### # # # # # ########### ####### # # ########### #
 #   # # #   # #   #     # # #   # # #   # # #     #   #   #             # # #   #   #   #   # #       #     #   #           # #
 ####### ### # ### ####### # ### # # ### # # ####### ### ##### # ######### # # ####### ##### # # # ##### ### # ############# # #
 #         # # # #   #   #   #   # #   # # # #     # # # #   # # #   #   # # #       # #   # #   # #     # # #   #       #   # #
## ####### # # # ### # # ##### ### ### # # # # ### # # # # # # ### # # ### # ####### ### # # ### # # ##### # ### # ##### ##### #
   # #     #       #   # #     #     # #     #   # #   #   #   #   # # #       #   #     #   #   #   #   # # #   # #   #       #
 ### # ################# # ######### # ######### # ######### ### ### # # ##### # # ########### ####### ### # ##### ### #########
 #     #   #   #     #   #       # # #     #     # #         #   #   #   #     # # #     #     #           #   #   #   #       #
 ####### # # # # ### # ######### # # ####### ##### # # ####### ### ####### ### # # ### # # ### # ### # ### ### # ### ######### #
         # # # #   #   #     #   # #         #   # # #   #   # # #   #   #   # # # #   # # #   # #   #   #   #   # # #         #
 ######### ### ### ##### ##### ### ########### # # ####### # # # ### # # ##### # ### ### ### ### # ### # ### ##### # # #########
 #       #     # # #   # #   #   #   #       # # # #       #   #   # # #       #   # # #   #     # #   #   # #       #   # #   #
 # # ########### # # # # # # ### ### ##### # # ### # ########### # # # ####### ### # # ### ####### # ##### ### ######### # # # #
   #             #   # #   #     #         #         #           #     #             #             #     #                   # #
