################################################################################################################################
################################################################################################################################
                 #       #   # #     #     #       #           #           #               #         #         #   #   #       #
#### ### # ##### # # ### # # # # ### ##### # ####### ##### ### # ##### # ### # ### # ####### ### ### # ####### ### # ### # #####
   # #   # #   #   #   #   #   # #   #   # #         #   # # # #     # # #   #   # #   #       #   # # #     #   # #   # #     #
 # ### ##### # ####### # ####### # ### # # ##### ##### # # # # ##### # ### ##### ##### # ####### # # # # ### ### # # # # ##### #
 #     #     #         # #     # # #   #   #     #   # #   #   #   # #     # #   #     # # #   # # # # #   # # # # # # # #   # #
 ####### ############### # ### # # ####### # ### # # ####### ### # # ####### # ### # ### # # # # # # # # # # # # # # ### # ### #
     #   #           #   # #   # # #   #   # #   # # #     # #   # # #       # #   # #   # # # # # #     # # # # #   #     #   #
#### # ######### ### # ### # ### # # # # ### # ### ### ### # # ##### # ##### # ####### ### # # ### ####### # # # ### # ##### ###
     # # #     #   #     # #   # # # # #   # #   #     #       #     # #     #       # # #   #     #     # #   #   # # # #   # #
 ##### # # ### # # ####### ### # # # # ### # ### ######### ##### ####### ### ####### # # ########### ### # ####### # # # # ### #
   # #   # # # # # #     #   #   #   # #       #     #     #     #       #   #   #   #     #       # # # #   #   #   # #   #   #
 # # ##### # # # # # ### ### ######### # ####### ##### ### # ######### ### # ### # ####### ##### # # # # # # # # ##### ####### #
 #     #     # # #   # #   # #   #     # # #   # #     # # #       #   #   #     # #       #     # # #   # # # #   #   #       #
######## ##### # ##### # ### ### # ##### # # # # # ##### # ####### ##### ####### # # ####### # ### # ##### # ##### # ### #######
         #     #   # # #   #     # #       # # # # #   # # #   # #     # #     # #   #   #   # #   #   #   #   #   # #         #
 ######### ####### # # ### ####### ######### # ### # # # # # # # ##### # # ### # ##### # # ### # # ### ##### # # ### # # #######
     #   #     #   # #   # #       #   #     #     # #   #   #   #     # # #   #     # # # #   # # #   #   # #   #   # #       #
#### # # ##### # ### ### # # ####### # # ############# ######### # ####### # ### ### # # # ##### # # ### # ####### ### ####### #
     # # #   # # #   #   # #   #     #   #   #   #   #         # #         # #   #   # # #     # # # # # # #           #     # #
 ##### ### # # # ### # ### ### # ######### ### # # # ### # ### # ########### ### # ### ##### # # # # # # ### ######### # ##### #
   # #     #   #   # #   # #   #   #     # #   #   # #   #   #                   #   #     # # # # #         #       #   #     #
## # ############# # # ### # ##### # ##### # ####### ####### # # ####### ########### ##### # # # # # ####### # ##### ##### #####
 # #   #       #   # # #   # #     #     #   #     #   #     # #   #     # #   #   #   #   # # # # # #       #     #     #     #
 # ### # ####### ### # # ### # ######### ######### ### # ##### ### # ##### # # # ##### # ##### # # # # ##### ##### ##### ##### #
   #     #     # #   # # # #   #           #     #   # # #     # # #     # # # #   #   # #     # #   # #       # #   #   #     #
 ####### ### # # # ### # # ######### ### # # ### ### # # # ##### # ##### # # # ### # ### # ##### ##### # ##### # ### # ####### #
 #     #     # # #     #   #       # #   # # # #     #   #     # #     #   # #   # #   #   #   #   #   #     #   # # #     #   #
 # ### ####### # # ######### ##### # # ### # # ######### ##### # ### # ##### ### # ### ##### # ### # ########### # # ##### ### #
 #   #       #     #     #   #     # # #   #           #     #   #   #     # #   # #   #     #     # #       # # # #   # # #   #
 ### ####### # ##### ### # ### ##### # # ######### # # # ### ##### ######### # ### # ### ##### ##### # ##### # # # ### # # # ###
     #     # #     #   # # # #   #   # #     #     # #     # #     #       # #   #       #     #     # #     # #   # # #   #   #
###### ##### # ### ### # # # ### ##### ##### ####### ### # # # ##### ##### # ### ######### # ### ### # ####### ### # # ####### #
 #       #   #   #   # #   #   # #     #   #         #   # # #       #   # #   #       # # # # # #   #     #         #       # #
 # ### ### ##### ##### ### ### # # ####### ##### ########### ######### ### ### ####### # # # # # # # ##### # ##### ######### ###
   # #           #   # #   #   #   # #           #         #         #   #   # #       #   #   # # # # #   # #   #     #   #   #
 ### ######### ### # # ##### ####### # ######### # ####### ### ### ##### # ### ############### # # # # # ##### # # ### # # ### #
 #       #   # #   # # #     #     #   #         # #     #   #   # #   # #   #       #       # # # #   #       # #   # # # #   #
 ##### ### # ### ### # # ##### ### ####### ####### ##### ### ##### # # # # # ####### # ##### ### # ############# ### ### ### ###
     # #   #   # # # #   #     #           # #     #   #   # #   #   # # # # #   #   # #   #     #       #   #     # #   #   # #
#### # # ##### # # # ##### ##### # # ####### # ##### # ### # # # ##### # ### # ### ### # ############# ### # ##### # # ### ### #
       # #   #   #       # #     # #     #   # #   # #   # # # # #     #     #   # # # #       #       #   #     #     #   #   #
 ####### # # ####### ##### # ##### ##### # ### ### # ### # # # # # ########### # # # # ####### ### ### # ####### # ##### ##### #
 #   #   # # # #   # #   # # #         # # # #     #   #   #   #   #   #       # # #   #     #     # # #   # #   #     #     # #
 # ### ### # # # # ### # # # ##### ### # # # ######### ############# ### ####### # ##### ### ####### # ### # # ### ### ##### # #
 #   # #   # # # #     #   #   #   #   # # #   #       #     #     #         #   #     # #     #     # #   #   # #   # #   # # #
 ### # ##### # # ############# # # ##### # ### # ####### ### # ### # ######### # ##### # ####### ##### # ####### ### ### # # # #
     #   # # # #     # #   #   # # #   #   #   # #       # # #   #   #   #     # #     #         #     #   #         #   # # # #
#### ### # # # ##### # # # # ### ### # ##### ### # ####### # ### ####### # ##### # ######### ##### ### ### # ######### ### # # #
     #         #   # # # #   # #     #     # #   # #     # # #   # #     # #   # #         #       # # #   # #         # # #   #
 ### # ######### # # # # ##### # ####### # # # # # # ##### # # ### # # ### # # ########### ######### # # ### # ######### # ### #
   # #   #       # # # #   # # # #     # #   # #   # #     #   #   # # #   # #         # #   #     #   #     #   #       # #   #
#### ### # ####### # # ### # # ### ### # # ### ##### # ######### ### # # ### ######### # ### ##### ### ##### ##### ### ### # ###
     #   # #     # # #     #       #     #     #       #   #       # # # #   # #     #   # # #   #       #   # #     #     #   #
 ##### ### ##### # # # ################### ##### ####### # # ##### # # # # ### # # ####### # # # # ### ### # # # ############# #
 #   # # #       # # # #             #           #       # # #   #   # #   #     #         #   # #   # #   #       #     #   # #
 # # # # ####### ### ### ########### # ### ####### ####### # # # ##### ##### ####### ########### ### ### ### ##### # ### # # # #
 # # # # #     #   #   #     #     # #   #         #   #   #   #   # #       #   # # #       # #   #   #   # #   #   #   # #   #
 # # # # ##### ### ### ##### # ##### ### ########### # # ######### # # ### ### # # # # ##### # ### # # ### ### # # ####### #####
 # # # #   # # # # # #   #   #     #   #       #     # #       #   # #   # #   #   #       #     # # #   #   # # # #   #   #   #
 # # # ### # # # # # # # # ####### ### ##### # # # ### ####### ### # ### # ####### ############### ######### # # # # # # ### # #
 # #   #   #   # #   # # #       #   #     # #   #   # #     #   #   # # #     #     #         #   #         # # # # # # #   # #
 # ##### ### ### ### # # ####### ### ##### # ####### ### ####### ### # # ##### # ##### ####### # ### ######### # # # # # ### # #
 #   # #         #   # #       #   #   #   #       #     # #   # # # # #     #   #     #     # #   #     #   # #   # # #   # # #
 ### # ### ####### ### ### ####### ### # ##### ### ####### # ### # # # ##### ##### ##### ##### ### ##### # # ##### # # ### ### #
   # #     #     #   #   #   #   # #   # #   #   #     #   #     # # #   # #       #     #     # #     # # #   #     # #   #   #
 ### # ##### ### ### ### ##### # # # ### # # ### ##### # # ####### # # # # ######### ##### ##### ##### ### ### ### ### # ### ###
     #         #   #   #       #   #     # #   #   #   # # #       # # #       #   #     # #     #   #     # #   # #   #   #   #
 ##### ############### ################### ### # # # ### # ##### ### # ####### # # ##### # # ##### ######### ### # ####### ### #
   # #   #       #   #   #       #   #     # # # # #     #     # #   # #     # # #     #   # #             #     #       #   # #
## # # ### ##### # # ### # ##### # # # # ### # # # # ######### # # ### # ##### # ##### ##### # ####### ### # ##### ######### # #
   #       #   # # #   #   #   #   # # # #   # # # # #     #   #       #       # #     #       #       #   # #   #         #   #
 ##### ##### # # # ########### ##### # # # ### ### # # ### # ########### ####### # ##### # ############# ### ### ######### ### #
     #       # # #     #         # #   # #   #     #     # # #   #   #   # #   # # #     #     #     #   #   #           # # # #
#### ######### # ##### # # # ### # ### # ### ####### ##### # ### # ### ### # # # ### ######### # ### ##### ### ####### # # # # #
   #     #     # #   #   # # # #       #   #   #       #   #     # #   #     # #   #   #     # #   # #   # #   #     # #   # # #
 # ##### # ####### ##### ### # ##### # ### ### ####### # ######### # ### ##### ### ### # ### # ### ### # # ##### ### ##### # # #
 # #   # # #       #     #   #       #   # # #         #     #       #   #   # #     #   #   # #   #   # # #   #   # #       # #
 # # # # # # ####### ### # ##### ##### ### # ####### ####### # # # ### ### ### ##### ##### ### # ### ### # # # ##### # ### ### #
 #   #   # #     #   #   #   #   # #   #   #   #     #   #   # # #           #   #         # #   # # # # # # #   #   #   # #   #
 # ##### # ##### # ### ##### # ### # ### ### # ##### # # # # # # ##### # ### ### # ####### # ##### # # # # # ### # ####### # ###
 # #   #       #   #     #   #     #   # #   # #     # #   # # #     # #   #   # # #     # # #   # # # #   # # # #   #     # # #
 ### # ### # # ##### ##### ########### # ##### # ### # ##### # ##### # # ### ### # # ### # # # # # # # ##### # # ### # ##### # #
 #   #     # #   #   #   #     #       #   #   #   # #     # #   #   # #   #   # # # # # #     # # #     #   # #   # #     #   #
 # ####### # ### # # # # ##### # ######### # ##### # ##### # ### # ### ### ### # ### # # # ##### # ##### # ### ### # # ### ### #
 #   #   # #   #   # # #     # # #       # #       #     # # #   # #     # #   #     # # #     #       #   #       #     #     #
 ### # ### ### ##### # ####### # # ##### # ######### ### # ### ### # ### ### ######### # # ### ##### # ##### # ##### ### #######
 #   #   #   #     # #         # # # #   #     #     #   #     #   #   # #   #   #   #   # # #     # #     # #         #       #
 # ##### # # ####### ########### # # # ####### ### ### # ####### ####### # ### # ### ##### # ##### ### # ### ######### # #######
 #   # #   #   #   #       #   #     #   #   #   # #   #   #   #   #     #     #   #     # # #   #   # #   # #   #     #   #   #
#### # ##### ### # ### ##### # # ####### # # ### ### ##### ### ### # ########### # ##### # # # # ### # ### # # # ######### # # #
     #         # # #   #     # # #   #   # #   #   #     #   #   # #     #     # #       # # # #     # #   #   #   #     # # # #
 ##### # ##### # ### ### ##### ### # # ### ####### ##### ### ### # ####### ### ##### ##### # # ####### # # ####### # ### # # # #
   #   #   # # #   # # #     #   # #   #   #     #   # #   #     #       #   #     #         #     #   # #   #   # #   #   # # #
## # # ### # # ### # # ##### ### # ##### ### ####### # ### ############# ### ##### # ############# ### # ### ### # ### ##### # #
 # # #   #   #   #   #   #   #     # #   #   #   # # #   #           # #   # #     #     #   #   # #   #   #     #   #   #   # #
 # # # ######### ####### # ######### # # # ### # # # ### ####### # # # ### # # ####### # # # ### # # # ### # ####### ##### ### #
 # # # #   #     #     # #       #     #   #   # # # # # #       # # # # #   #   #   # # # #   #   # # # # #   #   #       # # #
 # # # # # # ##### ### # ####### # ######### ### # # # # # ####### # # # ####### # # # # # ### ##### # # # ##### # ######### # #
   # #   # # #     # #         # # #         #   # # #   # #     # # #     #   # # # # #   #   #     # # #       # #   #     # #
#### ##### # # ##### ####### ### # # ######### ### # # ### # ### # # ##### # # # # # ####### ### ##### # ######### # # ### ### #
 #       # #   #   # #     # #   #   #       # # # # #     # #   # #     # # # # # # #   #   #     #   # #   #   #   #     #   #
 # # ##### ####### # # ### ### ####### ####### # # # # ##### # ### ### ### # # # # ### # # ####### # # # # # ### ########### ###
 # #     #     #     # # #    S#           #   # # # # #     # #   # # #   # # # # #   #   #       # #   # #     #   #     #   #
 # # ### ##### # ##### # ####### ######### # ### # # ### ##### # # # # # ##### # # # ####### ####### ##### ####### # # ####### #
   #   #     #     #   # #   # #   #   #   # #   # #     #     # #   # # #     # # # #         #                   #   # #   # #
## ############### # ### # # # # # # # ##### ### # ####### ##### # ### # # ##### # # # ##### # # ##### ### # ### ####### # # # #
   #         #   # # #     # # # # # # #   # #         # # #     #   #       #   #   # #     # #   #   #   #   #       # # #   #
 ### ####### # # ### ####### # # ### # # # # # ####### # # ##### ############# ######### ##### ### # ### ##### ### ### # # ### #
 # # #     # # #     #     #   # #   #   #   # #   #     #   # # #         #   #   #   # #     #   # # #     #   #   #   #   # #
 # # # ### # # ####### ### # ### # ########### # # # ####### # # # ####### # ### ### # ### ##### ### # ##### ### # ######### # #
   #   # # #   #     # #   #     # #   #     # # # # #     # #   #   #   #   #   #   #     #   # #   #       #   #     #     # #
 ####### # ##### ### # ##### ##### # # # ### ### # # # ### # ####### ### ####### # ########### # # ####### ######### # # #######
   #     #   # #   # #   #   #   #   # #   #     # # # #   #   #   # #   #G      #     #     # # # #     # #     #   # #       #
 # # ####### # ##### ### # ### # ##### ########### # # # ##### # # # # ### ########### # ### # # # # ### ### ### # ########### #
 #   #     # #       #     #   #   #   #             # #   #   # #   # # #           #   # # #   #     #     #   #           # #
 ##### ### # # ####### ##### ### ### ### ############# ### # ######### # ### ### ### ##### # ############### # ### ########### #
     # # #   #   #           # #     # #               #   #     #   #       #   #   #   # #     #         # #   #     #       #
 ##### # ####### # ########### ####### # ####################### # # ### ### # ### ### # # ##### # ##### # # ### # ##### ##### #
 #   # # #   #   # #   #   #   #   #     # #         # #     #   # #   #   # #   #   # #   #   #   #   # # #   # # #   # #   # #
 # # # # # # # ### # # # # # ### ### ##### # # ##### # # ### # ### ### ##### ### ### ##### # ##### # # ### # # # # # # # # # ###
 # # # # # #   #     # # #         # #       # #   # # # # # #   # #       # #   #         #     # # #     # # # # # # # # #   #
 # ### # # ########### # ######### # # ####### # # # # # # # ### # # ##### ### ########### ##### ### ######### # ### # # # ### #
 #     # # #       #   # #       #   #     #   # # # # #   #   # # # #   #     #   #     # #   #     #         #   # # # #   # #
 ####### # ####### # ### # ##### # ####### # ##### # # ### ##### # ### # ####### # # ### # # # ####### ####### ### # # # ### # #
                           #     #         #       #     #       #     #         #   #   #   #         #         #   # #     # #
################################################################################################################################
