################################################################################################################################
################################################################################################################################
                   #       #       #       #       #   #         #                 #     #     #     #     #           #       #
 ### ######### ### # # ### # ##### # ### ### ##### # # # ##### # # ######### # # ### ### # # ### ### # ### ### # # ### # ##### #
 # # # #       # # # # #   #   #   # #   #   #   #   #   # #   # #   #       # #   #   # # #     #   #   #     # # #S#   # #   #
 # # # # ####### # ### # ##### ##### # ### ### # ####### # # ### ### # ####### ### ### # # ####### ##### ####### # # ##### # ###
 # #   #   # #   #   # # #   # #   # #   # # # #   #   #   # #   #   # # #       #     # #       # #   # #     # # #   #   #   #
 # ####### # # # ### # # # # # # # ##### # # # ### # # ##### # ### ### # # # ################### # # ### # ### ### # ### ##### #
     #     #   #   # # #   #     # #     #   # #     #       #     #   #   #   #     #           # #     #   #     # #   #     #
###### ##### ### ### # ########### # ####### # ##################### ### ####### ### # ########### ##### ### ####### # ### #####
   #   #   #   # #   #     #   #   # #   #   #       #       # #     #   #     # #   # #     #     #   # #   #   #         #   #
 # # # # # ### # # ######### # # ### # # # ######### # ##### # # ####### # ### # # ### # ### ####### # # # ### # ##### ####### #
 #   # # #   # # #       #   # #     # #   #   #   #   #     #   #     # #   #   # #   # # #   #     #   # #   # #   # #       #
 ####### ### # ######### # ### # ##### ##### # # # ############### ### ### # ##### # ### # ### ####### ### # ### # # # ### #####
       #   # #         #   # #   #     #   # # # #     #           # #   # # #   # # #   #   # #   #   #   #   #   # #     #   #
 ##### # ### # ############# ### # ##### ### # # # ### # ########### ### # # # ### # # ### # # # # ##### ##### ##### ##### # # #
     #   #   # #   # #       #   # #     #   #   # #   #   #           # # # #     #   # # # #   #       #     #       # # # # #
########## ### # # # # ####### ### ##### # ####### # ##### # ######### # ### # ######### # # ##### ####### ########### # # # # #
     #     #   # # # # #   # # # #     #     #     #     # #     #     #     #             #       #     #       #   # #   # # #
 ### # ##### ### # # # ### # # # ##### ##### ############# ##### ### ################# ############# ### # ##### # # # ### # ###
   #   #   #     #   # #   # #   #     #   #       #     # #   #   #   #         #     #           #   # # #   #   # #   # #   #
## ##### # ######### # # ### ### # ##### # ####### # ### # # ##### ### # ####### # ### # ######### ##### # # ####### ### # ### #
   # #   #     #   # # #       # #     # #         #   # # #       #   #   #     #   # #     #   #   #   #   #     #   # # #   #
 ### # ####### # # # # ### ##### ##### # ##### ####### ### ######### ##### # ####### ####### # # ### # ####### ### ### # # # ###
 #     #     #   #   #     #   #     # # #     #     #     #     #   #     #       #     #   # #   # #       # #   #   #   #   #
 ####### ### ####### ##### # # ##### # # # ##### ########### # # # ### ########### ##### # ### ##### ####### # # ### ##### ### #
     # #   #               # #       # # # #   # #     #     # # # #   #   #     #   #   # #   # #   #     #   #     #   #   # #
#### # ### ############### # ######### # # # # # # ### ### ### # # # ##### ### # ### # ### # ### # ### ############# # # ### # #
   # # #   #         #   # #             #   # #   # #   # #   #   # #   #   # #   # #   # # #     #     #   #     # # # #   # #
 ### # # ### ####### # # # ########### ####### ##### ### ### ##### # # # ### # ### # ### # # # ##### ### # # # ### # # ### # # #
     # # #   #     # # #     #         #         # #   #     #   # #   #   # # #   #     #   #   # # # #   #   #   # #     #   #
###### # # ####### # # ##### # ####### # ##### # # ### ### ### # # ##### ### ### # ##### ####### # # # ############# ######### #
     #   #     #   #   #G#     #       # #     #           #   # #   #   #   #   #         # #   # # #       #     #   #       #
 # # ##### ### # # ##### # # ########### # ######### ####### ### # # # ### ### ########### # # ### # # ##### ### # ### # ##### #
 # #     # #   # # #       # #       #   # # #     # #       #     # # #   #     #         # # #   # # #   #   # #     # #     #
 # ##### ### ### # # # ####### ##### # # # # # ### ### ############# # # ### ### # # ####### # ### # # # ##### # ####### ##### #
 #     #     #   # # # #       #   #   # #   # #   #   #         #   #   #     # # # #     # # #   #   # #     #   #     #   # #
 ##### ####### # # ### # ######### ########### # ### ### ####### ### ########### # ### ### # # # ####### # ####### # ##### # # #
 #   # #   #   # #   # # #   #     #       #   #   # #   #   # #   #         #   #     # #   # #     #   #         # #   # #   #
## # # # # ### # ### # # # # # ##### ##### # ##### # # ##### # ### ######### # ######### ##### ##### # ####### ##### # # ##### #
   #   # #   # # # #   # # # #     # #   # #   # #   #     # # #   #     #   #           #   # #               #   # # #   #   #
 ########### ### # ### # # # ##### # # # ##### # ######### # # # ####### # ##### # ### ### # # ### # ######### # # # # ### # # #
 #       # #     #     #   # #     #   #       #       #   # # #       #         #   #     # #   # #   #   #   # # # #   # # # #
 # ##### # ######### # ##### ##### ############# ####### ### # ####### ############# # ##### ### ####### # ##### # # ##### # # #
   #   # #   #       # #   #   #                       # #   #     # #   #           #   #   #   #       #   #   #   #   #   # #
 ### # # # # # ####### ### ### # ############# ####### # # ##### # # ### ############### # # # ### ######### # ####### # ##### #
 #   #   # #   #       #     # # # #         # #   #   # # # #   # #   # #     #   #     # # #     #   #   #   #       #   # # #
## ####### ##### ##### # ##### # # # ####### # ### # ### # # # ### ### # # ### ### ####### # ####### # # # ##### ######### # # #
   #       #       # #   # #   #   #     # # # #   #   #   #   #       #   #   #   #       #       # # # # #   #   #     # #   #
 ### ### # ### # # # ##### # ### ####### # # # # # ############# ##### ##### ### ### ############# # # # # # # ##### ### # # ###
 #   #   #   # # # # #   # # #   #     # # # # # #           #   #   # #   # #   #   #       #     # #   # # # #     # #     # #
 ##### # ### ### # # ### # # ##### # ### # # # ####### ##### # ### # ### # # # ### ##### # # # ##### ##### ### # ### # ##### # #
   #   #   #   # #   #     # #   # # #     # #       # #   #     # # #   # # # #   #   # # # #     #   # #     #   #   #   #   #
 # ####### ### # ##### ##### # # # # # ##### ####### # # # ##### # ### ### # # # ### # # # # ##### ### # ####### # ##### # #####
 #       #   # #       #     # #   #   #   #       #   # # #   # #   # # # # #   # # # # # #   #     # #   #   # #     # #     #
 ####### ### # ######### ##### ######### # ####### ##### # # # # ### # # # # ##### # ### # ### # ##### # ### # # ##### # ##### #
 #       #   #       #   #   # #   #     # #   #   #   # #   #   #   # # #   #       #   #   #   #   # #     #   #   #   # #   #
## ####### # ####### # ##### # # # ####### # # # ### # ######### # ### # ######### ### # ### ##### # # ####### ### # ##### # # #
   #       #     #   #     #     # #   # #   #   #   # #     #   #   #           #     # #   #   # # # #     # #   #     #   # #
 ### ####### # ### ####### ####### # # # ############# # ### # ##### ########### ####### # ### # # # # # ### # # ####### ##### #
   # #       # #   #     #   #   #   # #     #   #   #   #   #       #   #       #       #   # #   # # # # # #   # #   #   #   #
## # # ######### ##### ##### # # ##### ##### # ### # ##### ### ####### # # ####### # ####### ####### # # # # # ### # # ### # ###
 # # #     #   #   #   #   #   #     #   #   #   # #   #   # #       # #   #       #   #   #   #     # # #   #   #   #     #   #
 # # ##### # # ### # ### # ##### ### ### ### ### # ### # ### # ##### # ########### ##### # ### # ##### ### ### #################
   #     # # # # # #   # # #   #   # # #   #     #   #         #   # # #         # #     #   # #     # #       #     #         #
######## # # # # # ### # ### # ##### # ### # ##### ############# ### # # ####### ### ####### # # ##### # ####### ### # ####### #
       # # # # # #   # #     #       #   # #     # #           #     # #   #   #   # #     # # # #     # #       # #   #       #
 # # # # # # # # ### # ################# # # ### # # ######### # ##### ### ### ### # # ##### # # # ##### # ####### ##### #######
 # # # # #   #   #   #   #     #     #     #   # # # #   #     # #   #     #     #   # #     #   # #     # #   #       #       #
 ### # # ####### # ### # # ### ### # ##### ### # # # ### # ##### # # ####### ### ##### # ######### ### ### # ### ### # ####### #
   # # #       # #   # # # #       #     #     #   # #   #     # # # #   #   # #   #   # #       #   #   # # #   #   #       # #
 # # # ####### ##### # # # ############# # ##### ### # ####### ### # # # # ### ### # ### ####### ### ### # # # ### ### ####### #
 # # #         #     # # #         #     # #   #   # #       #     #   # #   #         #     #           #   #   # #   #       #
## # ########### ##### # ########### ##### # # ##### # # # # ########### ### # ####### ##### # ##### ########### # ##### #######
   #     #       #   # #   # #       #   # # #       # # # #   #         #   # #     #             #   #       # #       #     #
 ####### # ### ##### # ### # # ####### ### # ########### # # ### ############# # ### ####### ##### ##### ### # # ############# #
 #   #   # #   #     # #   # # #           # #   #     # # # #   #         # # # #         #     # #     #   # #   # #   #     #
 # # # # # ### # ####### ### # # ### ### ### # # ##### ### # # ### ####### # # # ######### # ### ### ##### ### ### # # # # ### #
   # # # #   # #   #     # #   #   #   # # #   #     #     # # # #     #   #   #   # #   # # # #     #   #   # #   # # #   # # #
###### # ### ##### # ##### # ### # ### # # ######### ####### # # ##### # ######### # # # # # # ####### # ### # # ### # ##### # #
   #   #   # #     #         #   # #   # # # #     # #   #     #   #   # #         #   # # #           # #   # # #   # #     # #
 # # ### # # # ##### ##### ### ### ##### # # # ##### # # ### ### # # ### ########### ### # ### ######### # ##### ### # # ##### #
 #   #   # #   #   # #   #   #   # #   #     #     #   #   #   # # #   #         #   # #   #   #   #     #     # #   # #   # # #
 ##### ########### # # # ### ### # # # ##### ##### ### ### ### ### ### ######### # ### ##### ### # ########### # # ### ### # # #
     # #           #   #   #     #   # #   # #   #   #   # #   #   #   #       #   # # # #   #   #       #     # #   #     # # #
#### # # ##### # ### ##### # ######### # # ### ##### ##### ### # ### ##### ### ##### # # # # # # ####### # ##### ### ####### # #
   # #   #     #   # #   # #       # #   #   #   #   #   #   # #   #     # #         # # # # # # #   #   #   #   #             #
 ### # ### ##### # # # # # ##### # # ####### ### # ### # ### # ### ##### # # ######### # # # # ### # ### ##### ### ### #########
 #   #   #     # #   # # # #     # # #     #     #     #   # # #     #   # #           #   # #   # #   #     # #   #   #       #
 # ########### # ### # # # # ##### # ##### ############### # # # ### # ##### ########### ####### # ### ##### # ##### # # ##### #
   #           #   # # #   # #               #           #   # #   #       #   #               #   #   #   # # #   # # #     # #
#### ########### # ### ##### # ############# # ####### # ##### ########### ### # ##### # ### ####### ### ### # # # # # ##### # #
     #     #     #   #     # # #         #   # #     # #     #       #     #   #     # #   # #       #       #   #   #       # #
#### ##### # ####### ##### # ### ####### ##### ##### # ### ######### ### ### ####### # ### # # # ##### ######### ##### ##### # #
   #   # # # # #     # #   #     #   # # #     #   #   #   #   #   #   # #   #     # # #   # # # #   # #   #     #     #   # # #
 # ### # # # # # ##### # ##### ##### # # # ##### # ##### ### # # # ### # # ####### # # ##### # ### ### # # # # ### ##### # ### #
 #     # # #   #   #   #     #         #   #   # #   # #   # #   #               # # #     # # #   #   # # # #   #   #   #     #
 ####### # ####### ### ##### ##### # ####### # # ### # ### # ######### ####### # # # ##### # # # ### ### # # ### ##### ####### #
 #     # #         #   #   # #     #     #   # #   # # #   #     #     #     # #   #     # # # #   # #   #     #   #   #     # #
 # ### # ########### ### ### # ######### # ### ### # # # # ####### ### # ### # ####### ### # # ### # # ########### # ##### # # #
 # # # #   #             #   #         #   # # #   # #   # #       # # # # # #   #     #   # #     # #     #     # # #     #   #
 # # # # # # ############# ### ####### ### # # # ### ##### # ####### # # # # ### # ##### # ######### # ### # ##### # # #########
 #   # # # # #   #         #         #   # #   #   #     # # #   #     #   #   # #     # # #         # #   # #     # # #   #   #
 ##### # # # # # # ######### # ######### # ####### ##### # # # # # ########### # # ##### # # ########### # # ### ### # # # # # #
     #   #   # # #   #   # # #   #       #   #   # #     # # # # # #   #   #   # # #     # #       #     # #   # #   # # #   # #
#### ####### # # ### # # # # # # # ####### # # ### # ####### # # # # # # # # ### # # ##### ####### # # ### ### # # ### # #######
   # #   #   # #   # # # #   # # #   #     #   #   #   #   # # # #   #   # #   #   # #   # #   #   # # #     #   #   # #       #
 # # # ### ### ### # # # ##### # ### # ######### ##### # # # ### ### ##### ### ### # ### # # # # ##### # # # ####### ######### #
 # # #       #   # #   # #   # #   # # #       #   #     # #   #     #     # #   # #   #   # # #     # # # # #     #       #   #
## # ####### ### ####### # # # ### # # # ######### ####### # # # ##### ### # ### ##### ##### ####### # ### # # # # ##### ### ###
   #   #   #       #   #   # #   # # #   #     # #   # #   # # # #   #   #       #   # #   #   #   #   #   #   # # #   #     # #
 ##### # # ####### # ##### # ##### # ##### ### # ### # # ##### # # ##### # ##### # # ### # ### # # ##### ####### # # # ####### #
 #   # # #       # #     # # #     # #   # # # #     #         #   #     # #     # #     #     # # #   #     # # #   #         #
 # # # # ####### # ##### ### # ##### # # # # # ############### ##### ####### ### # ############### # ##### # # # ##### ##### # #
   #   # #     #   #   #     #     # # #   # #         #       #     #     #   # #   #         #   #     # # # #     #   #   # #
########## ### ### # ############### # ##### ######### ######### ##### ### ##### ### # ######### ####### ### # ##### ### #######
   #       #                 #       #     # #   #   # #   #   #     # #   #     #   #               #   #   # #     # #   #   #
 ### # ################# # # # ##### ##### # # # ### # # # # # ##### # # ### ### # ######### ######### ### ### # ##### ### # # #
     #   #         #   # # # #     #     # #   #     #   #   # # #   # # #   # # # #       # #       #   # #     #   #   # # # #
######## # ####### # # ### # ##### ##### # ######### ######### # # ### # # ### # # ### ### # # ##### ### # ######### ### # # # #
         # #     #   #   # #     #   #   #         #         #   #   # # #   #   #     # # # # #   #     #   #   #   # # #   # #
 ######### ##### ####### # ##### ### # # ######### ### ##### ####### # ##### # ######### # # # ### ######### ### # ### # ##### #
 #     #   #           #   # #   #   # #         #   # #             # #     #     #   #   # #   #           #   #     #       #
## ### # ### ######### ##### # ### ### ### ######### # ############### # ######### # # # ### ### # ########### # ##### ####### #
   #   # # # # #     #   #   #     # #   # #   #     #           #     #   #     # # #   #   #   #   #   #   # #     #         #
 ####### # # # # ### ### # # ####### ### # # # # ############### # ####### # ### # # ##### # # ##### # # # # ##### # ### # #####
         #   #   #         #             #   # #                 #         #   #           #         # #   #       #     #     #
################################################################################################################################
