################################################################################################################################
   #   #   #     #       #   #     #           #     #                 #     #                       #         #       #       #
 # # # # ### ### # ####### # # # # # ######### ##### # ### ### # ### # ##### # ### ##### ### ##### ### ######### # # ### ##### #
 # # #   #   # #   #       #   # # #         #       #   #   # # #   #           # #   #   #     # #   #     #   # #     # #   #
## # ### # ### ##### ########### # ######### ######### ##### ### ########### ### ### # # ####### # # ### ### # ### # ##### # ###
   # #   # #         #     #     #     #     #           #   #   #   #     #   #   # # # #   #   # # # # # #   # # #       #   #
 ### # ### # ######### ### # ######### # ##### # ##### # ##### ### # # ### ##### # # # # # ### ##### # # # ##### # ### # ##### #
 #   #   # # #         #     #   #     #     # # #   # #     #     #     # #   # #   # # #   #       # # #     # # #   #     # #
 ####### # # # ################# # ######### ### # # ####### ############# # # # ##### # ### ######### # # ##### # ########### #
       #   # # #     #         #   #     #   #   # # #   #   #   #   #   #   # #   #   #     #     # # # #     # # #           #
###### ### # # # ##### ####### # ### ##### ### ### # # ### # # # # # # # # ### ##### ##### ####### # # # # ### # # # ######### #
     #   #   #   #   # #     #         #   #   # # # #     # # #   #   # # # #     #     #             # #   # # # #   #   #   #
 ####### ######### # # # ### ### ##### # ### ### # # ######### ######### # # ##### ##### ### ########### ### # # # ### ### # ###
 #     # #         # # #   #   # #   # #   #     # #   #     # #     #   #   #     #   #   #       #     #   # # # # #     # # #
 # ### # # ######### # # ### # # # # ##### ##### # ### # ### ### ### # ### ### ####### # # # # # ### ####### # # # # ####### # #
   #   #   #   #   #   # #   # # # #     # #   # #   # #   # #   # # #   #   #       # # # # # #   #       # #   # # #     #   #
#### ####### # # ####### # ##### # ####### # # # ### # ### # # ### # ### ##### ##### # ### # ##### ####### # ##### # # ##### ###
     # #   # #           # #   # #     #   # #       # #   #   # # #     #   # #   # # #   #   #   #       #     # # #         #
 ##### # # # ####### ### ### # # ##### # ### ####### # # ####### # ####### # # # ### # # ##### # ### ####### ##### # ######### #
 #   #   #   #     # #   #   #   #   # # #   #     # #   #   #   #   #   # # # #   # #   #     #   # #       #   # #           #
 # # ######### ### ### # # ####### ### # # # # ### # ##### # # ##### # # # # # ### # ##### ##### # # # ####### # # #############
   #   #     # #       # #             #   # #   # # #   # #       # # #   # #   #   # #   #     # # #   #     # #             #
###### # ### # # ####### ####### ##### ##### ### # # # # ######### # # ##### ######### # ######### # ### # ####### ########### #
   #   # # # # # #   #           #             # # #   #       # # # # #   #   #     #   #       # #   # #       #   #         #
 # # ### # # # ### # # ##### ### # ########### # # ########### # # # # # # ### # ### ##### ##### ##### # ####### ### # #########
 # #     #     #   # #   #   #   # #   #     # # #   #   #   # #     # # #   #   #   #     #   #   #   # #   #   #   # #   #   #
 # ####### ##### ### ### # ### ### ### # ### # # ### # # # # # ### ### # ### ##### ### ##### # ### # ### ### # ####### # # ### #
 #       # #     #     # #   #   #   #   #     # # # # # # # #   # # # # #   #   #   #       #   #   #       # #       # #   # #
 ### # # # # ### ##### ##### ####### ##### ##### # # ### # # ### # # # ### # # # ### ########### ####### ### # ### ##### ### # #
 #   # #   # #   #   #       #     #   #     #   # #   #   #     #   #     # # # #   #     #     #       #   #     #     #   # #
 ### # ##### ##### # ### ##### ### ### # ### # # # ### # ########### ####### ### # ### # ### ##### # ##### # ######### # # ### #
   # #     # #     # #   #     # #     # #   # # # # # # # #   #     #     #     #     # #   #   # #     # # # #       # #   # #
## ####### # # ##### # ### ##### ####### # ### ### # # # # # # # ##### ### # ########### # ### ### ####### # # # # ##### ### # #
 #   #     #   #     #   # #   #         #   #     # # # #   #   #     # #   #         # #   #     #     # # #   # #     # # # #
 ### # ######### ##### # # # ### # # ### ### ####### # # # ####### ##### ##### ####### # ### ####### ### # # ##### # ##### # # #
 #   # # #   #   #     # # #     # #   # #       #     # #   #   #   #     #   #     # # #   #     # #     #       # #     # # #
 # # # # # # ########### # ####### ### ### ####### ##### ### # # ### # ##### ####### # ### ### ### # ############# # # ### # # #
 # # # # # # #       #   # # #   #   #   # #   #   #       #   #   #   #   #       # #     # # #   # #     # #   # # #   # #   #
 # ### # # # # ##### # ### # # # # # ### # ### # ######### # ######### # # ####### # ####### # # ##### ### # # ### # ##### ### #
   #   # # # #   # # # #   #   #   #   # # #   #         # #         # # #       #     #   #   #       #   #     # #     #   # #
## # ### # # ### # # ### ####### ####### # # ########### # # ######### # ### ######### # ### ########### ####### # ##### ### # #
   #     # #   # # # #   #       #     # #   #   # #     #   #   #     #   # #       # # #   #         # #   # #   #   # # # # #
 # ####### ### # # # # ######### # ### ### ##### # # ##### ### # # ######### # # # ### # # ### ####### ### # # ### # # # # # # #
 # #       # # # #     #   #   # # # #   #       # #     #     # #       #   # # # #   # # #   #     #     # #     # #   # # # #
## # # ##### # # # ##### # # # ### # ### # ####### ##### # ####### ####### ### # ### ### # # ### ### ####### ### ### ##### # # #
   # # #     # # #   #   #   #   # # #   #         #     #         #     #   # #     #       # #   #         #   #   #       # #
 # # ### ##### # ##### ### # ### # # # ##### # ##### ############# # ### ### # ############### ### ########### ### ##### ##### #
 # #     #     #   #   #   # #   #   # #     # #   #                   #   # #   #   #   #         #         #   #     # #   # #
 ######### ####### # ####### # ##### # ####### # # ################### ##### ### # ### # ### ############# # ### ##### # # # # #
         #       # #     #   #     # #     #   # # #   #       #   #     #     # # #   #   #             # # #       # #   #   #
 # # # # ####### # ##### # ##### ### ##### ##### ### # # ##### # # # # ### ##### # # ##### ############# # # ######### # #######
 # # # #   #   #   #     # #   #     #   #   #   #   #   # #   # #   # #   # #   #     # # #     #       # # #         #       #
## # # ### # # ##### ##### # # ######### ### # ### ####### # ######### # ### # ####### # # # # ### ######### # ############### #
   # # #   # #     # #   #   #     #   #   # #   # #       #   #   #     #   # #   #     # # #   # # #     #   #             # #
 ##### ##### ####### # # ### ### ### # ### # ### # ### ####### # # ##### ### # # # # ##### # ### # # # ### ##### ########### # #
 #   #         #   # # #   #   #     # #   #   #   #   #     # # # #   #     #   # # #     # #   # # # # #       #   #     #   #
 ### # ######### # # ##### # # ####### # ##### ##### # # ### # # # # # ##### ##### # ####### ##### # # # ######### # # # #######
 #   #   #   #   # #       # #       # # #   #     # # #   #   # #   #   # # # #   #     #     #   # # #         # #   #       #
 # ####### # # ### ######### # ####### # # # ##### ### ### ##### ####### # # # # ####### # ### # ### # # # ##### # #############
 #   #   # # #   # #         #   #     #   # #   #   #         #     #   #     #   #   # # #   #   #     # #   # #     #   #   #
 ### # # # # ### # ##### ### # ### ##### ### # # ### ######### ####### ### ####### # ### # ####### ####### # # # ##### # # # # #
     # #   #     #       #   # #   #     #   # #   # #   #   # # #                 #     #       #   #   #   # #       # #   # #
#### # ################# # ### # ### ### ##### ### # # # # # # # # ##### ##### ##### ##### ### # ### # # # ### ######### ##### #
   # # #     #     #     # #   #   # # # #     #   #   # # # # # # #   #     #       # #   # # #   # # #     #     #   # # #   #
 # # # ### # # ##### # ### # ##### # # # # ##### ####### ### # # # # # ### # ##### ### # # # # # # # ### ### ##### # # # # # ###
 # # #   # # #       # # # # #   # #   #     # # #     #     #     # #   # #     #     # # #   # # #   #   #     #   # # #   # #
 # # ### # # ####### # # # ### # # ######### # # # # ######### ##### ### # ##### # ### # # ####### ### # # ##### ##### # ##### #
 # #   # # # #       #   #     # #         # #   # #                 #   #     # #  G#   #       # #   # # #   # #   # # #     #
## ##### # # # ##### ########### ######### # ##### ######### # ################# # ############# ### ### ### # ### # # # ### ###
   #     # # # #     #         #     #   # #             #   #               #   #           # #     # #   # #   # # # #   # # #
 ### ####### # # ##### # ##### ### # # ### # ########### ################### # ######### # # # ####### ### # ### ### # ### # # #
 #   #       # # #     # # #   #   # #     # #   #     # #     #     #       # #       # # #   #               #   # #   # # # #
 # ### # ##### # # ##### # # # # ########### # # # ### # # ### # ### # ####### ####### # ### ##### ########### ### # # ### # # #
   #   # #     #   #   # #   # # #   #   #   # # # #     # #   # #     # #   #       # #   #     # #   #     #   # #   #   #   #
###### # # ##### ### ### ### ### # # # # # ### # # # # ### # ### ####### # # ####### # ### # ### ### # # ### ### # ### # ### ###
       # #     #   #   #   # #   # # # #   #   # # # # #   # # #     # #   #       #   #   #   #   # # #   # #   #   # #       #
######## ##### # # ### ### ### ##### # ##### ### ### # # ### # ##### # ########### ##### ### # ### ### ##### # ##### ### ##### #
   #   # #     # #   #   #   # #     #   #   # #     # # #   # #     #     #     # #   # #   # # #     #           #     #   # #
 # # # # # ##### ####### ### # # ####### # ### ####### # ##### # ##### ##### ### # # # # # # # # ####### ######### ####### # ###
 #   # # # #       #   # # # #   #     # # #       #   #   #   # # #     #   # #   # # # # # #   #   #       #   # #       #   #
###### # # ##### # # # # # # ######### ### ####### # ##### # ### # # ### # ### ##### ### # # ##### # # ##### # # ### ######### #
   # # # # #   # #   #     #         #     #     # # #     #     # #   # #     # #   #   # # #   # #   #   #   #   # #   #     #
 # # # # # # # # ######### # ####### ####### ### # # # ########### ### # ##### # # ### ### # ### # ##### # ####### # # ### #####
 # #     # # #       #   # #       #   #       #   # # #         #   # #             #   # #     # #   # #   # #   # #   # #   #
 # ##### # # ######### # ######### # ### # ### ##### # # ####### # ### ######### ####### ##### ### # # # ### # # # # ### # ### #
 #   # # # # #   #   # #   #       #     # # # #     #   #       #   # #   #   #   #   #     #       # #   #   # # #     #   # #
 ### # # # # # # # # # ### ######### ##### # # # ######### ######### # # ### # ### # # ##### ####### # ####### # # ######### # #
 #   #   # #   # # # # # #         # #   # #   # #         #   #   #     #   #   # # #     #       # #         # #     #   #   #
## ##### # ####### # # # ######### # # # # ##### # ######### # ### # ##### ##### ### # # ######### # ########### # ##### # ### #
   #   # # #   #   #   # #         #   # #       # #         #       #     #   # #   # # #   #     # #     #   # # #     #   # #
 ### # # # # # # ####### # ##### ##### ########### # ### # ########### ##### # # # ### # # # # ##### # ### ### # ### ##### ### #
     #   #   # # #   #   #   #   #   # #           # #   #   #       #     # # #   #   # # # #   #   # #   #   #     #   #   # #
## ### ####### # # # # ##### ##### # ### ########### # ##### # ##### ##### # ####### ### # ##### # # # # ### ######### # ### # #
   #   #   #   # # # #     #       #     #           # #   # # #   #       #     #   #   # #     # #  S# #   #   #     #   #   #
## # # # ### # # # # ### ################# # # ### # # # # # # # # ######### ##### ####### # ##### ##### # ### # ######### #####
   # #     # # # # #   # #     #   # #     # #   # # #   # #   # #           #   #         #     # #   #   #   #   #   # #     #
 ### ##### # ### # ### # # ##### # # # ##### ##### # ##### # ### ### # ##### # # ############### # # ####### ##### # # # ##### #
 #   #     #     # #     # #     #   # #     #     #   # # #       # #   #   # #   #     #   #   # #   #     #   #   # #   #   #
 # ### ### ######### ##### # ######### # ##### ##### # # # # ##### # ### ##### ### ##### # ### ### ### ####### # ##### # # # ###
 # # #   #         #   #   #   #       #     #     # #   # #     # # #   #     # # #     #   #   #     #     # # #   # # # #   #
## # ### ######### ### # ##### # ########### ##### # ##### ##### # ### ### ##### # # ####### ### ##### # ### # # # # # # ##### #
   # # #     #               # # # #   #     #     #   #   #     #   #   #   #   # #   # #   # #     # # #   # #   # # #       #
 ### # ##### # # ######### ### # # # ### ##### # ##### # ########### ### ### ### # ### # # # # ##### # ### ######### # ### #####
 #   #   # # # #   #     #       #   #   #     # #   # #     #     #   #     #   #   # # # # #   #   #   # #         #   # #   #
 # ##### # # ##### # ### ####### ### # ########### # ####### # ### ### ### ### ### # # # # # ### # ### # # # ### ####### # # # #
   #   # # #   #   #   # #     # #   #           # # #     #   # #   #   #     #   # # #   # #   # #   #   #   #         #   # #
 ##### # # ### # ##### # # ### # # # ########### # # # ### # ### ### ### # ### # ##### ##### # ### # ####### # ### # # ####### #
     # # # #   #     # # #   # #   #       #   #   # # # # #       #   # # #   #             #   # # #   # # # #   # #       # #
 ### # # # # ##### # # # ##### ##### ##### # ####### # # # # ##### ### # ### ############# ### ### # ### # # # ##### ####### # #
   #   #   # # #   # # #       #     #   #   #     # # # # # #   #   # #   #   #   #     # #   #   # #   #   # #   #       # # #
 # ##### ### # # ### # ######### ##### # ### # ### ### # # ### # ##### ### ##### # # ### # # ### ### # ### ##### # # ##### # # #
 # #     #   # # #   #     #     #   # #   # #   #     # # #   #     #   #   #   # # # # #   #   #     #   #     # #     # # # #
 # # ##### ### # # # ##### # # ### # # ### # ### ##### # # # ####### ### ### # ##### # # ##### ### # ### # # ##### # # ### # # #
 #   #     # #   # #   #   # #     # #   # #   #   #   # # # #         #   # #       # # #   # #   #   # # # #   # # #   # #   #
 ##### ##### ##### ### # ####### ##### # # # # ### ##### # # ######### # # ########### # # # # ##### # # # # # # # # ### # #####
     #   #   #     # # #   #   # #   # # #   #   #       # # #       # # #       #   # # # # #     # # # #   # #   # #   #     #
 ### ### # ##### # # # ### # # ### # ### # ##### ######### # # ####### ##### ##### ### # # # # ### # # # ##### ####### # ##### #
 # # #   #       #   #   #   #     # #   # #   #       #   # #   # #   #   # #     #   # # # #   # # #   #   # # #     #   #   #
 # # # ############### # ########### # ### # # # ####### ### ### # # ### # # # ##### ### # # ##### # ####### # # # ####### # # #
 #   #               # #   #     #   # #   # # # #         #   # # # #   #   #     # # #   #     # #   #   # # # #   #     # # #
 ################### # # ### # ### ### ### # # ### ########### # # # # ######### ### # ######### # # # # # # # # ### # # ### ###
       #   # #       # # #   # #   #     # # #   # # #       #   # # #       #   #   #       # #   # #   #   # #     # #   #   #
 ##### # # # # ####### # # ##### ####### # # ### # # # ##### ##### # ######### ### ### ##### # ##### # ##### # ########### ### #
   #   # #   # #   # # #   # #   #     # # # # #     #   #   #     #     #     #   #   #         #   # #   # #     #   #     # #
 ### ### ##### ### # # ##### # ### ### ### # # ########### ### ### ##### # ##### ### # ####### # # ##### # ####### # # ####### #
   #   # #   # #   # #   #   #   # # #   # #   #   #       #   # #   #   # #   #     # #       # #   #   #         # # #   #   #
 # ### # # # # # ### # # # ##### # # ### # ### # # # ####### ### ##### ### # # ####### # ####### ##### ############# # # # # # #
 #   #     # #   #     #       #   #             #                           #         #       #       #             #   #   # #
