################################################################################################################################
################################################################################################################################
#     #   #     # #   #         #         #   #           #                                           #   #         #   #       
# ##### # # ### # # # ### ##### ######### # # # ######### ############################# # ######### # ### # ##### # ### # ######
# #   # #   # # #   #     #   # #   #   # # #   #   #   #   #         #     #   #   #   #   #     # #       #     #         #   
# # # # ##### # # ##### ##### # # # # # # # ### # # # # ### # ####### # ### # # # ### # ### # ### # ####### ########### ##### # 
# # # # #     # # #   # #   #     #   #   #   #   # # # # #   # #   # # # #   # #     #   #   #   #   #   # #         # #   # # 
# # # # # # # # # # # ### # # ##### ####### # ### # # # # ##### # # # # # ##### ######### ##### # ### # # # # ####### ### # # # 
#   #   # # # # # # #   # #   #   #       # #   # #   # #   # #   #   #   #   #       #   #   # #   # # #       #   #   # #   # 
# ######### # # ### ### ##### # # # ##### # ### # ##### ### # ############### ####### ##### # # ### # # ####### # # ### # ##### 
# #   #   # # #   # #       # # # #     #   #   #     #     #   #       #                   #   #   # # #   #   # # #   #   # # 
# # # # # # # ### # ####### # # # # # ####### ########### ### # # ##### ### # # ### ################# # # # ### # # ####### # # 
# # # # #   # #   #     # # #   # # #       # #         #     # #   #   #   # # #   #               # # # #   #   #   #     # # 
# # # # ##### ######### # # # ### # ######### # ####### # ######### ##### # # ### ### ############# # # # ### ####### # ##### # 
#   #   #   #           # # # # # #       #   # #       #         #   #   # #   # # #       #   #   # # #   # #     # #       # 
########### ############# # # # # # ####### ##### ####### ####### ### ######### # # ####### # # # ##### ##### # ##### ######### 
#   #   #   #   #         # #   # # #    S# #     #         #   #   # #     #   #   #   #   # #   #     #     #           #   # 
# # # # # ### # # ####### # ### # ### ### # # ##### # # ##### # # # # # ### ######### # # ### ########### ############# ### # # 
# # # #   #   # #       # # # # #     #   #   #     # #       # # # # #   #   #       # # #   #     #   # #         #   #   #   
# # ##### # ### ### ##### # # # ############### ##### ######### # ### ### ### # ####### ### ### ### # # # # ####### # # # ######
# # #     # # #     #     # #   #       #       #           #   #   # #   #   # #             # # #   #   #   # #   # # # #     
### # ### # # ####### ##### ### # ##### ######### ######### # ##### # ##### ##### ######### ### # ########### # # ##### # # ### 
#   #   # # #     #   #   #     # #   #       # #         # #     #         #     #       #     # #         #   #     #   #   # 
# ##### # # ##### # ### # ##### # # ######### # # ####### # ########### ##### ##### ##### # ##### # ####### ######### # ##### ##
#       # #   # #   #   #     # #   #       # # #   #   # #   # #     #   #   #   #   #   #     #   #   #   #     #     #   #   
######### ### # ############# # ##### ### ### # ### # ### ### # # ### ### # ### # ##### ### ### ##### ### ### ### ### ### ##### 
#   #     # # #         #           #   #   # #     #   #   #   #   #   # # #   #     # # #   #   #   #   #   # #   # #   #     
# # # ##### # # # ##### # ##### # ##### ### # ######### ### # ##### ### # # # ####### # # # # ### # # # ### ### ### # # ### ####
# # #       #   # #   #   #   # #     #   #   #       #     #   #   # # #   # #   # #   #   #   #   #   #   #   # # #       #   
# # # ##### ##### # # ##### # # ##### ### ##### ##### ########### ### # ##### # # # ########### ############# # # # ####### # # 
# # # #           # # #     # # #     # #   # # #   #   #    G    # # #       # #   #             #   #   #   #   #       #   # 
# # ### ### ####### ### ##### # ####### ### # # ### ### # ######### # ############# # # ### ### # ### # # # ############# ##### 
# #     #   #     #     # #   #               #   #   # # #               #       #   #   # # # #     # # #   #         # #   # 
# ####### ### ### ####### # ############# ### ### ### # # # ######### ### # # ### ### ##### # # # ####### ### # ##### ### # # # 
#     #   #   # #   #   #   #   #         #     #     #   # #       #   #   # # #   # #   # #   # #       #   #     #     # #   
##### # # # ### ### # # # ### # ##### ##### ### ##### ####### ##### # # ### # # ### ### # # ##### # ####### ####### ########### 
#   # # # # #   #   # # # #   #     #   # # # # #   #   #   #     # # # #   # #   # #   # #     #             #     #           
# ### # # # # ### ### # # # ####### ### # # # # # # ### ### ##### # ### # ### ### # # ### ##### ####### # # # # ##### ##########
#     # # #   #       # #   #         #   # # # # # #   #   #   # #     # #   #   #   # # #   #   #     # # #       # #     #   
# ##### ####### ########### ######### ##### # # # # # ### ### # # ######### ### ####### # # # # # ####### ####### ### # ### # # 
# #   #         #   #   #   #     # #     #   #   # #   # #   # #     #     #   #       # # # # #       #   #   #     #   # # # 
### # ########### # # # ### # ### # ##### ##### ####### # # ### ####### ####### # # ### # # # ######### ### # # ### ### # # # # 
#   # #           #   #   # # #   #     #     # #   #   # #   #         #       # # #   #   #           # # # #   #     # #   # 
# ### # ################# ### ####### # ##### # # # # ### # # ########### # ##### # ##################### # ##### ####### # ### 
# # #   #   #   #       #   #   #   # #           #   #   # # #           #     # # #   #   #         #   #       #   #   # #   
# # ##### # ### ####### ### ### ### # ################# ### # # ############### # # # # # # # ####### # ########### ### ### # ##
# #   #   #   #     #   # #     #   # #         #   # # #   # #     #   #     # # # # #   #   #   #   # #       # #     #   #   
# ### # ##### ##### # # # ####### ### # ####### # # # # ##### ##### # # # ##### # # # ########### # ### # ##### # ############# 
#   #   #   #     # # # #             # # #   #   # #   #     #   #   # #   #   # # # #   #     #   #   #   #   #           #   
### ### # # # ### # ### # ##### ### ### # # # # ### # ### ##### # ##### ### # # # # # # # # ### # ### # ### ####### ####### # # 
# #   #   # #   #       #     #   #       # # # #   # #   # #   # #   # # # # # # # # # #     # # #   # # #       # # #   #   # 
# ### ### # ######### ### ### ### ######### # ### ### # ### # ### # ### # # # ### ### # ####### # # ### # ####### # # # ####### 
#   #   # # #       #       # #   # #   #   # #   #   # #   # # #   #   #   #   #   # # #       # #   # #       #   #   #       
# # ### # ### ##### # ##### # ##### # # # ### # ### ### # ### # ##### ##### ### ### # # # ####### ### # # ##### ##### ### ##### 
# # #   #   #   #   # #     #   #     #   #   # #   #   # #   # #     #   # #   #   #   # # #   # #   # # #     #   #     #     
# # # ##### ##### ### ####### # ########### ### # ### ### # ### # ##### # # # ### ####### # # ### # ### # # ##### ######### # ##
# # #     #       #       # # # #     #   #     # #   #   # #   #     # # # # #       #   #   #   #   #   #   #     #   #   #   
# # ##### # ############# # # # # ### # # ####### ### ### # # ####### # # # # # ####### ##### # ##### ####### # ### ### # # ### 
# #       #     #     # # #   # #   #   #     #       #       #     # # #   # #   #     #   #       #     # # #   #     # #   # 
# ############# # ### # # ##### ### ######### ######### ##### # ##### ### ### ### # ##### # ####### ##### # # ### ####### ##### 
# #             # #   # # #       #     #   # #   #     # #           #   #   #   # #     #   #   #       # #   #         #     
# # ##### ##### ### ### # # ##### ##### ### # # # # ### # # ######### # ### ### ### # ####### # # ######### ### ####### ### ### 
# # #     #   #     # #   # # #     #   #   #   # #   #   #   #     # #   #     # #   # #     # # #     #   # # # #     #   #   
# # # ##### # ####### ##### # # ### # ### # ##### ############# ### # ### ####### ##### # ####### # ### # # # # # # # ### ### # 
# # # #     #       #       # #   # # #   # #   #       #       #   # #   #   # #       #   #     # #   # #   # #   # # # # # # 
# ### # ### ##### ### ####### ### ### # ### ### ####### # ####### ### # # # # # # ##### ### # ##### ##### ##### ##### # # # # # 
# #   #   #     # #   #     #   #   #   # #   # #     # # #   #   #     #   # #   #   #   #   #         # # #   #   #   # #   # 
# # ##### ##### # # ####### ### ### ##### ### # # ##### # ### # ### # ####### ### # # ######### # ##### # # # ### # ### # ##### 
#   #     #   # # # #                 #       # #       #     #   # # #     #       # #   #   # # #     #   #     #   # #   #   
##### ##### # # # # ################### ####### ################# ### # ### ##### ##### # # # # # # ### # ########### # ### # ##
#     #   # # # # #         #   #   #   #   #   #     #     #   #   # #   #     #   #   #   # # # #   #   #       #   #   # #   
# # ##### # # # # ######### # # # # # ##### # ### ##### # ### # ### ##### ##### # # # ####### # # ##### ### ### ### ####### # # 
# #     #   # # #         #   # # #   #   # #         # #   # #   #     # #     # # #   #   # # # #   # #   #   #   #     # # # 
# ##### ##### # # ####### ##### # ##### # # ### ##### # ### # ### ##### ### ##### ####### # # # ### # # # ### ### ##### # # # # 
#   #   #       # #   #       # # #     # # #   #   # # #   # #   #   #   #     #     #   #   # #   # # # # #     #     # # # # 
# # ############### # # # ##### # # ##### # # ### # # # # ### # # # # ### ##### ##### # ####### # ### # # # ####### ##### # ### 
# # #   #       #   # # # #   #   # #     # # #   # #   #     # # # #   #     #       #         #   #   #     #     #       #   
# # # # # ##### # ### # # # # ##### # ##### ### ### # ######### # # ######### # ##### ##### ####### ### ##### ##### ######### ##
# #   #   #   # # #   # # # #     # #   #   #   #   # #   #     # # #   #     # #           #       # # #   #     #       #   # 
# ######### # # # ##### ### ##### # ### # ### ### ### # # ######### # # # ####### # # ### ### ##### # # # # ##### ####### # # # 
#   #     # #   #     #   #     #   #   #   #   # #     #   #   #   # # #   #     # #   #   #   #   # #   #     # #       # # # 
# ### ### # ######### # # ##### ##### ##### ### # ### ##### # # # ### # ### ### ### ### ####### ##### ##### ### # # ####### # # 
#   #   # # #         # #     #   #   #     #   #     #   #   # # # # #     #   #     #   #   #     # #     #   #   #   #   # # 
# # ##### # # ######### ### ##### # ####### # ####### # # ##### # # # ####### ### # ##### # # ##### # # ##### # ####### # # ### 
# # #   #   #     #   #   #     # #   #   #   #     # # #     # # # #       # #   # #   # # #     #   #   # # #   #     # #     
# # # # ### ##### # # ########### ### # # ##### ### # # ##### ### # ####### # ##### # ### # ##### ####### # # ### # ##### ######
# #   # #     #   # # #           # #   # #     # #   #   # # #   #     #   #     #   #   # #     #     #   #   # #         #   
# ##### ##### # ### # # ########### ##### # ##### ####### # # # ####### # ### ### ### # ### # ##### ### ####### # ####### # ### 
# #     #   # #   # # #     #         # # #             #   # #   #   # # #     #   # #   # #   #   # # #   #   #         #   # 
# ####### ### ### # ####### # ####### # # # ##### ######### ##### # # # # # ####### # ##### ### # ### # # # # ##### # ####### # 
#       # #   #   #         #   #   #   # # #   #         #   # #   # # # # #     # #   #   #   # # #   # #   #   # # #     #   
# ##### # # ### ############# ### # ##### ### # ######### ### # ##### # # ### ### # ##### ####### # # ### ### # # ### # ########
# #   # # #   # #           #     #     #   # #   #   #     #     #   # #     # # #   #   #   #   # #   # #   # # #   #     #   
# # ### # ### # ### # ### # # ######### ### # ### # ### # # ##### # ### ####### # ### # ### # ### # ### # # # # # # # ##### # ##
# #     # #   #   # #   # # #     #   #   #   #   #     # #       #   # #   #   #     # #   #     # #   # # # # #   # # #   #   
# ####### # # ### ####### # ##### ### # ####### ######### # ##### ### # # # # ####### # # ######### # ### ### # ##### # # ### # 
#   #   #   # # # #       # # #   #   #       #           # #     #   # # # #     #   #   #   #       #     # #     #   #   # # 
### # # ##### # # # ####### # # ### # ####### ########### ### ### # ### # # ##### ### ##### ### ####### # # ####### ####### # ##
# # # #   #     # # #   # # # #     #       # #     #     #   #   # #     #     #         #   # #       # #   #   #     #   #   
# # # ### ####### # # # # # # ############# # # ##### ##### # # # # ### ############# ### # # # # ####### ### # # ##### # ##### 
#       # #       # # #               #     # #     # #   # # # # #     #   #       #   # # # # #   #     #   # #     #   # #   
####### # # ####### ####### ########### ########### # # # # ### # ##### # # # ######### # # # # ##### ### # ### ##### ##### # ##
#     # # #   #   #       # #         #     #   #   # # #   #   #         # #           #   # # #   # #   # #   #   #   #     # 
# ### # ##### # # ####### # # ####### ##### # ### ### # ##### ######### ############### ##### # # # # # ### ##### # # ### ##### 
# #   #   #   # #         # #     # #           #     # #   #   #     # #       #           # # # # # #   #   #   # # #   #     
# # ##### # ### ########### ##### # ####### ### ##### # # # ### # ### # # # # # ##### ##### # # # # # ### ### # ### # # ### ####
# #     # # #     #             # #     #   #         #   # #   # #   #   # # #       #     # #   # #   #   # # #   # #   # #   
# ##### # # ### # # ### ####### # ##### # ### ############### # # # ####### # ######### ##### ##### ### ##### # # ### ### # # # 
#   # # # #   # # #   # #   #   #       #   # #     #     #   # # # #   #   # #   #     #   #   #   #   #   # # # # # # # # # # 
### # # # ### ### ### # # # ### ########### # # ### # ### # ##### # ### # # # # ### ####### ### # ####### # # # # # # # # # # # 
#   # # # # #       # # # #     #   #   #   # #   # # # # #   #   #     # # #   #   #     #   # #   #     #   # #   # # #   # # 
# ### # # # ####### # ### ##### # # # # # ### ### # # # # ### # ######### # ##### ### ### ### # ### # ######### ##### # ### # ##
#   # # # #         #   # #   #   #   # # #   # # #   # # #   #   #       #     #   # # #   # #   #   #   # #   #           #   
### # # # # ####### ### # # # ######### # # ### # ##### # # ##### # ############### # # ### # # ####### # # # ### ##### ####### 
# # # # # # #   #   #   # # #   #     #   # #   #   # #     #   # #     #           #   #     #   #     # # #     #   #   #     
# # # # # # # # # ### # # # ### ### # ### # # ##### # # ##### ### ####### ############### ####### ####### # ### ### # # ### ####
# # #   #   # # # #   # # #   # #   #     # # #   # #   #   # #   #     # #   #     #   #   #   # #   #   #     #   #           
# # ####### # # ### ### # ### # # ### ##### # ### # ##### # # # ### ### # # # ### # # ##### # # # # # # ######### ##### ####### 
#   #     # # #     #   # #   # #   #     # #   # #       #   #   #   #   # #     #           # #   #   #   #   # #     #   # # 
# ### ### ### ####### ### # ### # # ##### # ### # ############### ### ######### ####### ##### ############# # # ### ##### # # # 
#   # # # #   #   # #   # # #   # #     # #   #   #             # #   # #     # #     # #   #   #         #   #   #     # # # # 
### # # # # ### # # ### # # ########### # # ##### # ##### ### # # # ### # ### ### ### ### # ### # ####### ####### # ### # # # # 
#   # # #   # # #   #   # #   #       # # #       #     #   # # #   #   # # # #   # #   # # # #   #       #     # # #   # # #   
# ### # ##### # ##### ### ### # ####### # ############# ### ### ##### # # # # # ### ### # # # ##### ####### ### # # ##### # ####
#     #       #     #   #   # # #       #       #   #   #   #   #     # #   # # #     # # # #     # #     # # #   # #     #     
############# ##### ### # ### # # ##### # ####### # # ### ### # # ### # ##### ### # ### ### # ##### # ##### # ##### # ######### 
#                       #     #   #     #         #   #   #   #   #   #           #                                   #         
################################################################################################################################
