################################################################################################################################
################################################################################################################################
                   # #         #   #           #                 #   #           #   #       #       #                       # #
 ####### ######### # # ####### # ### ### # # ### ######### ####### # # # ### # # ### # ##### # # # # ### ################### # #
   #   #         #   #   #   # #     #   # #     #         #       #   # #   # #     #   #   # # # # #   #         #   #     # #
## # # ########### ### ### # # # ##### ### ####### ##### ### ##### ##### ##### ####### ### ##### # # # ### ####### # # # ##### #
   # #   #       # #   #   # # #     # #   #     #     # #   #   # #   #     # #   #   #   #     # # # # #       # # # #     # #
 ### ### # ##### # # ### ### # ##### # ##### ### ### # ### ### # # # # ##### ### # # ### ######### # # # ####### ### ####### # #
       # #   #   # # # # #   # #     #   #   # #   # #       # # # # #     #     #   #   #     #   #   #                 # #   #
###### ##### # ##### # # # ### # ####### # ### ### # ######### # # # ##### ########### ### ### # ######### # ########### # ### #
   #     #   #       #   #     # #     #   #     # # #   #     # # # #   #           # #   #   # #   #     #   #   #     #   # #
 # ##### # ##################### # # ########### # # # # # ##### # # # # ####### ### # ####### # # # ##### ##### # ##### ### # #
 #   #               #           # #     #       # # # #     #   #   # #   #     # # #       #   # # #   # #   # # #   #     # #
 ### # # ######### ### ########### ####### ####### # # ####### ####### ##### ##### # ####### ##### # # # ### # # # # # ##### # #
 #   # # #   #   #         #     # #       # #     # # #     # # #     #     #   #         # #   # # # #   # #   #   # #   # # #
## ##### # # # # ####### ### # # # # ####### # ####### # ### # # # ##### ##### # ####### # # # # # ### ### # ######### # # # # #
         # # # #       #     # # # #   #     #         # # # # # #     #       #   # #   # #   # #     # #   # #       # # #   #
 ######### # ######### # ##### # # ### # ############### # # # # ##### ### ####### # # # ####### ####### ##### # ####### # ### #
 #       # #       #   #   # # #   #   #       #   #   #   #   #     #   #   #     #   # #       #     #   #   # #       #     #
 # ##### # ##### ### ##### # # ##### ##### ##### # # ########### ####### ##### ######### # ####### ### ### # ### ############# #
 #     #     # # #   #     # #             #     # #     #       #   # #       #         # #     #   # #     #   #   #         #
 # ######### # # # ##### ### ######### ##### ##### ##### ##### ### # # ########### ### # # ##### # # # ##### # ### # # ####### #
 # #       #   #   #   #     #   #   #     # # #   # #   #     #   #         #   # #   # # #     # # #   #   #   # # #   #     #
 # # ##### ####### # # # ##### # # # ##### # # # ### # ### ##### ########### # # ### ### # # ####### ### # ##### # # ##### ### #
   # #     #     # # # # #   # # # #     # #   # #             #       #   # # #     #   # # #       #   #     # # #     #   # #
 ### # ##### ### ### # # # # ### # ##### ####### # ########### ####### # # # # ####### # # # ######### ####### # # ##### ### # #
     #     # # #   # # #   # #   # #   #     #   # #         #       #   # #   #       # # #     # #   #     # # #     #     # #
 ########### # ### # # ##### # ### # # ##### # ### # ####### # ### ####### ######### # # # ##### # # ####### # # ############# #
     #       #   #   #     #     #   #   # #   #   # #     # #   #       # # #   #   # # #   # # #     #   #   # #       #   # #
 ### # ######### ######### ############# # ##### ### # ##### ### ######### # # # # # # # ### # # ##### # # # ### # ##### # # # #
 #   #       # #           #         # # # #   #   # # #     #   #         #   # # # # #   # #     #   # # # #   # #   #   #   #
 ########### # ############# ####### # # # ### ### # # # ##### ### ############# ### # ### # ##### # ### # # # ##### # ####### #
     #     #       #         #   #   # # # #   #   #   #   # # #   #   #     # # #   #   # #   #         # # #   #   # # #   # #
#### # ########### # ####### # ### ### # # # ### ### ##### # # # ### ### ### # # # ##### # ### # ######### # ### # ### # # # # #
     # #     #     #   #     #   #       # #   #   # #     #   #   #   # # #   # #   #   #   # #     #   #   #   # # # #   #   #
 ##### # ##### ######### ####### ##### # # ### ### # # ########### ### # # ##### ##### ##### # # ### # # ### # ### # # # #######
     # #     #   #       #             # #   #     # #   #   #     #   #     # #       #     # #   # # #   # #     # # # #     #
 ### # ##### ### # ######### ####### # # ### ##### # ##### # # ##### # ##### # ######### # ### # # ### ### # ####### # # ##### #
   # # #       #   #         #       # #     #     #   #   # #   #   #     #   #         # # # # #     #   # #     #   #       #
## # # # ##### ######### # ########### ####### ####### # ##### # # # ##### ### # # # ##### # # # ####### ### # # ### ######### #
 # # #   #               #       #   #     #   #     # #     # # # #     #   # # # #     #   # #   #   # #   # # #   #       # #
 # ### ### # ### # ########### # # # ##### # ### ### # ##### # # # ####### ### # ############# ### ### # ##### # # ### # ### # #
 # #   #   # #   #       #   # #   #   #   #     #       #   # # # #  S  # #   # #     #       # #     #   #   # # # # #   # # #
 # # ### ##### # ######### # ########### ############### # ##### ### ### # # ### # ### # ####### ##### ### # ### # # # ### ### #
 #   #   #     #   #       #           # #           #   #   #   #   # # # # #   #   # #       #     # #   # #   # # #   #     #
 ### # # # ####### # # ############### # # ######### # # ### # ### ### # # # # ##### # ####### ### ### # ### # ### # ### #######
   # # # #   #   # # # #   #         # # #     #       #   #   #   #           #   # #   #     #   #   #   # # # # #   #   #   #
 # # # ##### ### # # ### # ######### # # # ### ########### ##### ##### # ####### # # ### # ####### # ##### # # # # ### ### # # #
 #   # #   #   #   #     #       #   #   # #   #                 # #   # #   #   #   # #   #     #   #   #   #   #   #   # # # #
###### # # ### ################# # ####### # # # ######### ####### # ### # # # ### ### ####### # # ### # ########### # # # ### #
   #   # # # # #     #     #     #   #     # # # #   #     #   # #   #   # #   #   #   #   #   # # #   #         #   # #   #   #
 # # ### # # # # ### # ### # ####### # ##### # # # # # ##### # # ##### # # ######### ##### # ### # # ########### # ####### # # #
 #   # # # # #   # #   # # # #   # #   #     # # # # #     # # #   #   # #           #     # #   #   #       # # # #     #   # #
 ### # # # # ##### ##### # # ### # ### # ##### # # # ##### # # ### # ### ############# ##### ### ### ####### # # # ##### ##### #
 #   #   # #           #   #     #     # # #   # # #     #   # # #   #   #   #       #     #   #   # #   #     # # #     #     #
 ######### # ##### ################### # # # # # # # ### ##### # ##### ### # # ##### # ### ### ### # # # ### ### # # ##### #####
     #     # #   # #     #     #     # # #   # #   # #       # #           #   # #   # # #   # #   # # #   #   #   # #   # #   #
#### # ##### # # # # ### # ### ##### # # ########### # ##### # ### ### ######### # # # # ### ### ### ##### # # ##### # ### # ###
   # #     # # #   # #     #   #   #   # #       #   # #   # # #   #           # # # #   # #   # #         # #       # #   #   #
 # # ##### ### ### # ####### ### # ##### # ##### ##### # # ### # ##### ####### # # # ### # ### # # # ##### # # # ##### # ### # #
 # #       #   #   #   # #   #   #     # #   #   #   #   # #   #     #       #   # # #   # # #   # # #   #   # # #       # # # #
 # ######### ### ##### # # ### ####### ##### # ### # ##### # ####### ####### ##### ### ### # ##### ### # # ### # # ####### # # #
 # #     #   #       #   #   #   #   # #     #     #     # #       #       #     #   # #   # #         # #   # # #     #   # # #
 # ### # # ### ### # ####### ### ### # # ############### ######### ####### ##### ### # # ### # ##### ### ### # # ##### # ### # #
 #     # # #   # # #   #   #     #   # # #   #     #   #           #     #   #     #   #       #   #   # # # # #   #   #   # # #
 ####### # # # # # ### # # ####### ### # # # # # # ### ############# ### ### # # ####### ####### # ##### # # # # ### ##### # # #
   #   #   # #   # #   # #           #   # #   # #       #         # #       # #             #   #       #   # #     #     # # #
## # # ##### ##### # ### ##### ########### ##### # ####### ####### # ######### ####### ##### ############### # # ##### ##### # #
   # #     # #     #   #     #   #       #   #   # #       # #   # #   #     # #     # #     #     #   #     # #             # #
 ######### # # ####### ##### ### # # ####### # ##### ####### # # # ### # ##### # ### # ####### ### ### # # ### # ###############
 #       # # #   #   #   # # # #   # #     # #   #   #   #     # #     #     # # # # #         # #   #   #   # #         #     #
 # ##### # # ##### # ### # # # ##### # # ### ##### ### ### ##### ####### ### # # # # ########### ### # ##### # ### ####### ### #
   #   #   #   #   # #   # #   #   #   #   # #   # #           #   #   # # # #   # #   #   #     #   # #     #   # #   #   # # #
#### # ##### # # ### # ### ### # ######### # # # # # ############### # # # # ##### # # # ### ##### ### # ### ### ### # # ### # #
     # #     # #   # #     #   # #   #   #   # # # # #   #   #       #   #   #     # # # #   #     #   # #     #   # # # #   # #
 ### # # # ####### # ##### # ### # ### # ##### # # # # ### # # ############### ####### # # ### ####### # # # # ### # # # # ### #
 #   #   # #   #   #   #   #   #     # # #   # # # # #   # # #       #   #   #         # #   #     #   # # # #   # # # # #     #
## ####### # # ####### # ##### ##### # ### # # # # # ### # ######### # # # ############# ### ##### # ### ### # # # # # # #######
   #     # # #       # #   # #   #   #     #   # # # #   # #   #   # # # #         # #       #     #   # #   # # # # #   #   # #
 ### ### # # ####### # ### # ### # # ########### # # # # # # # # # # # # ### ##### # # # ### # # ####### # ##### # # ####### # #
 # #   # # #   #           #   # # #     #     # # #   # #   # # # # # #   # #     #   #   # # # #     # # #     # # #         #
 # ##### # ### ### ##### ### ### ### ### ##### # # ##### ##### # ### ##### # # ####### ### # # ### ### # # # ##### # # #########
     #   #   #   # #   #       #     # #   # # # # #   #     # #   #     #   #       # #   # #     # # # # #   # #   #   #     #
###### ######### # # # ####### ####### ### # # # # # # # ##### # # ##### ########### # ##### ####### # # # ### # ##### # # ### #
     #     #   # #   # #       #   #     # #   # # # #   #       #     #     #       #     # #     #   # #   # #   #   # # #   #
 ### ##### # # ### ### ######### ### ### # # ### # # # ### ####### ### ##### # ####### ### # # ### ##### ### # ### # ##### # ###
   # #   # # #   #   # #         #   # #   # #   # # # #   #     #   #   #   # #       #   # # # #   #   #   #   # #   #   #   #
## # # # # ##### ### # # ######### ### ##### # ### ### # ### ### ### ##### ### # ############# # ### # ### ##### # # # # ##### #
   #   # #   #   #   #     #       #   #     #   #   #         #   # #   # # # # #             #   # #   # #     # # #   # #   #
 ####### ### # ### ######### ####### ### # ##### ### ##### ####### ### # # # # # # ########### ### # ### # ### ### # ### # # ###
   #   #   # #   # #         #     # #   # #   # #   #   # #   #   #   #   #   # # #     #   #   # #     #   #         #   # # #
## # ##### # ### # # ########### # # # ##### # # # ### # # # # ##### ####### ### # # ### # # ### # ####### # ####### # ##### # #
   # #     # # #   # #           # # #   #   # # # #   # #   #     # # #   #   # #   # #   #   # # #       #   #   # #     #   #
 # # # ##### # ### # ############# # # # # ##### # # ### ### ##### # # # # ### # ##### ####### # # ##### # ### # # # ##### #####
 # # #   #         #         #   # # # #   #   # # #   #   #     #   # # # #         # #   #   # #     # #   #   # #     #     #
 ### ### # # ####### ##### ### # # # # ### # # # # ### ### ##### ##### # # # ######### # ### ######### # ######### ### # ##### #
 #   # # # # #       #   #     #     #   # # #   #   # #   #   # #       #   #         #   #           # #         #   #     # #
 # ### # # ### ####### # ######### ### # ### ##### # # # ### # # # # ######### ########### ############### ######### ######### #
 # #   # #         #   #   #     #     #   # #   # #   #   # #     # #           #                   #     #   #G          #   #
 # # # # # ####### # ##### # ### ### # ### # # # ##### ### # ######### ####### # # ##### # ### ##### # ####### ####### ### # ###
   # # # #   #     #   #   # #   #   # #   #   #     #   # #           #     # #       # #   # # #   # #   #   #     # #   #   #
#### # # # # ######### # ### # ####### ############# ##### # ########### ### ##### # ### ### # # # # # ### # ### ### ### # ### #
   # # # # #       #   #   # #       #             #       # #     #     #   #   # # #   #   # #   # #   # #     # #     #   # #
## ### # # ####### # ####### ####### ####### ############### # ### # ##### ### # # ### ####### ##### ### # ####### ####### ### #
   #   # # #     # # #     #     # #     #   #   #     #   #   #   # #   #     # # #   #     #     #   #   #     # #     # #   #
 ### ### # # ### # # # ### ##### # ##### # ### # # ### # # # ####### # ######### ### # # ### ##### ### ##### ##### ### # # # ###
 #   # # # #   # #   #   #     #   #   # #   # # # #     # # #       #   #   #   #   # #   #   #   #   #   #     #   # # # #   #
 ### # # # ##### ####### ##### ### # # # ### ### # ####### # # ######### # ### ### ####### ### # ####### ####### ### # # # ### #
   #   # #     # #   #   # #   # #   # #   #     #     #   # #   # #   # #   #   # #   #   #   # #       #         # # #     # #
## ### # ##### # # # # ### # ### ##### ### ####### ### # ### ### # # ### ### ### # # # # ### ##### ####### ##### # # # ####### #
 # #   #     #   # # #     #   #     # # #   #   #   # #   # #   #       #   #   # # #   # #     # #       #     # #   #   #   #
 # # ####### # ### ########### # ##### # ### # # # ### ### # # ######### # # # ##### ##### ##### # # ##### # ##### ### # # # ###
 #       #   # #   #   #   #         #   #   # # #   #   #   #         # # # #       #     #   #   # #   # #   #       # # #   #
 ### ##### ### # ### # # # # ####### ### # ### # ### ### # ########### # # # ######### ### # # ##### # # # ### ### # ### # ### #
   # #     # #   #   #   # #   #   #   # # #   #   #   # # #       #   #   #       #   #   # #       # #     #   # #   # #   # #
## # # ##### # ### ##### ##### # # ### # ### ##### # ### # # ##### # ####### ### # # ####### ### # ####### ##### ##### # ##### #
   # #   #     #   #   # #     # # #   #     # #   # #   # # #     #     # # #   # #         #   # #     # #   # #   # #   #   #
 ### ### ##### # ### # ### ##### # ########### # ### # ### # ##### ##### # # # ### ####### ####### # ### ### # # # ### ### # ###
 #     # #       #   # #   #   # #   #   #     #   # # # # # #   # #     #   # #     #     #       #   #   # #   #     #   # # #
 # ##### # ##### # ### # ##### # ### # # # # ##### ### # # # # # ### ######### # ### # ### # ######### ### # ### ####### ### # #
 # # #   # #     # # #   # #   #   #   #   # #   #   # # # # # # #   #       # #   #   #   #   #       #   # #     # #   #   # #
 # # # ##### ### # # ##### # ##### ######### # ##### # # # # # ### ### ##### ##### ########### # ####### ### # ### # # ### ### #
     # #   # #   # #       #   #   #   #   # # #   #   #         #     #   #     #     #     # # #     #   # # #   # #   # #   #
 ##### # # ### ### # ##### # ### ### # ### # # # # ##### ####### ####### ####### ##### # ### # # # ### ##### # # ### ### # ### #
       # #     #   # #   #   #   #   # #   #   # #     # #     #             #   #   # # #   # # # # # #     # #     # #   #   #
 ############# # ##### # ### # ##### # # # ##### ####### # ### ########### # # ### # ### # ### # # # # ### ### ####### ##### ###
                       #             #   #               #   #             #       #     #     #   #       #                   #
################################################################################################################################
