################################################################################################################################
################################################################################################################################
#     #   #               # #   #     # #       #       #   #   # #   #         #         #     # #     # #           #       # 
##### ### # ############# # # # # # # # # ##### # ##### ### # # # # ### ####### # ##### # # ### # # ### # # ####### ### ##### # 
#   #   # #             #   # #   # #   # #     #     #     # #   # #   #     # # #   # #   #   #   # # # #   #     #   #   #   
# # ### # ### ####### ####### ##### ##### ########### ####### ### # # ### ### # # # # # ##### ####### # # ### # ##### ### ######
# #     #   # #     #         #     #   #     #   #   #   #   #   #   #   #       # # # #     #     #   # #   #       # # #     
# ####### # # # ### # ############### # ##### # # # ### # ##### # ####### # ####### # # # ######### # ### # ########### # # ### 
#   #     #   # #   #     #   #       # #   #   # # #   #     # # #       # #     # #   #   #       # #   # #           # #   # 
### ### ####### # ### ##### # # ####### # # # ##### # ####### # # # # ##### # ### ######### ##### ### # # # ######### # # ### ##
# # #   #       #   # #   # #   #   # # # # # #     # #       # # # #     # #   #         #     #       # # #   #   # # #   #   
# # # # # ######### # # # # ####### # # # # # # ##### # ####### # # ##### # ### ### ##### ##### # ####### # # # # # # # ### ### 
# #   # # #   #   # # # # # # #   # # # # #   # #     # #       #       # #   #   # #   #     #       # # # # #   #   #   #   # 
# ##### # ### # # # # # # # # # # # # # # ##### # ##### # ##### ######### # ##### # # # ##### ### ### # # # ############# ### # 
# #   # #   # # # # #   # # #   # #   #   #   #   # #   #   # # #   #   # # #   # # # #     #   # #   #   #     #             # 
# # # # ### # # ### # ### # ### # ### ####### ##### # ##### # # # ### # ### # ### ### ##### ### # # ########### ############# # 
#   #   #G  #   #   #   # #   # #     #   #   #   # #     #   #   #   #     # #   #   #   # #     #             #           # # 
####### # ### ### ##### ##### # ####### ### ### # # ##### ##### ### ####### # # ### ### # # # ####### ########### ######### # # 
#   #   # #       #       #   #   #       # # # # #   # #     #   # #     # #   #   #   # # #   #   #     #     #   #   # # # # 
# # # ### # ########### # # ##### # ##### # # # # ### # ##### ##### # ### ##### # ####### # # # # # ##### # ### ### # # # # # # 
# # # #   #           # # # # #   #   # #   #   #       #   # #   # # # # #   # # #     #   # # # #     #   # #   # # #   # #   
# # ### ############# # ### # # ##### # ########### ##### # # # # ### # # # # # # # ### ### # # # ##### # ### ### # # ##### ### 
# #     #       #   #           #                   #     # #   # #   # #   # # #   # #   # # # # #     # #   # # # # #   #   # 
# ####### ##### # ### ##### ##### ######### ######### ##### ##### # ### ##### # ##### ### # # # # ####### # ### # # # # ##### # 
#       #   #   #     #   #   #       #   # #     #   #   # #   #   #       # #   #   #   # # # #   #       #   #   # # #   # # 
####### ##### ### ##### # # # # # ##### # # # ### # ##### # ### ########### # ### # ### ### # ##### # # ####### ##### # # ### # 
#     #       #   #   # # # # # #   #   # # # # #   #     #     #     #   # # # # #     # # #       # #   #   #       # # #   # 
# ### ######### ### # # # ### # ### # ### ### # ##### ############### # # # # # # ####### # # ####### ### # # # ### # # # # ### 
# # # #       # #   #   #   #   # #   # #   # #   #                     #   # #   #       # # # #   #   # # #   #   #   #   #   
# # # # ##### # # ######### # ### ##### ### # ### # # ### ##### ########### # ### # # ##### # # # # ### # ### ####### ####### ##
# # #   # #   # #   #       #         # # #   #   # #   #   #   #     #   # #   # # #       #     #   # #     #   #   #         
# # ##### # ### ##### ####### # ### # # # ##### ### ### # # ##### ### # # ##### # # ############# ### # ####### # # ### ##### # 
# #       #   #   #   #     # # #   # #       #     #   # #     #   # # #     # # #         #   #   # #       # # #     #   # # 
# ### ### ##### ### ### ### # ### ### ####### # ##### ######### ### # # ### ### # ######### # # ### # ######### # ### ### # # ##
# #   # # #     #   #   # #   #   #       #   #     #     #   #   # # # # #     #         #   #   # # #         #   #   # # #   
# # ### # # ##### ####### ##### ### ##### # ### ######### # ### # # ### # ####### # ############# # ### ########### # # # ##### 
# # #     #   # #     #   #     #       # # #   #       # #     # # #   #     #   # #             #   # #       #   # # # #     
# # # ####### # ##### # ### ##### ### # # # # # # ##### # ######### # ##### # # ### # ############# # # # ####### ### # # # ### 
#   # #     #   #   # #     #     #   # #   # #       # #     #     #   #   #   #   # #     #   #   #   #       #   # # #   #   
##### ##### ### ### # ####### ##### ### ##### ######### ##### # ####### # ##### ##### ### # # # # # # ######### ### # ####### ##
#   #         #   # # #       #     #         #   #     #   #       #   # #   # #   # #   #   #   # #         #     # #   #     
# ##### ##### ### # # # ####### ####### ### ### # # ##### # ####### # ### # # # # # # # ##### ##### ################### # ######
# #   # #       #   # # # #   # #       #   #   # #       #     #   # #   # # # # # # # # #   #   #         #   #       #       
# # # # # ##### # ### # # # # # ######### ### ### # ########### ##### # # # # # # # # # # # ### # ######### # # # ############# 
#   #   #   #     #   #   # # # #   #         #   # #   #       #     # #   # # # #   #   # #   #   #     # # # #   #   #     # 
####### ### # ### # ####### # ### # # ############# # # # ##### # ##### ##### ### ######### # ##### # ### # # # ### # # # ### # 
#   # # #   # #   #         #     # #   #       #   # # # #   # # #     #   # #   #   #   # # #     #   # # # #     # #   #   # 
# # # # # ### # # ################# ### # ##### ##### # # # # # # ##### # # # # ### # # # # # # ####### ### # ####### # ####### 
# # #   #   # # #               #   #   #     #     # # #   # # #     # # # # #     #   # #   #   #     #   # #       # #   #   
# # ######### # ########### ##### ######### ####### ### ##### # ##### # # # ############# # ##### ### ### # # ### ### # # # # ##
# #     #     # #   #       #       #     # #     #     #   # #     # # # #   #     #           #   #     # #   # #   # # # # # 
# ##### # ##### ### # ####### ####### ### # # ### ####### # # # ##### # # ### # ### ##### ####### # ########### ### ### # ### # 
#     # #   #   #   # #       #       # #   # # # #     # #   #     # # # # # # # #     # #     # #     #     # #   # # #     # 
##### # ### # ### ### # # ### # ####### ##### # # # ### # # ####### # ### # # # # ##### # # ### # ##### # # ### # ### # ####### 
# #   # #   #   #   #   # #   #     # #   #   # # #   #   # #   #   # #   # #   #     # # # #   # #   # # #     #     # #       
# # ### # ##### ### ##### # # ##### # ### # ### # ### ####### # ### # # ### ##### # ### # # ####### ### # ############# ####### 
# #   # # #   #   # #     # #   # #       # #   # #   #       #   # # # #       # #   # #   #     #     # #           #         
# ### # # # # # # # ### # # ### # # ####### # ### # ############# ### # ##### # # ### # # ### ### ##### # # ######### ######### 
# #   # # # # # # #     # #   #   # #       #   # # #             #   # #   # # #   #   #     #   #   # # #   #   #       #   # 
# # ### # # # ### ######### # ### # # ######### # # # ############# ### # # # # ### ##### ##### ##### # # ### # ### # ##### # # 
# # #   # # #   #   #     # #   #     #         # # # #   #   #   # # # # # # #   # #     # #   #   #   #   # # #   # #   # # # 
# # # ##### ### ### # ### ########### ####### ### # # # ### # # # # # # # ### ### # ##### # # ### # ####### # # # ### # # # # # 
#   # #     # # #   # # #           #   #     #   #       # #   # # # # #     # # #     # # # #   #         # #   #   # # # #   
# ##### ##### # # ### # ########### ### # ##### ######### ##### ### # # ####### # ##### # # # # ############# ######### # # ####
#   #   #         #   #       #   #         # #         #       #   # #   #     # #   # #   # # #                       #   #   
### # ### # ### ### ### ##### # # # ##### # # ######### ####### # ### ### # ##### # # # # ### # # # # ##### ################### 
# #   #   #   # #   #     #     # # #   # #           #       # # #       #     #   # # # #   # # # # #   #             #       
# ############# # ####### # ####### # # ##### ### ### ####### ### ########### ### ##### # # ### # # ### # ### # ##### # # ######
#       #       #       # #   #     # #     #   #   #   #   #   # #     #     #   #     # #       # #   #   # # # #   #   #   # 
# ### # # # ##### ##### ##### # ##### ##### ### ### ##### # ### # # ### ##### # ### ##### ######### # ##### # # # # ### ##### # 
#   # #   # #   #     #   #   # # #   #     #   # # #     #   #   #   #     #     # #       #     # #   #   # #   # #           
##### ##### # # ######### # ### # # ### ##### ### # # ####### ####### ##### ### ### # # ### # ### # ### ##### ##### ############
#   # # #   # #       #   #         #   #     #     #   #     #     #     #   #     # #   # # # # #     #   #     # #           
# # # # # # # ####### # ######### ####### # ### ######### ##### ############# # ##### ### ### # # ####### # # ### ### ######### 
# #   #   # # #       # #   #   # #     # #   #   #   #   # #   #     #       #         #   #   #   #     # #   #     #     #   
# ### ##### # ########### # # # # # ### # ### ##### # # ### # # # ### # ####### ####### ### # ##### # ##### # ######### ### # # 
# #   #   # #             #   #     #   #   #     # # # #     #   # #   #   #   #     #   # # #     #   #   #   #   # # #   # # 
# # ### # ########### ######### ################# # # # # ######### ##### # # # # ### ##### # # ####### # ### # ### # # ### # # 
# #   # #       #     #       #   #             #   #   #     #           #   #   #   #   #   # #       # # # # #   # #   # # # 
# ##### ####### ##### # ##### # # # ########### # ########### # ####### ### ####### ### # ####### ####### # # # # ### ### # # # 
#     # #   # #     # # #   # # #   #           #         #   # #     #   #       # #   # #         #     #   #       #   #   # 
##### # ### # ##### # # ### # # ##### ########### # ##### # ### # ####### ####### # # ### # ######### ##### ####### ### ####### 
#   # #     #   #   # #     #   #   #       #   # #     #   #   #       #   #   # #   #   #     #   #   #   #     # # # #       
# ### ######### # ########### ### # ####### # # # ##### # ### ### ##### ### # # # ##### ####### # # ### # ### ### # # # ########
# #           # # #     #   #     # #   # # # #     #   #     #   #   #   # # # #     # #   #   # #     # #   #   #   #   #     
# # ### ### ### # ##### # # # ####### # # # ######### ### ### # ### ####### # # ####### # # # ### ####### # ##### # ##### # ### 
# #   #   #     #     #   # #     #   # #   #         #     #           #   # #   #   #   # #   # #       # #   # # #     # #   
# ### # # ########### ##### # ##### ### ##### ########### # ##### ##### # ### ### # # # ### ### # ######### ### # ### ##### # ##
# #   # #   #   # #   #               # #   #           # #     # #   # #   # # #   # # # #     #         #     #   # #     # # 
# # ### ### ### # # ##### ############# # # ########### # ##### # # # ##### # # ##### # # ############### ######### ### ##### # 
# #   # # #   #   # #   # #       #   #   # #     #   # # #   # # # #     # #   #     # # # #   #         #       #   #   # # # 
# ### # # ### ### # # # # # ##### # # ##### ##### # ### ### # # # # ##### # # ### ##### # # # ### ### ##### # ####### ### # # # 
# #   #   # #     # # # #   #   # # #   #   #   # #     #   #   # # # #   #   #   #         #     #   #     #       #     #   # 
# # ### ### ####### ### # ### # # ##### # ### # # ####### ######### # # ### ### ########### ########### ######### # ####### ### 
#   #   #   # #     #   # # # # #     #   #   # #   #   #   #       #   #   # #     #     #     #       #   #   # # #     # #   
##### # # ### # ##### ### # # # ##### ##### ### ### # ##### # ########### # # ##### # ### ####### ######### # # # ### ### # ### 
#     # # #   # # #       #   # #   # #     #             #   # #       # #   #   #   #   #       # #     # # # #     # # #   # 
# # # ### # # # # # # # ### ### # # # ### # # ######### ####### # ##### # ##### # ##### ### ####### # ### # # ######### # ### # 
# # #   # # # # #   # # #     # # # #   # # # #   #     #       #     #       # #     #   # #   #     # # # #         # #   # # 
# # ### # # ### # ### # # ### # # ##### # # # # ### ### # ########### ##### # # ##### ### # # ### ##### # # ####### # # # ### # 
# #   #   # #   # # # #   #   # #       # # # #   #   #   #         # #   # #   #   #   # # #   #   # # # #         #   #     # 
# ######### # ### # # ##### ### ########### # ### ####### # ######### ### # ##### ##### # # # # ### # # # ########### ######### 
# #     #   # # #   # # #   #       #   #   #   #   #     #     # #   #   # #   #     # #   # #     # #   #           #       # 
# # # # # # # # ### # # # ######### # # # ######### # ### ##### # # ### ### # # ##### # ##### ### ### ##### ########### ##### # 
#   # #   # # #     # #   #       # # # #         # #   #     #   #   # #     #     #   #   #   #               #       #   # # 
# ### # ##### ##### # ### # ##### # # # ### ### ### ### ##### # ##### # # ##### # # ##### ### # ####### # ##### # ####### # # # 
# #   #   #   #   # # #   #   #   # # #   #   #       #   #   # #   #   # #     # #     #     #     # # #     # #       # # # # 
### ####### ### # # # ######### ### # ### # # ############# ### # # ####### ##### ##### # ######### # # # ### # ####### # ### # 
#   #     # #   # # #           #   #   # # #   #       #   # # # #   #   # #         #   # #     # #   #   # #   # #     #   # 
# ####### # # # # # ################### # ### ### ##### # ### # # ### # # # ##### # ####### # ### # ##### # # ### # # ##### ### 
#         # # # # #   #                 #   # #   # #   #       # # # # # #     # #     #   # #   #   #   # #   #   # # #   #   
# ######### ### # ### # ################### ### ### # ### ##### # # # # ####### # ##### # # ### ##### ######### ##### # # ### # 
#     #   # #   #   # #     #         #   #   # #   #   # #     #   # #   #     #   # # # #     #   #   #   # #     # #   #   # 
# # # # # # # ##### # ##### # ####### # ##### # # ##### # # ### ##### ### # ##### # # # # ####### # ### # # # # ##### ######### 
# # #   # #   #   #       # # #     # #   #   # # #     # # # #     #   #   #     #   #   #   #   #   # # # #   #     #   #   # 
# # ############# ### ### # # # # ### ### # ### # # ##### # # ### # ### ### ##### ########### # ##### # # # ##### ####### # # # 
# # #   #   #   #   #   # #   # #   #   # #   # #   #     #   #   #       # #   #         #   #     # #   # #     #       # #   
# # # # # ### # # ####### ##### ### ### # ### # ##### ######### ######### # # # # ##### # # ### ##### ##### # ##### ####### ####
# # # # #     #   #   #   #   #   #     #   # #   #         #   #       #   # # # # #   # # #       #     # # #     #       #   
# ### # ######### # # # # # # ### ######### # ### ########### # # ##### ##### # # # # ##### # ##### ### # # # # ##### ####### # 
# #   #         # # #   #   #   #         # # #               # # #   #     # # #   # #     #     #   # # #   #       #   #   # 
# # ### ######### # ##### ############### # # ##### ############# # # ##### # # # ### # ######### ### # # ##### ######### # ### 
# # # #         # # #   # #     #       # # #   #   #             # #     #S  # #   #       #     #   # #       #           #   
# # # ######### # # # # # # ### # # ##### # ### ##### ############# ### ####### ####### ### # ##### ##### ##### # ########### # 
#   #   #     #   #   # # # # #   # #   #     #       #   #         # #       # #     #   #   #   #   #   #   #   #     #   # # 
# ##### # ### ######### # # # ##### # # ##### ######### # # ######### ####### # # ### ### ##### ##### # ### # ##### ### # ### # 
#       #   #           #         #   #                 #           #         #   #   #       #       #     #       #   #     # 
################################################################################################################################
