################################################################################################################################
       #   #   #                     #         #                 #       # #       #   # #       #             #   #       #   #
 ##### # ### # # # ### # ####### ### ##### ### # ######### ##### # ### # # # ##### # # # # ### # # ######### # ### # ##### # # #
 #   # #     #   # # # # #   #   #     #   # #   #     #   #     # #   # # #     # # # #     # #   #         #     # #   # # # #
## # # ####### ### # # # # # # ####### # ### ### # ### # ### ##### # ### # ##### # # # # ##### ############### ##### ### # ### #
   # #     #   #   #   # # # #   #   #   #       # #     #     #   # # # #       #   # #     # #       #     #   # # #   #   # #
 ### # # # # ### ##### # ### ### # # ######### ### ### ####### ##### # # ############# # ### ### ##### # ### # # # # # ##### # #
 #   # # # #   #     # # #   #   # #       #   #   #   #     #       # # #     # #     #   #     # #   # #   # #   # # #     # #
 # ### # # ### ##### ### # ### ### ####### # ### ### ### ### ######### # # ### # # ##### ####### # # ##### ### ##### # # ##### #
 #   # # # #   #   #   # #   # #   # #   # #   #   #   #   # #         #   # # #   #   #       # # #   #   #   #   # # # #     #
 ### ### # # ##### ### # ### # # ### # # # ####### ######### # ############# # # ### # # ##### # # ### # ### # # ### # # # #####
   #   # #   #     #   #     #   # #   # #     # #       #   # #   # #       # # #   #   #     # # # # #     #   #   # # # #   #
###### # ##### ##### # ########### ##### ##### # ##### # # ### # # # # ##### # # # ####### ##### # # # ####### ### ### # # # # #
       #   #       # #                 #       #   #   # #   #   # # #   #   # # # #     #   #     # # #         #   # # # # # #
 ######### # ####### ##### # ### ##### ######### # # ### ### ##### # ### ##### # # # ### # # ### ### # ############# # # # # # #
   #     #   #     # #   # #   # #     #       # # # #     #   #         #     #   # # # # #   #   # # #       #     # #   # # #
## # ### ##### ### # # ### ##### # ### # # ### # ### # # # ### ######### # ##### ### # # ##### ### # # # ##### # ##### ####### #
 #   # #       # #   #   # #     # #     #   #   #   # # #   #         #         #   # #     #   #   # # #   #   #         #   #
 ##### ######### ####### # # ##### # ####### # ### ### # ############# ####### ### ### ##### # # ### # # # # ##### ### ### # ###
 #     #     # #   #   #   # #     # #       #   #   #S#   #   #                   #   #   # # #   # #   # # #     #   #   #   #
 # ####### # # ### ### ##### # ##### # ##### ####### ##### # # ############### ##### ### # # ##### # ##### ### # ####### # ### #
   #       # # #   #         #   #   # #     #       #     # #               #         # # # #   # #           #     #   #   # #
 ### ####### # # ### ### ####### # # # ####### ####### ##### ############### ### ####### # # # # # # # ############# ##### # # #
   # #   #     # #   #   # #   # # # #   #   # #     #   #   #   #         #     #       #   # # # # #         #   #     # # # #
## # # # # ##### # ### ### # ### # ##### # # # # ####### # ### # # ######### ##### ########### # # # # ######### # # ### ### # #
   # # # # # #   # #   #   #     # #     # #   # #       #   # #   #         #   # #   #     # #   # #   #       # #   #   # # #
 ### # ### # # ##### ### ########### ##### ##### # ##### ### # ##### ######### # # # # # ##### ##### ### # ####### ### ### ### #
     #   #         # # #   #         #   # #     #   #     # # #   # #       # # # # # #       #     #   # #       #     #     #
######## ### ##### # # ### # # ####### # # # ####### # ### # # # # # # ##### ### # ### ######### ##### # # ##### ### ###########
             #   #   #       #       # #   #         # #   #   # # #   #   #     #     #       # #     # #     #   # #         #
#### # ####### # ################### # ############### # ####### # ### # ############### ##### # # ########### ### ### ####### #
   # #   #     #   #     #   #       #   #       #     # #     # #   # #     # #   #       #   # #   # #       # #   #   #     #
 # ####### ####### # ### # # ########### # ##### ##### # # ### # ### # ##### # # # # ####### ### ### # # ####### ### ### # #####
 #       # #       #   #   #             # #   #     # # #   # # #   #         # #   #       # # #   # #   #     # # #   # #   #
 ####### # # ####### # ####### ########### # # ##### # ##### # ### ### ######### ##### ####### # # ### ### # ### # # # ### # ###
   #   #   # # #     # #     # #   #     #   # #   # #     # #   # # #             # #   #   #   #     #   #   # # # # #   #   #
## # # ##### # # # ### # ### ### # # ### ##### # # ####### # ### # # # ########### # ### # ####### ##### ### # # # # # # ##### #
 # # # # #   #   #   #     #   # # #   #     # # #         #   #   # #   # #     #   #   # #   #       #   # # #   #   #   # # #
 # # # # # ####### # ######### # # ######### # # ######### ### ##### ### # # ### # ### ### # # # ####### # # # ########### # # #
 # # # # # # #   # #     #     # #     #         #   #       #           #   # # #   # # #   #   #     # # # #   #       # #   #
 # # # # # # # # ### # ### ### # ##### # ####### # # ########### ############# # ##### # ####### # ### ### # ### # ##### # ### #
   # # # # #   # #   # #   #   #   #   # #     # # #     #     #           #   #     # # # #   # #   #   # # #   # #   # #   # #
#### # # # # ### # ### # ####### ### ##### ### # # ##### # ### # ####### # # # ##### # # # # ### ####### # # ##### # # # ### # #
   # # # # #   # #   # #         #   #     # # # #     # # #       #   # # # # #   # # #   # #   #     #   #     #   # #   #   #
 # # # # # ### # ### # ########### ### ##### # ######### # # ##### # # # # ### # ### # ### # # ### ### ##### ### ##### # ##### #
 #   #   # #   #   # # #     #   # #   #     #     #   #   #     # # # # #   #   #   # #   #   #   # #     # # #       # #   # #
 ######### # ####### # # ### # # # # ####### ##### # # ##### ### # ### ##### ### # ### # ##### # ### ##### # # ######### # # # #
           #         # # #   # #   # #       #   # # #     # #   #     #   #   # #     #       #   #     # #     #   # # # #   #
 ##################### # ######### # # ##### # ### ####### # ########### ##### # ############# ### ### ### ##### ### # # # #####
 #       #         #   #     #   # # # #   #     #   #   # #     #   #         #     #         # # #   #   #   #   #   # # #   #
 # # ### # ####### ### ##### # # ### ### # # ### ### ### # ### ### # ### ####### ### # # # ### # # # ### # # # ### ### # # # # #
 # # #     # #   #   # #   #   #     #   #   #                 #   #   # #   # # # # # # #   # # # # #   # # #   # #   #   # # #
 ### ####### # # ### # # # ########### ####### ######### ####### ##### ### # # # # # # # ### # # # # # ### # ### # # # ####### #
   #   #   #   #   # #   # #     #   #     #   #       # #       #   # #   # #   # # # #   # #   # # #   # # # # # # #   # #   #
## # # # # # ####### ##### # ### # # # ##### ### ##### # # ######### # # ### ##### # ####### ##### # ### ### # # # # ### # # ###
 # # # # # # #       #   # # #   # # #   #   # #     #   # #   # #   #   # # #     #       #   #   #   #   # # #   # # # # # # #
 # # # # # # # ####### # ### # ##### ### # ### ######### # # # # # ####### # ##### ####### ### # ##### ### # # ##### # # # # # #
 # # #   # # #       # #     # #   #     #     #       # # # #   #     #   #   # # # #     #   # #   # # # #       # # # #     #
 # ### ### # ####### # ####### # # ############# ##### # # # ### ##### # ### # # # # # ##### ### # # # # # ####### # # # ##### #
 #   # #   #   #   #   #     # # #       #   #   #   #   # # # # #     #   # # #     #   #     # # #   # #         # # #       #
 ### ### ##### # ####### ### # # ####### # # # ### # ### # # # # # ####### ### # ####### ##### # ### ### ########### # ####### #
   # #   #   #   #       # # # #   #     # # #   # #   # # # #       #   #     #   #   # #     #   #   #       #   #   # #   # #
## # # ### # # ### ####### # # ### # ##### # ### # ### # # # ####### ### ######### # # # # ### ### ### ### ### # ####### # # # #
 # # # #   # # # #     # #   #   # #   #   #   # #   # # # # #   #     #           # # #   #   # # # #   # #   #     #   # # # #
 # # # # ### # # ##### # ####### ##### ####### # ##### # # ### # ##### ### ##### ### ####### # # # # ### # # ##### # # ### # # #
   #   # # # # # #     # #     # #   #   #   #   #     # #     #     #     # #   #   #       #   # #   #   #     # #   #   #   #
 ####### # # # # # ##### # ### # # # ### # # ##### ##### ########### ####### # ### ### # ### ##### ### ######### # ##### #######
   #   #   # # # # #   #   #   # # #     # # #     #   #   #   #   #       #     #     # #   # #   #     #   #   #   # #     # #
 ### # ##### # # # ### ### ##### # ####### ### ##### # ### # ### # ####### # ### ####### # ### # ### ### # # # ##### # ##### # #
   # #       #   #   #     #   # #       # #   #   # #         # #         # #           #     # # #   #   # #   #             #
 # # ######### ##### # ##### # # ####### # # ### # # ######### # ############# ### ##### ####### # ### ##### ### ############# #
 #   #   #         # # #   # # # # #   # #   #   #   #       # # #             #   #   #     #   # #   #                       #
 ##### ### ######### # # # ### # # # # # ### # ####### ##### ### ### ##### # ### ### # ##### # ### # # # ##################### #
 #           #   #   #   #     # # # # #   #   #     # #   #     #   #     # #   #   #       #   #   # #     #   #     #   #   #
 # ########### # # ### ######### # # ##### ### # # ### # # ####### ######### # ### ############# ####### ### ### # ### # # # ###
 #     #       # # # # #     #   #       #   #   # #   # #         #   #     # #   #   #   #   #       #   #   # #   # # # #   #
 ### # # ######### # # ##### # ####### ##### ##### # ########### ##### # ##### ##### # # # # # ####### ####### # ### ### # ### #
   # # #   #       # # #   # # #     #     #   #     #     #   #     # #   # #       #   # # # # #   #       #     #     #   # #
## # ### ### ####### # # # # # # ### ### ##### ##### # ### # # # ### # ### # ############### # # # ######### ##### ######### # #
         #   #     # #   # # #   # # #   #   #     # #   #   # #   #     #   # #             #           #   #   #         #   #
#### ##### ### ### # ##### # ##### # ### # ####### # # ####### ######### ##### # ################# ##### # ### # ##### ####### #
   # #   #   # # # #     #   #     #   #           #   #     #         #     # # #   #   #     #   #     #   # # #   # #       #
 # # # # ### # # # ##### ### # ####### ### ######### ### ### ### ##### # ### # # ### # # # ### # # # ### ### # # ### # # ##### #
 # # # #     # #             #     # #   # #     #   #   # #   #     # #   #   #     # # # # # # # #   #     # #   #   # #   # #
## # # ####### ######### ### ##### # ### # ##### # ### ### ### ##### # ##### ######### # # # # # # ### ### # # ### # ### # ### #
     #   #     #   #     #     # #   # # #         #   #     #   #   #     # #         # # # # # #   # #   #   #   # #   #     #
 ####### # ##### # ####### ### # ### # # # ######### ####### ### # ##### # ### ####### ### # # ##### # # ####### ##### ### #####
       # #   #   #   #     # #   # #   # # #       #         #   # #   # #         #   #   # #       # # #   # # #     # # #   #
 ####### ##### ##### # ##### ### # ### # # # ##### ######### # ##### # ############# ### ### ####### # # # # # # ### ### # # # #
   #   #   #   #       #     #   # #   #   # # #   #         #       # #           # #   # #         # #   # # #   #   #   # # #
## # # ### # ########### ##### ### # ##### # # # ### ############### # # ######### # # ### ### ### ### # ### # ### # # ### # # #
 # # #       #   #     # #         # #   # #   #   # #   #   #     # # # #   #   #   #   # #   #   # # #   # #   # # #   #   # #
 # # # ##### # # # ### # # # ##### # # # # ### ### # # # ### # ### ### # # # # # ####### # ### # ### # # # # ### # ##### ##### #
 # # # #   # # #   # # #   # #   #   # #   # #   # #   #     # #   #   # # # # # #     # #     #   # # # # # #   # #   #   #   #
 # # ### # ### ##### # ####### # ### # ##### ### ########### # # ### ### ### # # # ### # ##### ### # # # # # # ### # # ### # ###
 # #   # #     #     #   #   # #               #     #       # # #   #       # # # # #   #     # #   # # # #   #   # # #   # # #
 # ### # ########### ### # # # # ######### ### ##### # ####### # ### ######### ### # ##### ##### ##### # ####### ### # ##### # #
 #     # #         #   #   #   # #     # # #   #   # # #       #     #   #   #   # #     #       #   # #   #   #   # #     #   #
 ### ### # ####### ### ######### # ### # # # # # # # # ############### # # # ### # ##### # ####### # # # # # # ### # ##### ### #
 #   #   #   #   #     #     #   # #   #   # # # #   #     #     # #   # # #   # #     # #   #     #   # # # #   # # #   #     #
 # # # ### # # # ### ### ##### # # # ####### # # ######### ### # # # ### ##### # # ### # # # # ######### # ### ### # # # ##### #
 # # # #   #   # #   #   #     # # # #       #           # #   #   #   # #   # # #   # #   # # #   #     #     #   #   # #   # #
 # # # # ####### # ### ### ##### # # ### ############### # # ### ##### # # # # # ### # ##### # # # # # ######### ####### # ### #
 # # # # #   #   #   # #   #     # #   #   #             #   # # #     #   # # #   # #   #   #G# #   #   #     #   #   # #     #
 # # # # # ### ##### # # ### ##### ### ### # ##### ##### ##### # # ######### # ### ##### # # # ######### # ### ### # # ### #####
   # # # # #   # #   # # #   #   # # #     #   #   #             # #     # # # # #       # # #         # #   #   #   # #   #   #
 ##### # # # ### # ### # # ### # # # ##### ### ##### ######### ### # ### # # # # ######### # ######### ##### # ####### # ### ###
 #     # # #     #       #     # # # #       # #   # #       # # #   # #   #   #           #   #     #       # #     # #       #
## ##### # ######### ############# # ######### # # ### ##### # # ##### ### ##### ######### # ### ### ######### # ### # # ##### #
   #       #   #   # #           # # #       # # #   #   # # # #   #     #     # #   #   # # #     #     #   # #   # # # #   # #
 ### ### ### # # # ### ######### # # # ##### # # ### ### # # # # # # ######### # # ### # # # # ####### ### # # ### # # # # # ###
 #     #   # # # #     #       #   # #   # #   #   #     # # #   #     #     # # #     # # # #   #   #     # #   # # # # # #   #
 ### # ### # # # ##### # ##### ### # ### # ####### ####### # ######### # ##### # ####### # # # ### # ####### ### # ### # # ### #
   # # # # # # # #     #     # #   #   # #     # # #     # #     #           #   #     #   #   #   #   #     #   #     #   #   #
## # # # # # # # ########### # ##### ### ##### # # # ### # ##### # ### ##### ##### ####### ##### ##### ####### # ####### ### ###
   # #   #   # #   #       # # #     #   #       # # # # #   #   #   # #     #   #   #   #     # #   # #       #           #   #
 ### ######### ### # ### ### # # ##### ### ####### # # # # # # ##### # # ### ### ### # # # # ### ### # # ####### ##### # # ### #
 #     #     #   # # # #     #   #   #       #   # #   #   # #   #   # #   # #     #   #   #   #     # # #   # #   #   # # #   #
 # ### ##### # ### # # ########### ########### # # # ####### ### # ####### # # ### ########### ####### # # # # # # # ### # # ###
 # #   #     #   #   #               #       # #   #   #   #   # # #       # # #     #   #   #       # #   # # # # # #   # #   #
 ### # # ####### ##### ############# # ##### # ##### # # # ### # # # ####### ### ### # # # # ##### ### # ### # # # # # # #######
   # # # #     #       #   #     #   #   # # #   #   # # #     #   #   # #   #   #   # #   #   #   #   #   # #   # # # #       #
## # ### # # ##### ##### # # ### ####### # # ### # ### # ##### ### ### # # ### ### ### ####### # # # ##### # ##### # # ####### #
   #     # # #   #       # #   #   #     # #     # #   #   #       #   #   #   # #     # #   #   # #     # # #     # #     #   #
 ### ##### # # # ######### ### ### # ### # ######### # ### ######### ### ### ### ####### # # ##### ##### ### ### ### ####### ###
   # #   # # # # #   #   # #   # # #   # # # #       #   #         #   #   #   # #       # # #     #   # #   #   #   #     #   #
## # ### # ### # # # ### # ##### # ### ### # # # ################# ### ### ### # ####### # ### # # ### # # ### ### ### ### ### #
   #           #   #     #           #     #   #                 #   #   #     #               # #     #   #     #     #   #   #
