################################################################################################################################
################################################################################################################################
#                   #             #   #         #     #       #             #                   #       #   #     #   #     #   
########### # ##### # ##### ##### # # ######### # ##### ##### ##### # ### # # # ##### ##### ### # ##### ### ### ### # ##### ### 
#       # # # # #   # #     #   #   # #   #       #     # #   #     #   # #   #     # #   #   #   #   #   #         #     #     
# ##### # # # # # ### # ####### ##### # # # # ##### # ### # ### ### ##### ### ##### # # # ### ####### ### # ### ######### ##### 
# #   # #   # # #     #       # #       #   # #   # # #   # # # # #   #   #     # # # # # #   # #       # # #   #       # #     
# ### # ##### # ##### ####### # ############# # # # ### ### # # # # # # ### ### # # # ### # ### # # ##### ### # # ##### # # ####
#   #         #             #   #       #   # # # #   #   # #   #   # # #     #   # #     #   # # # #   #     # # #   # # #     
### ################### ### ##### ##### # # # # ##### ### # ### ####### # ### ##### ######### # # # # # ####### # # ### # # ####
# #     #       #     # #     #   #     # #   #     #   # # #   #       # #   #           #   #   # # # #   #   # # #   #   #   
# ##### ####### # ### # ####### ########### ####### ### # # ##### ######### # # ### ##### # ### ##### # # ### ### # # ####### # 
#     #       #   #   # #     #             #   # # # #   # #     #         # # #   #   # #   #     # # #   #   #   #   #   # # 
# ########### ##### ### # ### ########### ### # # # # ##### # ##### # # ####### ##### # ##### # ### # # ### ### ####### # # # # 
# #         #       #     # # #     #   #     #   # #     #   #     # # #     #       # #     #   # # #   #         #   # # # # 
# ### # # # ######### ##### # # ### # # # ######### ##### ##### ##### # # ### ######### # ####### ### ####### ### # # ### # # # 
#     # # #           #   # # #   #   #   #         #   #         #   #   # #       #   # #     #     #       #   # #     # # # 
####### # ### ######### # # # ########### # ######### # ######### # # ##### ####### # ### ##### # ##### ### ### ### ####### # # 
#       #   #         # #   #   #   #   # # #         #       #   # #         #     # # #       #       #   #   #           # # 
# # ##### ##### ##### # ####### # # ### # # # ############### # ### ######### # ### # # ##################### ######### ##### # 
# # #   # #   # # #   # #       # #   # # #   #   #         # #   # #   #     #   # #   #   #         #     # #       # #     # 
# # # # ### # # # # ### # ####### ### # # ##### ### ####### # # # ### # ######### # ##### # # ####### # ### # # ##### # # ######
# # # #     # #   #   #   #     #   # #   #     #   #     # # # # #   #   #     # #       # # #       #   #   # #     # #   #   
### # ####### # ##### ##### # ##### # # ### ##### ####### # # # # # ##### # ### # ####### # # ### ####### ##### # ##### # ### # 
#   # #   #   #   # #       # #   # # #       #   #   #   # # # # # #   # #   #   # #     # #   #       #   #   # #   #       # 
# # # ### # ### # # ### # ##### # # # ####### # # ### # ### # ### # # # # ### ##### # ##### ### ####### ### # ### # # ### ##### 
# # #   # # #   #   # # #   #   #   # #       # # #   #   # #     # # # #   # # #   #     #   #   #         #   # # #   # #     
# # ### # # ### # ### # ### # ####### # ##### # ### ##### # ### ### # # ### # # # ####### # ##### # ########### # ##### # ######
# #   #   #   # #     #   # #     #   #   #   #     #   #       #   # #   #   # #         # #     # #         # #       #   #   
# ########### # ##### ### ####### # ##### # # ####### # ### ##### ####### ##### ####### ##### ##### # ####### # ########### # # 
#         #   # #   #   # #     # # #     # # #       #     #   # #   #     #         # #   # #     # # #     # #   #   #   # # 
# ####### # ##### # ### # # ### # # ### # # # ##### # ####### # # # # # ### ##### ### # # # # # ##### # # ##### # # ### # ##### 
#       # #       # #   #     # # #     # # #       # #   #   #   # #   # #       #   # # #   # #     #   #     # #           # 
# ##### # ######### ########### # ######### ####### # # ### ##### ####### ######### ### # ####### ####### # ##### ########### # 
# #     #     #   #           # #         # #       #   #   #     #   # #               # #       #     # # #   # #   #     #   
# # ########### # ########### # ######### # ##### # ##### ##### ### # # # ####### ####### # ####### ### # # ### # # # # ### ####
# # #     #     #   #     #   #       # # #     # #   # # #     #   # #   #       #   #   #     #   # # # #   # # # #   # # #   
### # ### # ####### # ### # ####### # # # ##### ##### # # ##### # ### ##### ##### # # # ### ##### ### # ##### # # # ##### # # # 
#   # #   #     # # # #           # # # #     #   #   # #     # # # #   #   #     # #   #   #     #   #   #       # #     #   # 
# ### # ####### # # ### ######### # # # # ####### # # # ##### ### # ### ##### ##### ##### ### ##### ##### ##### ### ### ####### 
#     # #     #   #   # #   #   #   #   #   #     # # #     #   # #   #     # #     #     #   #   #     #   #   #   #   #       
# ##### # # ######### # # # # # ########### # ##### ####### ### # # # ##### ### ### # ##### ##### # # ##### # ### ### # # ######
#     #   #       #   # # #   #             #     #         #   # # #   # #     # # # #   #       # #     # #   #   # # # #     
# ########### ### # ### # ####################### ########### ### # ### # ####### # # # # ######### ####### ### ### # # # ##### 
#       #   # #   # #   #       #     #   #     #   #   #     #   # # #   #         #   # # #   #     #     #     #   # #       
####### # ### ##### ### ####### # ### # # # ####### # # # ### # ### # ##### # ########### # # # # ### # ##### ######### ########
#     # #     #     #   #     # #   #   # # #     #   # # # # #   #         # #   #     #   # #   # #   #   # #       #     #   
# ##### ####### ##### # ##### # ### ##### # # ### ##### # # # ### ########### # # # ### # ### ##### ##### # # # ##### ##### # ##
# #           # #     #     # #   #   #   #   #         # #     #           # # #   # #   #   #   # #     #   # #   # #     #   
# # ### ##### # ### ### ### # ### # ### # ############### ### ############# ### ##### ##### ### # # # ### ##### ### # # ####### 
#   # #     # #   #   #   #   # # # #   # #               # # #       #   #     #         #   # # # # #   #   # #   #   # #   # 
##### ### # # ### ### ### ##### # # # # ### ############### # # ##### # ######### ####### ### ### # # ##### # # # ####### # # # 
#   #     # # #   # # #   #   # #   # # #   #     #     #     #   # # #       #   #       # #   # # #   # # #       #   #   # # 
# ######### # # ### # # ### # # ##### # # ### ##### ### # # ##### # # ##### # ### ### ##### ### # # ### # # ####### ### ##### # 
# #         # # #     #     #   #     # #   #   #   # #   # #       # #     #   #   # #     #   # #   # # #   #   #             
# # # ##### # # # ############### ##### ### ### # ### ##### # ##### # # ####### ### # ### ### ### ### # # ### # # ### ######### 
# # # #   # # # #   #         #   #   #   # # #   #         # #   # # # #   # # #   #     #   #               # #   #   #     # 
# # ### # ### # ##### ####### # ### # # ### # ### ####### # # # # ### # ### # # ######### # ####### ######### # ### ##### ### # 
#   #   #   # # #     # #   # # #   #   #   #     #     # # # # #     # #   # #   #       #     #   #   #     # # # #     # # # 
### # ##### ### # ##### # # # # # ##### # ##### ### ### # # # ######### # ### ### # # ######### # ### # # ### # # # # ##### # # 
#   # #     #   #   #     # #   # #   # #   #   # # # # # # #   #     #   #   #   # # #       # # #   #   #   # # # # #   # # # 
# ### # ### # ### # # ##### ##### ### # ### # ### # # # # ##### ##### ##### ### ##### # # ##### # # ####### ### # # # # # # # ##
# #   #   # #   # # # #   #     #   # #   # #     # # # #     #     #           #   # # #   #   # #     # # #   # #   # #   #   
# # ##### ##### # # # # ####### ### # ### # ####### # # ### ####### # ############# # # ### # ######### # # # ### ##### ####### 
# #   # #     # # # # #         # #   #   # #     # # #   # #       #       #       #   #   # #   #     #   #   #       #       
##### # ##### # # # # ########### ##### # # # ### # # ### # # ####### ### # # # # ### ### ### # # ####### ##### ##### ### ######
#   #   #   #   # # # #           #   # # # # #   #   #   # # #         # #   # #       #   #   #   # #   #     #     #   #     
# # ### # # ##### # # # ##### ##### ### # # # # ##### # ##### # ####### ####### ### ####### ####### # # ### ####### ### ##### # 
# #     # #     # # # # #   #       #   # #   # #     #       #     #   #     # #   #             # # # # # #     #   # #   # # 
# ########### # ### # # # # ### ##### ### ##### # ############### ### ### ### # # ### ########### # # # # # ### # ### # ### ### 
# #           #   # #     # #   #   # #       #   #     #       # #   # # # #   #   #           # # # # # #     #     # #   #   
# # ############# # # ### # ##### # # ##### # ##### # ### ##### # # ### # # ####### ########### ### # # # ########### # # ### # 
# #   #         # # #   # #       # # #     #       #         #   #   # #   #       #     #   # #   # # #     #     # # # #   # 
# ### # # ####### # # # ############# # ##### ### # ################# # ##### # ######### # # # # ### # # ##### ##### # # # ### 
#     # # #     #   # #     #         # #     #   #       #     #     #     # # #       #   #   #   #   # #     # #   #   #   # 
####### # # ### ##### ##### # ######### # ##### ### # ##### ### ########### ### # ##### ####### ### # ### # ##### # ########### 
#       # # # #           # # # #       #   # # #   #     #   # #     #       # # #   #   #       # #     # #     #       #     
# ####### # # ########### # # # # ######### # # # ####### ##### # ### # ##### # # # ##### ####### # ##### # # ### ####### # ### 
# # #     # # #       # # # # # #   #     #   # # #       #   # #   # # #   #   # #   # #       # #   #   # # # #     #   #   # 
# # # ### # # # ##### # # # # # # # # ### ##### ### ##### # # # # # # ### # ##### # # # ####### ##### ### # # # ##### # ####### 
# #   #   #   # #   # #   # # # # # #   #     #   # #   # # #   # # #   # #       # #         #     #   #   #     #   # #     # 
# ########### # ### # ##### # # ### ### ##### ### # # # # # ####### ### # ######### ######### ##### ### # ####### # ### # ### # 
#         #   #     #     # # #   #   # #         # # # # #         # #   #                 #   #   #   # #     # # #   #   #   
# ####### # ####### ##### # # ### ### # ########### # # # ########### ##### # ############# ##### ### ### # ### # # # ######### 
#     #   #     #   #   # # #   # #   # #   #   #     # #                 # #         # #   #     #   #     #   # # #           
# ### # ####### # ### # # ##### # # ### # # ### # ##### # ####### ####### # ######### # # # # ##### ### # # # # # ############# 
# # # # #       #     # #     # #   #     #   # # #     #       #       #   # #   #   #   # #   # # #   # # # # # #       # #   
# # # ### ############# ##### # ############# # # # ##### ##### ### ##### ### # # # ####### ### # # # ### # # ### # ### # # # ##
#   #     #           #   #   #   #   #       #   #   #   #   #   # #   #   #   #   # #       # #   # #   # #   # # #   #   # # 
### ####### ######### ### # ### # # # # ############# # # # ##### # # # ############# # ##### # ### # ##### ### # # # ####### # 
# # #     #         # # # #   # # # #   #   #   #   # # # #   #   # # # #       #   #   #   # #   #   #   #   #   # # #   #   # 
# # # ### # ####### # # # ### ### # ##### ### # # # # # ##### # ##### # # ##### # # ##### # ##### ### # # ##### ### # ### # ### 
# #   #   #   #   # #   #   # #   #   # #     #   # # #       #     # #   #   # # #       # #     #   # #     # #   # #   # # # 
# ##### ##### # # # ####### # # ##### # ########### # # ########### # ####### # # ########### ####### # ##### ### ### # ### # # 
# #   #         # #       # # # #   # #       #   #   #     #   #   #   #     # #   #       #               #       #   #   #   
# # ##### ################# ### # # # # ##### # ####### ##### # # # ### ##### # ### # ##### ############### ############# ### ##
#   #     #   #   #       # #   # #   # #   #           #     # # #   # #     #     #     #   #           # #           #   # # 
# ### ##### # # # # ##### # # ### ####### # ######### # # ##### # # ### # ############### ### # ######### # # ######### ### # # 
# #   # #   # # # # #   #   # #     #   # #           #   # #   # # #         #         #   #   #         #   #       #   # #   
# # ### # ### # # # ### ##### ##### ### # ########### ##### # ### ### ##### # # ################# ######### ### ##### ##### ### 
#       #   #   #   #   #     #   # #   # # #               # # #     #   # #   #       #       # #           #   # #     #   # 
# ######### ######### # # ##### # # # ### # # ### ####### # # # ####### # ####### ##### # ### # # # ############# # ##### ### # 
# # #     #     #     #   # #   #   #     # # #   #   #   # #   #   #   #         #   # # # # # # #     #   #     #     # #   # 
# # # ######### # ######### # ############# # # ### # # ######### # # ############# # # # # # ### ### ### # # ##### ##### # ### 
#   # #   #   #   #   #   # #   #   #   # #   # #   #   #       # #   #     #       # #   # #     #   #   #   #     #   #   #   
# ### # # # # ##### # ### # ### # # # # # ### ### ####### ##### # ######### # # # ### ##### ####### ### ####### ### # # ####### 
#   # # # # # #     #     #     # #   #     # #   #       #   # # # #         # # #   #     #     # #   #     #   #   #         
# # # # # # ### ######### ####### ######### # # # # ####### ### # # # ######### # # ### ### ##### # # ##### ##### ####### ##### 
# #   # # #    G#       # #   #   #     # #   # # #       #     #       #   #   # #   # # #   #   #   #   #             #     # 
# ##### # ############# # # # ### # ### # ### # ######### # ####### ##### # ##### ##### # ### # ### ##### # ##### # ######### ##
# #     # # #           # # #     #   #       #   #   #   #         #     #   #             #             # #   # # #   #   #   
# # # ### # # ##### ### # # ######### # ######### # # # ####### ### # ####### # ################### # ##### # # # ### # # # ### 
# # #   # # # # #   #   #   #         # #         # # # #       #     #       #   #             # # # #     # # # #   #   #     
# ##### # # # # # # # # ##### ######### # ######### # # ### ### # # ### # ######### ########### # # # # # ### # ### ########### 
#       # # # #   # # # #     #     #   #           # #   # #   # #   # # #       #     #       #   #   #     #   # #           
######### # # ####### # ##### # ##### # ################# # # ### # # # ### ##### ####### ####################### # ############
#         #   #       #       #       #     #     #       # #   # # # #   #   # #     #   #                       #             
# ############# ##################### ##### # ##### ########### # # # ### ### # ##### # ##### ##################### ########### 
# #     #     # #     #     #             #   #     #           # # #   #     #   # # # #   #   #             #     #   #   #   
# # ### # ### # ### # # ### ##### ### ### ##### ##### ##### ### # ####### ####### # # # # # ### # ########### ### # # ### # # ##
#   # #   #   #   # # #   #     #   #   #   #   #   # #   # #   # #     #   #   #   #   # #     # #     #   #   # # #     #   # 
##### ##### ### # # ##### ##### # # ##### # # ##### ### # # ##### # ### ### # # ### ##### ####### # ### # # ### # # ########### 
#   #   #   #   # #     # # #   # #   #   # #     #     # #     #   #   #   # # #   #     #   #   # # #   # # # # #         #   
# # ### # ### ### ##### # # # ### ### # ### ##### ####### ##### ##### ####### # # # # ##### # # # # # ### # # # ####### # # # ##
# # #   # #     # #   # # # #   # #   # # #   # # #     #       #   # #  S    # # #   #     # # # # #   # # # # #       # #   # 
# # # ### ####### # ### # # ### ### ### # # # # # # ### ####### ### # ######### # ########### # # # ### ### # # # ####### ##### 
# #               #       #         #   #   #   #   #   #           #           #             # #     #     #     #             
################################################################################################################################
