################################################################################################################################
 #   #     #       #           #     #           #         #           #       #     #   #     #   #         #                 #
 # # # ##### ##### # ######### ##### # ######### ### ####### ####### ### ##### # ##### # # ### # # # ####### ### ########### # #
 # # #       # #   # #   #   # #       #       #     #   #   #     #     # #   #   #   # # # #   # #   #   #   # #   #   #   # #
 # ########### # ### # # # # # # ##### # ##### ####### # # ### ########### # ##### # ### # # ##### ### ### ### # # ### # #######
 # #         #   #   # # # #   #     #   # #   #     # #   #     #     #   #     #   #   #     # # # #     # # #   #   #       #
 # # ####### # ### ### # # ##### ### ##### # # # ### # ######### # ### # ##### # ##### ####### # # # ####### # # ### ######### #
 #   #       # #     # # # #   #   #     #   #     # #   #     # #   #   #   # # #     #   #   #   # #   #     #   # #   #   # #
 ### # ##### # ##### # ### # ##### ##### ######### # ### # ### # ### ##### # # # ##### # # # ####### # ### ##### # # # # # ### #
     # #     # #   # #   # #     # #   #   #   #   # #   # # #     # #     # # # #   #   # #       # #   #       # # # # #     #
 ##### ##### # # # # ### # ##### # # # ### # # ##### # ### # ### ### # ##### ### # # ##### ####### # ### # ######### # # #######
 #   # #   #   # #   #   #     #   # #   # # # #     #   #   # # #   # #   # #   # #             # #               # # #       #
 # # # # # # ### ##### ####### # ### ##### # ### ### ### ##### # # ### # # # # ##### ####### ### # ####### ####### # # ####### #
 # # # # # #   # #     # #     #   #   #   #     #     #     # # #     # # # #     #     # #   # #       #   #   #   # #     # #
 # # # # # ### # # ##### # ####### ### # ################### # # ######### # ##### # ### # ### # ####### ### # # ##### # ##### #
 # # # # # # #   #       # #           #   #             #   # #     #     #     # # #   #     #   #     # # # #     #   #     #
## # ### # # ########### # ### ############# ########### # ### ##### # ######### # # # ########### # ##### # # ########### #####
   # #   # #         #   #   # #   #       # #       #   # #       #     #     #   # # #   #       #   #     # #         # #   #
 ##### ### ####### # # ##### # # # # ##### # # ##### ##### # # ##### ##### ### ##### # ### # ##### ### # ##### # ### # ### # # #
 #     # #       # # #     #   # # # #   # # # # #   #     # #       #   # #   #     #   #   #       # # #   # # # # # #   # # #
 # ##### ####### # ####### ### # ### # # # # # # # ### ##### ######### # # # ### ####### ####### ##### # ### # # # # ### ##### #
   #   # #     # #     # #   # #     # #   # # #   # # #   #       #   #   #     #       #     # #     #   #   #   #     #     #
#### # # # # ### ##### # ### # ####### ##### # # ### # ### # ##### # ############# ##### # ### # # ####### ### ### ####### ### #
 #   #   # # #   #       # # # #     #     #   #     #   #   # #   #   #         #     # # # # # #       # #     #   #       # #
 # ####### # # ######### # # # ### ####### ##### ####### ### # # ##### ##### ####### # ### # # ######### # ### ##### # ##### # #
 # #       # # #       #           #       #   # #     #   # # #     #         #   # # #   # #         # #   #   #   # #     # #
 # # ######### # ##### ########### # ####### ### # ### ### # # ##### ####### ### # ### # ### ####### ### ### # # # ### # ##### #
 # #     #     #   #   #     #   # # #       #   #   #   # #       #       # #   #   # # #     #   #   # #     #   #   #     # #
 # ##### # ####### # ### ### # # # # # ####### ####### ### # ######### # # # # ##### ### ### # ### ### # # ##### ### ### ### ###
   #   # #         #     # # # # # # # #           #   #     #     #   # # # # #   #     #   #   #   # # #     #       #   #   #
 ##### # ################# # # # # # # ##### ### ### ### ##### ### # ### ### # # # ####### ##### ### # # # ### ####### # ##### #
                         # #   #             #   #   #   #     #   # #   #   # # #         #   #     #   # # # #   #   #   #   #
######## ######### # ### # ##### ############# # # ### ### ######### ##### ### # ########### # ##### ##### # # # # ####### # ###
   #     #     # # #   #         #     #       # #   #   #   # #   #       # # # #   #   #   #   # # #       #   #   #     #   #
 # # ##### ### # # ### ####### # # ### # ####### ### ### ### # # # ##### ### # # # # ### # # ### # # # ############# ###########
 # #     #   #   #   # #     # # #   #   #     #               # # #   #     # # # #   #   # #     # # #         #   #         #
 # ##### ### ######### # ### # # ### ### # ### ##### ######### # ### # ####### # # ### ##### ### ### # # ####### # # # ####### #
 # #   #       #       #   #   # #   #   #   # #   # #           #   # #   #   # # #   #     #   #   # #     # # # # # #     # #
 ### # ######### ##### ### ####### ######### ### # ### ######### # ### # # # ### # # ### ##### # # ### ##### # # # # # ##### # #
 #   #           #       #   #     #         #   #     #       # #   # # #   #     # #   #     # #         #   # # # #       # #
 # ############### ### # ### # ### # ######### ######### ##### # ### # # ##### ##### # ### ##### ######### ### # # ########### #
 # #     #       # #   #   # # #   #   # #   # #       # #   # #   # # # #     #     # #   #                 #S# #     #   # # #
 # # ### ##### # ### ##### # # # ##### # # # # # ####### # # # # # # ### ####### ##### # ### ############### # # ### ### # # # #
 # # #   #     #     #     # # #     # # # #   # #       # # #   # #   #   #   #   #   # # #     #   #       # #   #     #   # #
 # # # ### ################# # ##### # # # ##### # ####### # ##### ### ### # # ### # ### # ####### # # ##### # ### # ######### #
 # # #     # #               # #     # # #       # #     # #   #             #     #   # #   # #   #   #     #   # #         # #
 # # ####### # ########### ### # ### # # ######### # ### # # # ### ################### # ### # # ####### ### ### # ######### # #
 # #       # #     #       #   # #   # #         # #   #   # #   # #         #       # #       #       #   #   # #       #   # #
 # ####### # ##### # # ### # ### ### # ######### # ### ##### ### # # ####### # ##### # ####################### # ####### # ### #
 # #       # #   # # # #   #   #   # #   #     # #   #     #   #   #       # #     # #     #     #   #       #   # #     #   # #
 # # ####### # # # ### # # ### ### ##### # ### # ### # ### ### ### ##### ### ####### ##### # ### # # # ##### ### # # ######### #
   # #   #   # # # #   # #   #   #   # # # # #     # # # #   # #     #   #   #   #   #     # # #   # #     #   # #   #   #   # #
#### # # # ##### # # ### ### ### # # # # # # ####### # # ##### # ##### ### ##### # ### # ### # ##### ######### # ##### # # # # #
 #     #   #   # # #   # #     # # # # # #   #     # #   #     # #   #   #     #       # #   #     #     #   # #       #   # # #
 # # ######### # # ### # ##### # # # # # ### # ### # ### # ####### # ### ##### ######### # ##### # ##### # # # # ##### ##### # #
   #           # # # # #   #   # # #   #   # # # # #   # #       # #   #   # #       #   #     # #     # # #   # #   #   #   # #
########## # ### # # # ### ##### # ####### # # # # ### # ####### ##### ### # ####### # ####### # ##### # # ##### # # ### # ### #
         # #     # # #   # #     #       # # # #   # # # #   #   #   #   # #       # # #       # #   # # # #       #   # #     #
 ####### # ### ### # ### ### ##### ##### # # # ##### # ### # # ### # ### # ### ##### ### ####### # # ### # ### ####### # #######
   #     # # # #   #   # #   #   #   #   # # # #     #   # # # #   #     #   # #   #             # #     #   #   #     #       #
#### ##### # # # ##### # # ### # ### ##### # # # ####### # # # # ########### # # # ######### # ### ######### ### ######### ### #
 #   #     #   #   # #   #   # #   #   #   #     #     # # #   # #         #   # #     #     # #   #         # # #   #   #   # #
 # ### # ######### # ### ### # ####### # ####### # ### # # ##### # ########### # ##### ######### ### ### # ### # # # # ### # # #
 # #   # # #     # #       # #     #   # # #     # #   # #       # #           # #     #         # # #   #     # # # #   # # # #
 # ##### # # ### # # ### ### ##### # # # # # # ### # ### ######### # ########### # ##### ######### # # ##### # # # # ### # # # #
   #   # # # # #   #   #   #   #     # # #   # #   #   #   #       #   #   #   # #       #         # # #   # #   # # #   # # # #
 ### # # # # # ####### ### ### ####### # ##### # ######### # ######### # # # # # ######### ####### # # ### # ##### # ### ### # #
     # # # # #           #   #   #   # #   #   #     #   # # #       # # #   # # #         #   #   # #     # #   # #   # #   # #
###### # # # ##### # ### # ##### ### # ### # ####### # # # # ####### # ####### # ####### ##### # # # ######### # # ### # # ### #
   #   #   # #     #   # #   # #   #   #   # #     #   # # #   #     # #     # #       # # #   # # #     #     # #   # #   #   #
## # ####### # ### ### ##### # ### ##### ### # # ####### # ### # ### # # ### # ####### # # # ### ####### # ##### ### # ### #####
   #         # #   # #     #   # #   #   #   # #         #   #   #   #   #   #   #     # # # # #         # #   # #   #   # #   #
 ############# ### # ##### ##### ### # ##### # ############# ##### ####### ### # ####### # # # ########### ### # # ##### ### # #
 #   #   #   #   #   #   #     #   #   #   # #   #   #     #     #   #   #     #   #     # # #           # #   #   #   #     # #
 # ### # # ##### # ### ### ### # # ##### # # ### # # # ####### ##### # ########### # ##### # ### ######### # ####### ######### #
   #   # #   #   #   #   #   # # #   #   # #   #   #   #   #   #     #       #     # #           #         #   #   #           #
## # ####### # ### ### # ### ### # ### ### ### # ####### # # ### ##### ####### ##### ### ######### ########### ### #############
           #   #   #   #   #   # #   #   #   #   #     # #   #   # #     #     #   #   # #     #   #   #     #       #         #
 ######### ##### # # ### ##### # ### ####### # ### ### # ##### ### # ### # ##### ##### # # ### # ### # # ### ####### # ####### #
   #       #     # #   #     #   # #   #   # # #   # # #             #   #   #           # # #   #   # #   # #   # # # #   # # #
## # ##### ##### # # ##### ####### ### # # # # # ### # ##################### ######### ### # ##### ### ##### # # # # # # # # # #
   #     #       #   #   #         # #   #   # #     #                     #     #  G# #   #   #   #       #   # # # #   #   # #
 ####### ############# # # ######### ######### ##### ##################### ##### # # # # ##### # # ####### ##### # # ##### ### #
     #   #     #       # #           # #     #   # # #     #             #       # #   #     #   #   #     #   # #     #   #   #
#### # ### ### # ####### ####### ##### # ### ### # # ##### # ####### # # ########### ####### ### ### ### ### # # # ##### ### # #
     # #   #   #   #   #       #           #       #   # #   #     # # #           # #       #     #   # #   #   #       #   # #
 ##### # ### # ### ### ####### # ############# ####### # # ### ### ### ########### # # ############### # # ####### ####### ### #
     #     # # # #   #       # #       #     #   #     #   #   # #   # #       #   #   # #           # # # #       #     # #   #
 ########### # # ### ### ### # ####### # ### ### # ######### ### ### # # # ##### ##### # # ######### ### # # ########### # #####
   #       # #     # #   #   #       # #   #   # #         #     #   # # #     #     # # #   #       #       #     #   #   #   #
 # # ##### # # ##### # ### ######### # ### ### # ######### ####### ### # ##### ##### # # ### # ####### ####### ### # # # ### # #
 # # #   # # # #     #   # #       # #   #   # #         # #   # # #   # #   #   #   #     # # # #   #         #   # # # #   # #
 # # # ### # ### ####### # # ####### ### ### # ####### ### # # # # # # # # ##### # ### ### ### # # # # ##### ### ### # ### ### #
 # # #   # # #   #     # #   #     # # # #   # #       #   # # #   # # # #     # # #     #         #   #   # # #     #   #   # #
 # # # # # # # ### ### # ### # ### # # # # ### # ####### ##### ### ### # # ##### # # ### # ####### ##### # # # ######### ##### #
 # # # #   # # #   #   #   # #   #   #   # #   #       # #   #   #   # # #     #   # #   # # #   # #     # # #         #     # #
 # # # ##### # ##### ####### ### ######### ### ######### ### ### ### # # # ### ##### ##### # # # # # ##### # ######### ##### # #
 # # # #     #     # #   #   # # #       #   # #         #         # # # # #       #     #   # # # # #     #     #     #   #   #
 # # # # ######### # ### # ### # ### ### ### # # ######### ####### # ### # ####### # ### # ### # ### ##### ##### # ##### #######
 # # #   #   #   #   #   #     #     # # #   #         #   #   #   #   #         # #   # # #   #   #     #   #   # #   #   #   #
 # # ##### # # # ##### ### ########### # # ##### ##### # # # # # ##### # ##### # ### ### # # ##### ##### ### # ### # ##### ### #
 # #   #   #   #           #     # #   # #   #   #   #   #   # #             # #   # #   # #   #   #   #   # #     # #   # #   #
 # ### # ####### ####### ### ### # # # # ### # ### # # ####### ############# ##### # # ####### # ### # ##### # ##### # # # # ###
 #   #   #   #   #     # #   #   # # # #   # # #   # # #     #   #   #     # #   #   # #       #     #       #     #   #   # # #
 ### ##### # ##### ### ### ### ### # # ### ### # ### # # ####### # # # ##### # # ##### # ##### ################### # ####### # #
   # #     # #   # # #     # #   # # # #       # # # #     #     # # # #   # # #   #   # #   #         #   #     #           # #
#### # ##### # # # # ####### ### # # ### ####### # # ####### # ##### # # # # # ### # ### ### # # ####### # ##### ####### # # # #
     # #   #   #   #     #   #   # # #   # #     # #   #     # #     #   #   # #   #   #   #   #         #     #   #     # #   #
 ##### # ########### ### # # # ### # # ### # ##### ### # ####### ############# # ######### ### ############### ### # ##### # ###
 #   # #           #   #   # #   # #       #   # #     # #       #         #   #   #     # #   #       #     #   # #   #   #   #
 # # # ####### ### ######### ### # # ### ##### # ####### # ####### ####### # ##### # ### # # ### ### # ##### ### # # # ####### #
 # # #       # #   # #   #   # # #   #   #     #         #   #   # #     # # #   #   # #   #     #   #         # # # #   #     #
 # # ####### # ### # # # # ### # ### # # # ##### ##### # ### # # # # ### # # # # ##### ##### ########### ####### # ##### #######
 # #   #     #   #   # #   #   # # # # # #   #   #     #       # # #   # #   # # #     #   # #         #   #     # #   #   #   #
 # ### # ####### ### # ##### # # # # # # ### ##### ############### ### # ##### # # ### # # # # ####### ##### ### # # # ### # # #
 # # #   #   #   #   #       # # #   # # # #     # #   #   # #     #   # #     # #   # # #   # #     #       #   # # # #   # # #
 # # ##### ### ### # ######### # ##### # # ##### # # # ### # # ##### ##### ##### ### # # ### # ##### ### ####### # # # # ### # #
 # # #   #   #   # #         # #       #   #     #   #     # #   #     #   #   #     # #   # #   # #     #     # #   # #     # #
 # # # # ### ### # ##### ### # ##### ##### # ########### ### ### ##### # ### # ####### ### # ### # ##### # ### ####### # ##### #
 # # # #   #     #     # # #         #     # #   #     #       #   # #   #   # #     #   # #   # #     # #   # #     # # #     #
## # ### # ##### ####### # # ######### ### # # # # ### ### ### ### # ####### # # ### ### # ### # # ### # ### # # # # # ### #####
   #     #   #   #     #   # #       #   #   # #   # # #   #   #   #         # #   # #   # #   # #   #   #   #   # # # #   #   #
 ########### # # # ### ####### ##### ####### # ##### # # ####### ##### # ##### ### # # ### ##### ### ### # ####### ### # ##### #
       #   #   # # # #   #     #   # #     # # #   #   #   #     #   # #     #   # # #     #     #   #   #     # #     #     # #
###### # # ##### # # ### # ##### ### # ### # # # # ######### ##### # # ####### # # ####### # ##### ########### # ########### # #
       # #   # # #   # #   #   # #   # #   # #   #           #     # # #     # #       #   # #   # #           # #           # #
 ####### ### # # ##### ##### # # # ### # ### ################### ### # # ### ####### # # # # # # ### ########### ##### # ##### #
         #   #               #   #     #                         #     #   #         #   # #   #     #                 #       #
