################################################################################################################################
################################################################################################################################
         #     #       #               # #     #     #     #   #   #         #                   #   #   #           #       # #
 ######### # # ### # # # ############# # # ### # ### # ### # ### # # # # ### # ####### ##### ### # # # # # # ##### # # ##### # #
 #         # # #   # # #   #   #   #   #   # # #   # # # #       #   # # #   # #       #     #   # #   # # # #     # #     #   #
 ####### ### # # ### # ### # # # # # ####### # ### ### # ### ######### # # ##### ##### # ##### ### ##### # # # ##### ##### ### #
         #   #   #   #   # # #   # #   #   #     #     #     #       # # #       #     #   #   #   # #   # # #     #       #   #
######## # ##### # ##### # # ##### ##### # ### # ####### ##### ##### # # ############# ### # ### ### # ### ################# # #
         # #     #     # #   #   #       # #   #         #   #   #   # #     #         #   #     #   # #     #           #   # #
###### # # ############# ####### ######### # ####### # ### # ### # ### ##### # # ####### ######### # # # ### # ######### # ### #
   #   # #   #     #   #             #   #   #     # #   # # #   #   #   #   # #       # #   #   # # # #   # #         # # # # #
 # # ### ### # ### # # # # ######### ### ### # ### # ##### # # ##### # ### ########### # # # # # # # # ### # ######### # # # # #
 # # #   #   # #     # # #     #           # # #     # #   #   # #   # #   #   #   #   # # # # # # # #   # # #         #   #   #
 # ### ### ### ####### # ##### ######### # # # ##### # # ####### # ##### # # # # # # ### # ### ### ##### ### # ####### ####### #
 #   #   #   #   #   # #     #     #   # #   #     # # #   #     #   #   # # #   # # #   #       #   # #   # #   #     #       #
 ### ### ### ### # # # ### # ##### # ### ######### # # ### ##### ### # ##### ##### ### ######### ### # ### # ### # ##### ##### #
   #   # #   #   # # #     #     # # #   # #       # #   #     #   #   #   #   #   #   #           # #   # # #   #     #   # # #
###### ### # # # # # ####### # ### # # ### # ####### ### ##### ### ### ### ### # ### ##### ####### # # # # # # ####### ### # # #
       #   # # # # # #     # #   #   #     # #           #   #   #     #   #   #   # #     #     #     #     # #   #   #   #   #
 ####### ### # ### # ### # # # # ########### ##### # ##### # ### ### ### ### ##### # ####### ### ############# ### # ### ### ###
     #   #   #     # #   # # # #           #     # #   #   #   # #   # # # #   #   # #   #   # #   #   #     #     #   #   #   #
#### # # # ######### # ### # ####### # ### ##### ####### ##### # # ### # # ### # ### # # # ### ### # # # ### ######### ####### #
   # # # # # #       # #   #   #     #   #     # #       #       #   # # #   # # #   # #   #   # # # #   # #   #   #   #     # #
 # # ### # # # ####### ### ### # ##### # ####### # ######### ####### # # ### # ### ### ##### # # # # ##### ### # # ##### ### # #
 # #   # # # # #   # #   #     #     # # #       #         # #     #   #     #     # #   # # #   # # #       # # #       # # # #
 ##### # # # # # # # ### ########### ### # ############### # # ### ######### ####### ### # # ##### # # ##### # ########### # # #
 #     # # # # # #   # #     #     #   # #     #   #   #   # #   #           #         # #   #       # #   # # #   #   #       #
 # ##### # # # # ##### ##### ##### ### # ##### ### ### # ### ### ############# # # ##### # ### ######### # # # # # # # ####### #
   # #   #   # # #     #   #       # # # #   #     #   # #     # # #       #   # # #     # #   #         # # #   #   #         #
 ### # ####### # # ##### ########### # # # # ####### ### ####### # # ##### ### # ### ##### ### # ######### # ################# #
 #   #   #     # # #   #     #     # # #   #   #     # # #   #   # # #   #   # #   #   # #     #     #     #       #   #     # #
 # ##### # ##### # ### # ### # ### # # # ##### # ##### # # # # ### # # # ### # ### ### # ### ######### ##### ##### # # # # ### #
 #       # #   # #   # # #   #   #     #   #   # #   # #   # #   #   # # #     #   #   #     #         # #   #   #   #   # #   #
 ######### # # # ### # # ####### # ######### ### # # # ##### ### ##### # # ######### # ####### ######### # ### # # ####### # ###
 #         # # # #   #   #     # # #       # #   # #       #     #   # # # #   #     # #     #   #     # # #   #   #     #   # #
 # ######### # # # ##### # ##### # # ##### # # ########### ####### # ### # # # # ####### ### ### # ##### # ### ##### ### # ### #
   #   #     # # #     # #     # # #     # #           #   #   #   #   # # # #   #     # # #     #     #   #   #   # #   # #   #
#### # ####### # ##### # ##### # # ##### # ##### # # ### ### # # ##### # # # ######### # # ########### ##### # # # # # ### # # #
     #   #     #     #     # # # # #     #     # # #     #   #   #   #     #     #     #   #         #       # # # # # #   # # #
 ####### # ######### ##### # # # # # ######### ### # ############# # ### ####### # ####### # ####### ########### # ### # ##### #
 #       #     #   #   #   # #   # #     #     #   #     #       # #   #       #   # #     # #     #     #   #   #   # #   #   #
 ############# # ##### # ### ##### ##### # ##### ### ### # ##### # ### # ########### # ##### # ### ##### # # # ##### # ### # ###
   #     #     # #   # #           #   # #   #   #     #       #   #   #   #   #     #     # #   # #   # # # #   # #   #       #
## ### # ##### # # # # ####### # ### ### ### # ##### # ############# ### ### # # # ####### # ### # # # # # # ### # ##### ##### #
   #   #     #   # # #         #   #     #   # #   # #     #         #       #   #   #   # # #   #   # #   #             #   # #
 ### # ##### ### # ##### ################# ### ### # ##### # ######### ############# ### # # # ####### ##### ####### # ### # ###
     # #   # #   # #     #       #       # # #   #   #     #   #     #       #     #   # #   #   #   # #     #     # #   # #   #
###### # # # # # # # # ### ##### # ##### # # # # ### # ####### # ### ####### ##### ### # ####### # ### # ##### ### # ### # ### #
 #     # # #   #     #   #   # #   #   # # #   # #   #   #   # # # #       #   # #     #   #   # # #   # #     # # #   # # #   #
 # ##### # ############# ### # ##### # # # ##### # ##### # ### # # ####### ### # ######### # # # # # ### # ##### # ##### ### ###
 #   #   #     #   #   # #   #   #   # # # #     #   #   #     #     #   #   #     #     # # #   # # #     # #   #   #   #   # #
 ### # ####### # # # # # # ##### # ##### # # ####### # ############# ### ### ##### ##### # # ##### # # ##### # ##### # ### ### #
     #       # # #   #   #   #   #   #   # #       # #     #       #   #   #     # #     # # #     # # #     #     # # #   #   #
#### ##### # # # ########### # ##### # ### ####### ##### # # ##### ### # ####### # # ##### # # ##### # # ### ##### # # # ##### #
 #   #   # # #   #       #   #       #     # #   # #     # # # #   #   #       # # # #     # #   #   # # # #     # # # # #     #
 # ### # ### ##### ##### # ######### ####### # # # # ##### # # # ### ### ### ### # # # ### # ### # ### # # ##### # # # # ##### #
   #   # #   #   #   #   #     #   #       #   #   # #     #   # #         #   #   #   #   #   # #         #   # # # # # #     #
## # ##### ### # ### ######### # ######### ######### # ######### ### ######### ######### ##### # # ######### # ### # # # # #####
   #       #   #     #     # # #         #           #       #   #   #   #   #               #   # #   #     #   # # #   #   # #
 # ########### ##### # # # # # ### # ### ##### # ##### ##### # ### ### # # ### ### # ####### ##### # # # ####### # # # ##### # #
 # #         # #   #   # # # #   # #   #     # #     #     #   #       # #   #   # #   #   # #   # # # #       # #   #     # # #
 # ######### # # # # ### # # ### # ####### # # ##### # ### ##### ####### ### ### # ### # # ### # # # # ####### # ##### # ### # #
 #           # # # # #   #   #   #   #     # # #   # # #         #   #   #   #   #   # # # #   # # # # #     # #     # #   # # #
 ############# # # ### ### ### ##### # ##### # # # # # # ##### ##### # ### ####### # ### # # ### # # ### ### # ##### # ### # # #
 #   #   #   # # #   #   # #   #     #     #   # #   # #   # #     # #   #       # # #   # # # # # # #   # #   #   # #   #   # #
 # # # # # # ### ### ##### # ### # ####### ##### ######### # ##### # ### ####### # # # ### # # # # # # ### ##### # # ### ##### #
   #   #   #   #   #   #   # #   # #     #     #       #   #       #     #       # #   # # # #   #   #       # # # # #   #   # #
 ############# ### ### # # # ####### ### ############# # ################# ####### ##### # # # ### ######### # # ### # ### # # #
         # #   #   #   # # # #     # # #   #       #   # #               # #             # # # # # #         # #     # #   # # #
 ##### # # # ### ### ##### # # ### # # ### # ##### # ### # ############# # ############### # # # # # ######### ####### # ### # #
     # #   # #   # #     # #   # #   #   #   #     # #   #         #     #                 # # #       #   # #   #       # #   #
###### # ### # ### ##### # ##### ##### ####### ##### # ### ####### # ############# ######### # ####### # # # # # # # ##### #####
   #   #   # #   #     # #         #   #       #     # #   #     # #   #     #     #         #   #   # # # #   #   #           #
 # # ### ### ### ##### # # ####### # ### ########### # # ### ### # ### # ### # ##### ##### ##### # # # # # ### ##### # ### # # #
 # #   #   #   # #   #   # #     #   # #   #         #   #   #   #   #   #   #     #   #   #   #   # # # # #   #S  # #   # # # #
 # ### ### ### # ### ##### # ### # ### ### # ############# ### ##### ##### ####### ### ##### # ##### # # # ##### # # ### ### # #
 #     # #   #   #   #       #   #     # # #     #         #   #   #     #   #   # #   #     #     # # # #       # #   # #   # #
 ####### # # ##### ### ####### ### ### # # ##### # ######### ##### ########### # ### ### ######### # # # ######### ### # # ### #
     #   # #       #         #   #   # # #     # #     #   # #   #   #   #     #     #   #       # #   # #   #     #   # # #   #
#### # ### # ####### ####### # # # ### # ##### ####### ### # # # ### # # # ########### ### ##### # # ### ### # ##### ### # # ###
   # #     #               # # # #   #   #   #   #       # #   #   #   #   #       #   #   #   #   #         # #   # #   # #   #
 # # ############# ####### # # # ### ##### # ### # # # # # ####### ####### # ##### # ### ### ####### ### # ### # # ### ### # # #
 # # #           # #       # # # # #       # #   # # # # #     #   #       #     # #   #   #           # #   # # # #   # # # # #
 ### # ##### ### # # ####### # # # # ######### ### # # # ##### # ### ### ####### # ### ### # ######### ##### # ### # ### # # # #
     #     # #   # #   #     # # #   #       #     # # # #   # #   #   # #       #     #   # # #   #   #     #   # #   #   # # #
########## # # ### ### # ##### # ##### ##### ### ##### # # # # ### ##### # ##### ####### ### # # # # ### ####### # # # ##### # #
   #       # # #   #   # #   # #     #   # #   # #     #   #   #   #   # # #   # #   #   #       # # #   #   #   # # #   #   # #
 ### # ### # # # ### ##### # ####### ### # ### ### ##### ####### ### # # # ### # # ### ### ### ##### ##### # # ### ##### ##### #
     # #   # #   # #       #   #       # #   # #   #     #     #   # #   # #   #   #   #     # #   # #     # #   #     # #     #
#### # ##### ##### ########### # ####### # # # # ### ### # ### ### # ##### # ### ### ### ### # # # # # ##### # # ##### # # #####
 #   #     # #   #     #   #   # #     # # # #   #     #   # #   #G#   # # #   # #   #   #   # # # # # # #   # #     #   # #   #
 # # ##### # # # # ### # ### ### ##### # # ####### ### ##### ### # # # # # ### # # ### ######### # # # # # ### ##### ##### ### #
   # #     #   # # # # #   #   #       # #         # #         # # # #   # #   # #   # #         # # # # #   # #   #     #     #
#### # ######### # # # ### ### # ####### ####### # # ### ####### # ####### # ####### # # ######### ### # ### # # # ##### #######
     # #     #   # # #   #     #   #     #       #     # #     # #     #   #         # #       # #     #   # #   #     #       #
 ### # # ##### ### # ### ####### ### # ######### ####### # ### # ##### # ############# ####### # ######### # ##### # ######### #
 #   #   #   #   #   #           #   # #       # #   #   #   # #     # #           #         #   #     #   #   #   # #   #     #
 # ####### # ### ##### # ##### # # ### # ##### # # # # ##### # ##### # ########### # ### ####### # ### # # ### ### ### # # #####
 #   #     #   # #     #     # # #   # #   #   # # # #       #     # #             #   # #       #   # # # # #   # #   # #     #
#### # ####### # # ##### ##### # ### ####### ##### # ############# # ############### # ### ########### # # # ### # # ### # ### #
     #     # #   # #   # #     #   #         # #   # #     #     # #     #     #   # #       #       #   #     # # #   # # # # #
 ######### # ####### # ### ##### # ########### # ### # ### # ### # ##### # ### ### # ####### ####### ####### ### ##### # # # # #
 #     #   #   #     #     #     # #   #     # # #   #   # # #   #     # # # #   # #   #   #         #     # #   #     # # # # #
 # ### # ### # # # ######### # ### ### # # # # # # ##### # # # ### ### # # # ### # # # # # ####### ### ### # # ### ##### # # # #
 # # #   #   # # # # #     # # # #     # # #   # # #   # # # #   # # # #   #   # # # #   #       #       #   #   #     # #   # #
 # # ##### ### ### # # ### # # # ####### # ##### # # # # # # ### # # # ####### # # # ########### # ##### ####### # ### # ##### #
 # #       #       # #   # # #   #       # #     # # #   #   # #   #     #   #   #     #   #     #     # #     # #   # # #     #
 # ################# ### # # ##### ####### # ####### ######### ####### # ### ##### ##### # ########### ### ##### # ### # # #####
 #           #       #   # #     #       # #   #     #       #       # #                 # #         #     #   # # #   #   #   #
 ########### # ##### # ### ### # ####### ##### # ##### ##### # ##### # ######### # ##### ### ####### ####### # # # # ####### # #
       #   # # #   # #   #     #       #   # #   #         #   #     #     #     # #   # #   # #   #     #   #   # # #       # #
 ####### # # # # # # ### ####### # ### ### # ############# ############### ######### # ### ### # ####### # ######### # ####### #
   #     # # #   # # #   #   #   #   # #   # #         #   #   #           #     #   #     #   # #     # #         #   #   #   #
## # ##### # ##### # # ##### # # ### ### ### ### ##### # ### # # ######### # ### # ########### # # ### # # ####### # ### ### ###
   # #   # #     # # #   #   # #   #   #   #   #     # # #   # # #     #   #   #   #           # #   # # # #     # #       #   #
 ### # # # ##### # ##### # ##### # ### ### ### ####### # # ##### # ### # # ### ##### ######### # ### # # # # ### # ##### # ### #
   # # # #       #     #   #     #   #     # #     #   #       # # #   # #   # #           #       # #   #   #   #     # #   # #
#### # # ############# ##### ####### ####### ##### # ### ##### # # ##### # ### # ######### ##### ### ######### ####### # ##### #
     # #   #       #               # #           # # #   #   # # # #     # #   # # #     # #   # #   #       #   #   # # #   # #
 ######### # # ### # # ### ####### # # ######### # # ### # # ### # # # ##### ### # # ### ### # # # ######### ### # ### ### # # #
   # #     # # #     #   #       # # #         #   #   # # #     #   # #     #     #   #   # #   # #         #   #   #   # #   #
## # # ####### ################### # ######### ####### # # ########### # ##### ####### ### # ### # # ######### # ### ### #######
   #         #       #       #   # # #       # #   # # # #       #     # # #         # #   #   # #   #         #   #   #   #   #
 ########### # ##### # ##### # # # # # ##### # ### # # # ####### # ##### # # ##### # # # ####### ##### ####### ##### ##### # # #
 #   #   #   #     # # #   #   # # # # #     # #   # # #   #   # #     # # # #   # # # #   #   #     #       #       #   #   # #
 ### # # # ######### # # # ##### # # # # ##### # ### # # ### # # ####### # # # ### # # ##### # ### # # ##### ######### ####### #
     # #             #   #     #   #   #                     # #         #   #     # #       #     #       #         #         #
################################################################################################################################
