################################################################################################################################
             #                 #               #         #       #   #   #         #     #     #   #               #   #       #
 ####### ### # ##### ##### ### # ### # ####### ### ##### ### ##### # ### ####### ### ##### ### # # ########### # # # # ##### # #
       #   #   #     #     #   # #   #   #   # #   #   #   #     # #   # #     # #   #     # #   #   #     #   # #   #     # # #
 ##### ### ##### ### # ##### ##### # ### # ### # ### ##### # ### ##### # # ### # # ### ##### ####### # ### ##### ######### ### #
     #   #     # # # # #   #     # #   # #   # #   #     # # # #     # # #   # # # #   #         #   # #   #     #   #   #     #
#### # # ####### # # # ### ##### # ##### # # # ### # ##### # # ### ### # # # # # # # ### ##### # # ### # ### # ### # # # ##### #
 #   # # #     # #   #   #     #   #   # # # # #   # #     # #   #     # # # #   #   #   #     #     # #   # # #   #   # #     #
 # # # ### ### # ####### ##### ##### # # # ### ##### # ##### # # ####### # # ############# ### ##### # ### # # # ####### # ### #
   # #   # #   #     #   #     #     # # # #   #           #   # #       # #   #     #     #   #   #   # #   # # #     # #   # #
#### ### # ######### # ### ##### ##### # # # ### ##### # ####### # ####### ### # ### # ##### ### # ##### ### ### # ##### ### # #
 #     # #         # #       #   #   #   # # # # #   # #         #       # # #     # # #     #   #     #   # #   # #     #   # #
 # # ### ######### # ######### ##### ##### # # # # # # ####### ######### # # ####### # ##### # ##### # ### # # ### # ######### #
 # #   # #       #   #     #   # #     #         # # #       #           #   #       #     # # #   # #   #   # #   #         # #
 # ### # # ### # ##### ### # ### # ### # ######### # ####### ### # ######### # ########### # # ### # ### ### # # ########### # #
 # #   #   # # #         # #   # # #   #   # #     #   #     # # #     #   # #     #       # #   # #   #   # #   #       #   # #
 # # # ##### # ######### # ### # # ### ### # # ####### # ##### # # ### ### # ####### # ######### # ####### # ##### # ### # ### #
   # # #     #   #       #   # #   #     # # #     #   # #   #   #   #   # # #       # #       # #       # #     # #   # #   # #
#### # # ##### # ########### # ### # ### # # ##### # ### ### ####### ### # # ### ##### # ### ### ####### # # # # # ### ##### # #
   # # # #   # #     #       # #   # #   # #   #   # #     # #         # # #     #     # # #     #   # #   # # #     # #     # #
 ### # # # # # ##### # ### ### ##### # ### ### # ### ##### # # ### # # # # ####### ##### # ####### # # ##### # ####### # ##### #
     #   # # #   #   # #   #   #     # #   #   #   #   # # # #   # # # #   #     #     # #     #   #       # # #     # # #   # #
########## # ##### ### ### # ### ##### # ### # ### ### # # # ##### # # ##### ### # ##### # ### ####### ### # # # ### ### # # # #
   #     # # #     #     # # #   #         # # # #   # #   # #     # #   #     #   # #   #   #       #   #   # # # # #   # #   #
 # # ### # # # ##### ### # # ### ######### # # # ### # ##### # ##### ### ##### ##### # ##### ####### ### ####### # # # ### ### #
 #   # #   #   #   # #   # #   # #     # #   #   #   #   # #   #   #   #   #   #     # # #   #     #   # # #     # #   # # #   #
 ##### ######### ### # ### ### ### ### # ####### # ##### # ####### # # ### # ### ##### # # ### ####### # # # ##### ##### # # ###
   #   #       # #   # #   # #     #   # #     # #   # # #   #     # #   # #     #     # #   #         #   # #   # #   #   #   #
## # ### ####### # # # # # # ####### ### # ### # ### # # ### # ####### # # ####### ##### ### ########### ### ### # # ######### #
   # #         #   # # # # # #     # #   #   #   # # # # # # #   #     # #         # #   # # #     # #     #   # #   #         #
 ### ######### ##### # ### # # ##### # # ### ##### # # # # # ### ### ### ########### # ### # ##### # # # # ### # ### # #########
     #       #G#     #   #     #     # #   # #   # #   # # #   # #   #                     #   #   #   # # # # #     #   #     #
###### ##### # ### # ### ##### # ##### ##### # # # ##### # ### # # ### # # ####### ##### # ### ### ##### # # # # ####### ### ###
     # #   # #   # #   #   #   #   #   #     # #   # #   #     #   #   # #       #   # # #   #   #       #   # #       #   #   #
 ### # # ### ### # # ##### # ##### # # # ##### ##### # ####### ####### # # ##### ### # # # # ### ##### ####### # ##### ### # # #
   #   #     # #   #     # #     # # # # #   #   #   #   #   #       # # # #   # # # #   # # #   #     #       #   # #     # # #
## ########### ### ### # # ####### # # # # ##### ### ### # # ####### ### # # ### # # ##### ### ######### ######### # ####### # #
   #     #   # #     # # #       # # # # #             # # # #     #     # #   # # # #     #   #   #   # #           #     # # #
 ### ### # # # # ##### # ####### # # # # # ######### ### # ### ### ####### ### # # # ##### # ### # # # # ### ####### # ### # # #
 #     # # #   #   #   # #     # # # #   # #       #   # # #   # #   #       # #   #     # # #   # # # #   # #     # #   # # # #
 ##### # ##### ### # ##### ### ### # ####### ##### ### # # # ### ### # # # # # ######### ### # ### ### ### # # ### # ### # # # #
     # # #   #     # #     #   #   #       # #   #   # # # # #   #   # # # #   #       #   # # # #   #   #   #   # #     #   # #
#### ### # # ### ### # ######### ######### # # ##### # # # # ### # ### # # ########### ### # # # ### ### ### ### # ### ####### #
   #   #   #   # #   # #         #       #   #     #   # # #     #   # # #           # # # # #   # #     #   #   #   # #     # #
 # ### ####### ### # # ### ####### ##### ######### # ### # ##### ### # # ######### # # # # # ### # ####### ### ##### # # ### # #
 #   # #     #   # # #     #     #     #             #   #     # #   # #   #     # #     # # # # #   #       #   #   #   #   # #
#### # # ####### # # ####### ##################### ### ####### # ######### # ### ######### # # # # ### ####### ### ####### ### #
     # #           #         #             #   #   #   #       #     #   # # #           # # #   #     #       #   #       #   #
 ##### ####### ########### # # ########### # ### ### ### ########### # # # # ########### # # # ### ##### ####### ##### ##### ###
     # #       #         # # #   #       # #       #   # #       #   # # # #   #         #   # #     # # #   # #     #     #   #
 ### # ### ##### ####### # ##### ### ### # ####### ### # # ##### # ##### # ### ##### ##### ### ##### # # # # # ##### ######### #
 #   #   # #   #   # #   # #   #   #   # #     #   #   #   #     #     #     #     #     #   #     # # #   #     # #     #   # #
 # ##### # # # ### # # ### # ##### ### # ##### # ### ##### # ### ##### ########### ##### # # ##### # # ######### # ##### # # ###
 # #   # # # #     #   #     #   # #   #       #   # #     #   #   # # #       #   #   # # #   #   # #   #             # # #   #
 # # # # # # ####### ######### # # # ############# # ### ######### # # # ### ### ### # # # ### # ### ### # ####### # ### # ### #
 # # #   # #   # #   #         # # # #         #   # #   #       # # # #   # #   #   #   # # # # #   #   # #     # # #   # # # #
 ### ##### ### # # ### ######### # # ######### ### # # ### ##### # # # ### # # ### ####### # # # # ### ### # ### # ### # # # # #
 #   #   # #   # #   # #         # # #       #   #     #   #   # #     #   # #   # #         #         #   #   # #   # # #   # #
 # ### # # # ### ### # # ########### # ##### ### ####### ### # # ##### # ### ##### ##### ######### ##### ##### # # # # # # ### #
 # #   #   # #     # # # #   #     # #     # # #       #   # # #     # # # #   #   #     #       #       #   # # # # # # # #   #
 # # # ##### ##### # # # # # # ### # ####### # ####### ### # ####### # # # ### # ### ### # ##### ### ##### # ### # # # ### # ###
   # # #   #     #     #   # # #   #                 #   # # #   #   # #   # #   #   #   #     #   # #   # #     # # # #   #   #
 ##### # # ##### # ######### ### ##### ####### ##### ### # # # # # ### ### # ##### ##### # ####### ### # # ####### # # # ##### #
 #   #   #   #   # #                   #     #   # # #   # #   #   #     #     #   #     # #       #   #   #       # # # # #   #
 # # ######### ### # ####### ##### ##### ### ### # # # ### ######### # ####### ### # ##### # ####### ####### ### ### # # # # # #
   #       #   #   # #     # #   # #   # #   #   #   #           #   # #     # #   #   #   #   #   # #       #   #   #     # # #
########## # ####### # ##### # # ### # # # ### ####### ####### # # ##### # ### # ####### ##### ### # # # ##### ### ######### # #
   #   #   # #       #       # # #   # # #   #         #     # #     #   #     # #       #   #     # # # #     # #   #   #   # #
 # # # # ##### ######### ##### # # ##### ### # ####### # ### ######### ########### ####### ######### ### # ##### ### # # # ### #
 # # #   #   #   #     #     # # # # #   #   #   #   # #   #         # # #     #   # #   #         #   # # #     # #   # #   # #
## # ##### # ### # ### ### ### # # # # ### ####### # ##### ######### # # # ### # ### # ########### ### ### # ##### ####### # # #
   #       #   # #   #     #   #   # #   #     #   # #     #   #     # #   #   # #   # #         #   #   #         #     # # # #
 ############# ##### # ##### ####### ######### # ##### ##### # ####### # ####### # ### # ########### ### # ####### # ### # # # #
 #           #       # #   # #       #         # #         # #       # # #       #       #         #   # #   #   # # #   # # # #
 # ######### ### ##### # # # # ##### # ######### ### ##### # ####### # # # ########### ##### ##### ### # ##### # ### # ##### # #
 # #   #   #   # #     # #   # #     #       #       #     #     # #   # #     # #   # #     #         # #   # #     # #     # #
 # # # ### ### ### ### # ##### # ########### # ####### ### ##### # ##### ##### # # # # # ##### ####### # # # # ####### ### ### #
 # # # #     #     #   #   #   #     #   #   #   #     #       # #   #   #   # # # # #   #     #       #   #   #   #   #   #   #
 # # ### ### ####### ##### # ####### # ### ##### # ### # ### ### # ### # # ### # # # ######### # ##### ########### # ### ##### #
   #     # # #     # #   # # #     #     #     # # #   #   # #   #     # # #   # # # #   #   # # #   #     #   #   #     #   # #
########## # ##### # # # # ### ### ##### ##### # # ######### # ######### # # ### # # # # # # ### # # ### # ### # ######### # # #
     #     # #   # # # # #   # # #   #   #   # # #   #       #         #   #   #   #   #   #     # #   # # #               # # #
 # # # ##### # # # # # # ### # # ### # ### ### # ### # ##### ######### # ##### ################### ### # # # # # ####### # # # #
 # # # #   #   # # #   #   #   # #   #   # #   #   # #   #     #     #   #     #     #     #       #   # #   # # #       # # # #
 # ### # # ##### # ####### ##### # ##### # # ### # # ### # ### # ### ### # ##### ### # ### # ####### ######### # # ####### # # #
 #   # # #   #   #       # #   #   #     # #     # # # # #   # #   #         # # #   # # # # #       # #   #   # # #   # # #   #
 ### # # ### # ### # ##### # # # ####### # ####### # # # ### # ##### # ##### # # # ### # # # ####### # # # ##### # ### # # ### #
 # #   # #   #     # #     # # #       # #     #   #   # #   #     # # #   #   # #   # #   #   #   # #   #     # #     # #   # #
 # ##### # ######### # ####### ####### # ##### # ####### # ####### # # # # ### # ##### ####### # # # ######### # ####### ### # #
         #         # # #           # # #     # # #     # # #   # # # # # # #   # #           #   # #           #           # # #
############ ##### # # # ######### # # # ### # # # ### # # # # # # ### # # # # # # ############### ##### ############### ### # #
   #         #   #     # # #   #   # # #   #     # # #   #   # # #     # # # # # #     #           #         #   #     #   # # #
## # ### ##### # ##### # # # # # ### # # # ####### # ######### # ####### # # # # ### ### ########### ### ### # # ##### ### # ###
   # #   #     # #   #   #   #       # # #   #  S  #       #   # #       #   #       #   # #   #   #   # #   # #     #   # #   #
 ### ### # ##### # # ##### ####### ### ##### # ########### # ### # ############### ### ### # # # # ### # # ### ##### ### # ### #
     #   #     #   #     # #     # #   #   # # #           #     #           #     #   #     # # #     # #     #   #   #   #   #
###### # ############### # # ### # # ### # # # # ####################### ### # ### # ######### ######### # ##### ##### ##### ###
 #     #   #       #   #   # #   # #   # # # #   #             #       #   # #   # #   #   #   #         #       #   #     #   #
 # ####### # ##### # ##### # # ####### # # # ############### ### ##### ##### ##### ### # # # ### ######### ####### # ##### ### #
 # #       # #     # #   # # # #     #   # #               # #   #   #       #   #   # # # #     # #           #   #     # #   #
 # ####### # ####### # # # # # ### ####### ### # ######### # # ### # ######### # ### # ### ####### # ####### ### ####### # # ###
 # #     # #   #   #   #   # #   # #     # #   #   #     #   #     #     #     #   # #     # #   # # #     #   #   #   # # #   #
 # # ### # ### # # # ####### ### # # ### # # ##### # ### ##### ########### ####### # ####### # # # # # ### # # ### ### # # #####
 # # #   #   #   # #   #   #   #   # #   #   #     # # # #   # #           #     # #     #     #   #     # # #   # #   # #     #
 # # # ### ####### # # # # ### ##### # ####### ##### # # # # ### ########### ### # # ### # ##### ######### ##### # # # # ##### #
 #   # #       #   # #   #   #   #   #         #   # #     #   # #       #   # #   #   # # #   # #     #   #   # #   # #     # #
 ##### # # ### # ### ####### ### # ### # # # ### # # ######### # ##### # # ### ####### # # # # # # ##### ### # # ##### ####### #
 #     # # #   # #       #   #   # #   # # #   # # #   #     #   #   # # #   #         # # # # #     #   #   # #     #         #
 # ##### # # ### # ##### ##### ### # ### # ### ### ### # ######### # ### ### ### # ##### ### # ### ### ####### # ### ###########
 #   # # # #   #     #   #       # # #   #   #       # #         # #       #   # #   # #     #     #   #     # #   # #         #
 ### # # # ####### # ##### ####### # # ############### ### ##### ### ######### ##### # ########### # ### ### # ### # # ### # ###
     #   # #     # # #     #     # # # # #   #   #     #   #         #       #       #   #       # #   # # # #   # #   #   #   #
############ ### # ### ##### ### # # # # # # # # # ######### # ####### ##### ########### # ##### # ### # # # ### # ########### #
             #   #     #     # #   # #   # #   #   #       # # #     #     #   #   #     #   #   #   # #   #     # #         # #
 ############# ####### # ##### ##### ##### ######### # # # # # # ### ##### ### # # # ####### # ##### # ### ####### # ####### # #
 #   #     #   #       #   #   # #   #   #     #   # # # # # # # # #     #   # # # #   #   # #   # # #     #       #   #     # #
 ### # ### # ######### ### # ### # ### # ##### # ### ### # ### # # ######### # # # ### # # # ### # # ####### ### # ### # ##### #
   # #   #             # #   # #   #   #       #     #   #     # # #         # # #   # # #   # # #         # # # #   # # #     #
## # ### ############# # ##### ### # # ############# # ### ##### # # ########### ### # # ##### # # # # ### # # # # # # # ##### #
 #   #   #           #             # # #   #     #   # #   #   #   # #           #   #   #     # # # # #     #   # # # #   #   #
 ##### ### ######### ##### # ####### ### # # ### ##### # ### # ### # # ########### ########### # ### # ####### ### ### ### # ###
 #   # #   #       #       #   #     #   # # #   #   # # #   # # # #   #     #     #       #   #     #   #   # #   #   # # #   #
 # ### # ### ##### ####### ### # ##### ### ### ### # ### # ### # # ### # ### # ### # ##### # # ##### ### # ### # # # ### # ### #
       # #     # # #   #     # #     #   #   # #   #     #   #   # #   #   #   #   #   #   # # #       # #     # # #   #   #   #
######## # ### # # ### # # # # ##### ####### # # # ##### ####### # # ##### # ##### ##### ### # # ### # # ####### # ##### ### ###
   #   # #   # #     #   # # #     #       # # # #   #   # #     # # #   # # #     # #   #   # # #   # # #     # # #   #   # # #
 # # # # ### # ##### ##### # ##### ####### # # ####### # # # ##### # # ### # # ### # # ### ### ### ### # # ### # ### # ### # # #
 #   #   #   #     #       #     #       #   #         #             #     # #   #         #       #   #   #   #     #     #   #
