################################################################################################################################
#                     #     #                 #     #             #           #       #     #     #     #           #   #   #   
# ####### # ######### # # # # ############# # # ### ### ##### ### # ### # ### ##### # # ### # ### # ### # ####### # # # # ### # 
# # #     #         #   # #     #   #   #   # # # #   # #   #   #   #   # # #     # #   # # # # # #   #   #     # #   # #     # 
# # # ############# ##### ##### # # # # # ### # # ### # # # ### ######### # ##### # ##### # # # # # ####### ### # ##### ####### 
# # # #     #       #   # #   #   #   # #   #       #   # #   # #       #       # #       # # # #           # # # #     #     # 
# # # ##### # ####### # ### # ####### # ### ##### ####### ### ### ##### ### # # # ####### ### # # ######### # # ### ##### ### # 
# #   #   #   #       #     # #     # #   # #   # #   #   # #     #   #   # # # #     #   #   # # #       #   # #   #     # #   
# ##### # ##### ############# # ### ### # # # # # # # # ### ####### ##### # # ####### # ### ### # # ##### ##### # # # ##### ####
#       # #   #       #   #   #   #   # # #   # #   # # #   #       #   # # # #   #   #   # #   # #     #   #   # # #       #   
# ####### # # ####### # ### ### # ### ### ##### # ### # ### # ### ### # # # # # # # ##### # # ### # ####### # ### ### ####### # 
# #     # # #   #     #     # # # # #   #   # # #   # #   # # #   #   # # # # # # # #   #   #     # #   # # # #       #     # # 
# # ### # ##### # ########### # # # ### # # # # ##### ### # ### ### ### # ### # ### # # ######### # # # # # # # # ##### ### # # 
# # # # #       # #         # # # #       #   #     # #   #   #   #   #   #   # #   # #   #     #     # #   # # #     # #   # # 
# # # # ######### ### ####### # # ##### ##### ##### ### ##### ### ### ##### # # # ####### # ### ##### # ##### ######### # ### # 
#   # # #     # #   #       # # # #     #   # #   #   # #   # #     #   #   # #   # #   # # # # #   # # #   #           # # # # 
##### # ##### # ### ####### # # # # ##### # ### # ### # ### # # ### ### ##### ##### # # # # # # # # # # # # ##### ####### # # # 
#   # #   #     # #   #   # # # # #   #   #     #     # #   #   #   # # #   # #       #   #   #   # # # # #     #       # #   # 
# # # ### ##### # ### # # # # # # ### # ####### ####### # ####### ### # # # # # ################### # ### ##### ######### ##### 
# #     #           # # # #     # # # # #       #       #   #   # #   #   # # #   #             #   #     #   # #       #       
# # ### ####### ##### # # ##### # # # # ### # ### ######### # ### # ####### # ### # ########### # ### ##### # ### ##### # ######
# # #    S# #   #     # #   #   # # # #   # #   # #   #   #             #   #     #           # # #     #   #   #     # #       
# # # ### # # ### ##### ### # ### # # ### ##### # # # # # # ############# ### ##### ######### # # # ### # ##### ##### # ### ### 
# # #   #     # #     #   # #   # # #   #     # #   # # #   #   #         #         #       # # # # #   # #   # #   # # # # #   
# # ####### ### ##### ### # # ### # ### ##### # ##### ### ### # # ######### ### # ### ##### # ### # ##### # # # # # ### # # ### 
# #   #   #   #     #   # # # #   #         # # #   #   #   # #   # #   #   #   #     #   # # #     #   # # # #   #     # #   # 
# ### # # ### ##### ### # # ### ########### # ### # ### # ### ##### # # ##### ### # ### ### # # ##### # # # ############# ### # 
# #   # #   # #       # # #     #   #   #   #     #   # # #   #     # # #     #   # # # #   #   #     #   # #   # #     #     # 
# # # # ### # # ####### # ######### # ### # ########### # # ####### # # # ######### # # # ####### ######### # # # # ####### ####
# # # # # # # #     #   #           #     # #       #   # # # #   # # # #   #   #     #   #       #     #     # #           #   
# # ### # # # # ##### ############# ######### ##### # ### # # # # # # # ### # # ### ####### ######### # ##### ### ######### # # 
# # #   #   #   #     # #         # #       #     # #   # # #   #   # # #   # #   #       #           # #   #   # #       # # # 
# ### ### ### ### ##### # ####### ### ##### ##### # ### # # ### ##### ### # # ### ### # ############### # # ### # # ##### ### # 
# #   #         #       # # #   # #   #   #     # # #   #   #   #     #   # #   #   # #     #         #   #   #   # #   #     # 
### ### ####### # ####### # # # # # ### ####### # # # ### ### # # ##### ### ### ### ##### ### ##### ######### ### # # ######### 
#   #   #     #   #     # # # # # # #   #     #   #   #   #   # # #       # # #   # #   #     #     #       # # # # #         # 
# ### ### ### ##### ### # # # # # # # # # # # ######### ####### # # ##### # # ### # # # ##### # ##### ##### # # # # ##### ##### 
# #   # # # #     # # #   # # # #   # #   # # #         #     # # # #     #   # # #   #     # #     #   #   # #   #   #   #     
# # ### # # ##### # # ##### # ####### ##### ### ############# # # # # ##### ### # ######### ####### ##### ### ####### # ### ####
# #   # # #   #   # # #     #     # #   # #     # #     #     #   # #   #       # # #     #     #     #   # #         #   #     
# ### # # ### # ### # ##### ##### # ### # ####### # # ### ####### ##### # ### # # # # ### ##### # ##### ### ########### # ##### 
#   #   #     #     #     # #   #     # #       # # #     #     #       # #   # # # #   #       # #     #             # #     # 
####### ################# # # # ##### # ### ### # # ########### ######### # ### # # ### ######### # ##### ############# ### # # 
# #   #           #     #     #       #     #   #   #   #       # #   #   # #   # # # #         # #       #       #     # # # # 
# # # ### ####### # ### ##### ############### ### ##### # ####### # # ##### # # # # # ######### # # ####### ##### # ##### # ### 
#   #     #   #   #   #     #         #   #   # #   #   # #     #   #     # # # #   #   #     # #   #       #   # # #     #     
# ##### ### # ####### ##### ######### ### # ### ### # ### # ############# # ### ####### # ### # ##### ####### ### # # ### ######
#     # #   #     #   #   #   #     #     # #   #   #   # # #     #     # # #   #   # # #   # #     #   #   #   #   #   # #   # 
# ### ### ####### # ### ##### # ##### ##### # ### ##### # # # ##### ### # # # # ### # # ### # ##### ### # # ### ####### # ### # 
#   #     # #     #   #     # # #     #     # #   #     # #   #     # # #   # #     # # # # #     #   # # #             #       
### ####### # ### ### ##### # # # ##### ##### # ### ##### # ### ##### # ##### # ##### # # # ##### ### # # ####### ############# 
# #     # # # #     # #   # # #         #     # #   #     #     #             #           # #   #     # # #     # #   #   #   # 
# ##### # # # ####### # # # # ##### ##### ### # ### # ############################# ####### # ######### # # ### # # # # # # # # 
#   #   # # #     #   # # # # #   #   #   #   #   # #       #                     #   #   # #       #   # #   # #   #   #   # # 
# ### ### # ##### # ### # # # # # ### # ### ##### # ####### # ################### ##### # # ### ##### ### ### # ##### ####### # 
#         #       # #   # # #   # #   # # # #     # #       #       #       #   # #     # #   # #   #   # # # #     #     #   # 
# ################# # ### # ##### # ### # # # ##### # ############# # ##### # # # # ##### ### # # # ### # # # ##### ##### # ### 
# #   #   #     #   #   #   #     # #   # #   # #     #     #       # #   # # # # # # #   #   #   #   #     #   # #   #   # #   
# # ### # # ### # ##### ##### ##### # ### ##### # ##### ### # ####### ### # # ### # # # ### ### ##### ### ##### # ### ##### # ##
# #   # # #   # #     #     #     # #   #     # # #       # #         #   # #   # # #   #           #     #     #   #   #   #   
# ### # ##### # ##### # ### ##### # ### ##### # # # ##### ############# ### ### # ### ### ################# ##### ##### # ### # 
#     #   # # #   #   # # #     # #   #     #       #   #                 # #   # #   #   #           #   # #         # #   # # 
##### ### # # ### # ### # # # # # ### ##### # ##### # # ####### ### # ### # # ### # ##### # ######### # # # ### ##### # ### ### 
#     # #   # #   #   # # # # # # # # # #         #   #       # # # # #   # #   # #       #     #   #   # #   # #   # # # #   # 
# ### # ### # ####### # # # # ### # # # # ####### ####### ##### # # # ##### # # # # ########### # ####### ### # # # ### # ### # 
# #       # #     #   # # # # #   # # # # # #   #       # # #   #   # #   # # # # # #         # #       #   # #   #     # #   # 
### ####### ##### ##### # # ### ### # # # # # # ####### # # # ####### # # # # ### # # ### ##### # ######### ### ######### # ### 
#   # #     #   #   #   #   #   #     #       #   #   # #   #   #     # #   #     # # # #       #     #   # #   # #     # # #   
# ### # ####### ### # # ##### ### ########### ### ### # ##### # # ##### ##### ##### # # ######### ### # # # # ### # ### # # # ##
#     #   #   # #   # #         #     #     #   #   # # #   # # # #   #   #   #   # # #       # #   # # # #   #   #   # #   #   
### ##### ### # # ### ######### ##### # ### ### ### # # # # # # ### # ##### ### # # # ####### # # # ### # ##### # ### # ####### 
#   #   #   #   # # #         #       #   #   #   # # #   # # #     # #     #   #   # #       #   #     #   #   #   # #         
# ### ##### # ### # # ####### ### ##### ##### ### # # ##### ######### # ##### ####### # ####### ######### # # ##### # ######### 
#   # #     # #   #   #   # #   #       #   # #   # #     # #       # # #         #   # #         #     # #   #   # #   #       
# ### # ##### # ### ### # # ### # ####### ### # ### ##### # # ##### # # # ####### # ### # ##### ### ### ### ### # ##### ####### 
# #   #   #   # #       # #     #       #     # # # #     # #   # # #       #     #   #   #   # #   # #G  #   # #       #     # 
# # ##### # ### # ####### ####### ### ######### # # # ##### ### # # ####### # ### ### # ### # ### ### ### ##### ######### ### # 
# #   #     #   # # #     #   #     #     #       # # #   #     # #     #   # #     # # #   #   #     # #     # #   #     # #   
# ### # ##### ### # # ##### # ##### # ### # ####### # ### ####### ##### ##### # # ### # # ##### ####### ##### # # ### # # # ### 
#   # # #     #   #   #   # # #   # #   #     #     # #         #   #   #   # # # #   # # #   # #           #   #     # # #     
# # # # # ##### ####### # ### # ### ########### ##### # ####### # # # ### # # # ### ### # ### # ##### ##### ############# ##### 
# #   # # #             # #   #   # #       #   #   #   #     #   # #   # #   # #   # # #     #   #   #     #             #     
### ### # # ##### ####### # ##### # # ####### ##### ##### ### # ####### # ####### ### # ######### ##### ### # ### ######### ####
#   #   # # #     # #     #   # #   #         # #   #   # #   # #       #     #   #         #   #   #   #   #   # # #   #   #   
# # # ### ### ##### # ####### # ############### # # # # # # ### # ### ######### ### ##### # # ##### # ### ##### # # # # # ### # 
# # # # #   # # #   #         # #       #     #   #   # # #   # #   # #         # #   #   #   #     #   #       # #   # # #   # 
### # # ### # # # # ########### ##### # # ### ##### ### # ##### ### ### ######### # # # ####### ##### # ####### # ### ### # ### 
#   #     #   # # #         #   #   # # #   #       #   #     # # #     #   #   # # # #       #   # # #   #     #   #   #   #   
# ####### ##### # ### # ### # ### # ### ### # ####### # ##### # # ######### # # # # # ####### ### # # ### ### # ### ### ##### # 
# #           #   #   # #   #     #   #     #   #   # #     # # # #     #   # #   # # # #   #   # #   #   #   #   #   #       # 
# ##### ##### ##### # # # ########### ########### # ### # ### # # # ### # ### ##### # # # # ### # ##### ### ### # ### ######### 
# #     #       #   # # #           #             #   # # #   #   #   #     #   #   # #   #     #   #   #   #   # # # #       # 
# # # ### ##### # # # # ######### ####### ########### ### # ##### ### ######### # ### ######### ### # ########### # # ### ### # 
#   # #   #   # # # # #   #     #   #     #     #   #       #   #   # #   #     # #   #       #   # # #         #   # #   # # # 
####### ### # # ### # ##### ### ### # ##### ### # # ####### # ##### # # # # ##### # ### ##### ##### ### ####### # ### # ### # # 
#     # #   # #     #   #   #   #   # #     # # # #   #   # # #   # #   # #     # #     #   # #   #     # #   # # #   # #   # # 
# ### # # ### ######### # ####### ### # ##### # # ### # # # # # ### ##### ##### # ####### # # # # ####### # # # ### ### # ### # 
#   # # # # # #         #     #       #       # # # #   # #                 #   #     #   # #   # #         # #     # # # # #   
# # # # # # # # ####### ##### ############### ### # ##### # ############# # # ####### # ### ##### # ######### ####### # # # ### 
# # #   #   #   #           #       #   #   #     #   # #   #     #     # # #   #   # # #     # # #   #   #   #       # # #     
# # ### ######### ######### ####### # # # ######### # # ### # ### # ### # ##### # # # ### ### # # ### # ### ####### ### # ##### 
# # #   #   # #     #     #       #   # #     #   # #       # # # # #   #     #   # # #   #   # #   # # #   # #   # #   # # #   
# # ##### # # # # # # ####### # ####### # ##### # # ##### ### # # # ######### ##### # # ### ### ### # # # ### # # # # ### # # # 
# #       # #   # # #   #     # #       #       #   #   # #   # # #     #       #   #   # #     #   # # # #   # #   #     #   # 
# ######### ##### # ### # ####### ################### # ### ### # ##### # ##### # ####### ##### ##### # # # ### ### ########### 
# #   #   # #     #     #   # #   #       #           #     #   #     #   #                         #   #   #   # #   #     #   
# # # # ### # ### ######### # # ### ##### # ################# # ##### ##### ### ####### # ### ##### ### ##### ### ### # ### ### 
#   #   #   # #   #       #   # #   #       #       #   #   # #   #   #     #   #     # # #   #       #       # # # #   # #     
######### ### ##### ##### ##### # # ######### ##### # ### ### ##### ### ##### ### ### # # ### # ##### ######### # # ##### ##### 
#     #   #   #   #   # # #     # #     # #   #     #     #   #     # # #   # #   # # # #   # #     #         # #   #           
# ### # ### ### # ### # # # ##### ##### # # ### ####### ### ### ##### # # # ### ### # # ### ####### ####### # # ### # # # ######
#   #   #       #       # #     # #     # #   #       #     # #   #     # #   # # #   #   #   #   # #   #   #   #   # # # #     
### ##################### ##### # # ##### ### ####### # ##### ### # ##### ### # # # ### ##### # ### # # # ##### # ##### # ##### 
# #       #         #   #   #   # # #       #       # # #       # #   #   # #   # # #     #   #   # # # # #   # # #     #   #   
# ####### # ####### # # ### # ##### ##### ########### # # ##### # # ### ### ##### # ### # # ##### # # ### # # # # ### # ### # ##
# #       #   #     # # #   #       #   #     #   #   #   #   # # # #   # #   #     #   # # #     #   #   # # # #     # #   # # 
# # ######### # ##### # # # ######### # ##### # # # ##### # # # # # # ### # # # ##### ### # # ######### ### # # ####### # ### # 
# #   # #   # #       #   #         # #     # # # # #   # # # # # # # #   # # #   #   #   #     #       #   #           #     # 
# # # # # # # ############# ### # # # ##### # # # # # # # # # ### ### # ### # ### ##### ######### ####### ####### # ### ####### 
# # # #   # #     #     #     # # # # #   # #   # # # # #   # #   #   # #   #     #   #       #   #     #     #   #   #       # 
# # # ### # ##### ##### # ### # # ### # # # # ##### # # # ### # ### ### # ######### # ######### ### ######### ####### ####### # 
# # # #   # #   #   #   # # # # #   #   # # # #     # # # #   #     #   #       #   #           # # #   #   #       #       # # 
# # # # # ### # ### # ### # # # ### ####### # # ####### # ########### # ####### ### ############# # # # # ######### ####### ### 
# # # # # #   #   # #     #   #   #       # #   #   #   #       # #   # #     #     #     #       #   # #       #   # #   #   # 
# # # ### # ####### ####### ##### ####### # ### # # # ######### # # ### # # ######### ##### # ######### ####### # ### # # ### # 
# # # #   #         #       #   #       # #   # # # #     #   # #   # #   #   #   #   #     #           #     #   #   # # # # # 
# ### # ############# ####### ######### # ### # ### ##### # ### # ### ####### ### # ### ##################### ##### # # # # # # 
#     #                     #           #                                   #                                       #   #   #   
