################################################################################################################################
#           #     #     #   #       #   #     #   #   #   #   #         #             #   #   #     #     #   #   #     #   #   
# # # ##### ### # # ### # # # ##### # # ### ### ### # # # ### # ######### ########### # # # # # # # ##### # # # # # ### # ### # 
# # # #   # #   #   # # # # #     #   #   # #   #   #   #                 #         #   # # # # # #     #   #   # #   # #G    # 
# # # ### # # ####### # ### ##### ####### # # ### ####### ####### ######### ####### ##### # # # # ##### ### ##### ### ######### 
# # #     #   #   #   #   #   #   #       # #     #   #   #     # #   #   # #   #     #   # # # #   #   #   #   # #     #     # 
# # ############# # ##### ### # ### ####### ####### ### ### ### # ### # # # # # ##### ##### # ##### # ####### # # # ### # ### # 
# # #     # #   #   #   # # #   # #   #   #       # #     # # # #       # #   #   #         #       # #       # #   #   # # # # 
# # # ### # # # # ### # # # ##### ### # # # # ### # # ##### # # # ##### ######### ################### # ####### ##### # # # # # 
# # #   # #   #       # # #   # #     # # # # #   # # #       # # #   #   #     # #       #   #   #   # #   # # #     #   #   # 
# ##### # ####### ##### # ### # # ##### # # # # ### # # ####### # # # # # ##### # # ##### # # ### # ### # # # # # ####### ##### 
# #   # #   #   #   # #   #     #   #   #   # #       # #   #   # # # # # #     # # #     # #   # #   #   # #   #   #   #     # 
# # # # ### # # ### # ##### ####### # ####### ####### # ### # ##### # ### # ##### ### ##### ### # ### ##### ######### # ##### # 
#   # #   #   # #                 # # #     #   #     #     # # #   #   #   #   # #   #   # # # #   # #   #         # #       # 
######### ##### # ############# ### ### ### ##### ### ##### # # # ##### ##### # # # ##### # # # ### # # # ######### # ####### # 
#   #   #     #   #   #       #   #     # # #   #   # #     #   # #   # #     # #   #     # #   #   # # #   #     #   # #     # 
# # # # ##### ### # # # ##### # # ####### # # # ### # # ######### # # # # ##### ##### ##### # ### ### ##### # ######### # ##### 
# # # #   #   #   # # #   #   # #         #   #   # # #   # #   # # # #   #   #     #       #   #   #     #         #   # # #   
# ### ### # ### ### ##### # ##### ### ### ####### ### ### # # # # ### ##### # ##### ########### ### ##### ######### # # # # # ##
#     #   # #     # #     #     #   #   #       #   #   #   # # # #         #   # # #     #   # #     #   #   #   #   # # # # # 
####### ### ##### # # ######### ##### # ### ####### ### ### # ### # ########### # # ### # # # # ### # # ### # # # # ### # # # # 
#   #   #   #     # #     #     #   # #   # #   #   #     # #     #     #         #     #   #     # # # #   #   # # #   #   # # 
# # # ### # # ### # ### # # ##### # ##### ### # # ### ##### ########### # ####### ######### ##### ### # # ####### # ####### # # 
# #     # # # #   #   # # # # #   #     #     #     #   #   #   #       #   #   #           #   #       # #   #   #         #   
####### # ### # ##### ### # # # ####### ######### ##### # ### ### ######### # # ####### # ### # ##### ### # # # ### ##### ##### 
#     # # #   #   # # #   # # #   #   #         #     # # # #   #       # # # # #       #   # #     #   #   # # #   #   #     # 
# ### # ### ##### # # # ### # ### # # ######### ##### # # # ### ####### # # # # ############# ##### ### ##### # ##### # # ##### 
# # # #     #   #   # #   # #   #   #         # #   #   # #   # #   #   #   # #   #               #   #     # #   #   # # #   # 
# # # ####### ##### # ### # ### ############# # # # ### # # # # # # # ##### # ### # ####### ######### ##### ##### # ### # # # # 
# # # #             #     #                 # #   #   # # # # #   # #   #   #   #   #     #   #    S  #     #   # #   # # # #   
# # # ########### ######### ############### # ####### # # ### ##### ### # ##### ##### ### ##### ####### ##### # # ##### # # ####
# #   #         #         # #     #         # # #   # # #         # #   #     # #     # #       #     # #   # #   #   #   #   # 
# ##### # ##### ######### # # ### # ######### # # # # ########### # # ####### # # ##### ########### ### # # # ##### # # ##### # 
#       # #   #   #   #   # # #   #     #   # # # #   #   #       #   #       # # #                 #   # # # #     #   #     # 
##### ##### # ### # # # ### # # ####### # # # # # ##### # # ########### # ##### # ############# ##### ### # # ####### ### ##### 
#   # #   # #   #   #   #   # # #     # # # # # #       # #   #     #   # #     #   #       #   #     #   # #         #   #     
# # # # # # ### ##### ### ### # # ### # # ### # ######### ### # ### # # # # ####### # ##### # # # ##### ### # ####### # ####### 
# #   # # # #   #     #   # # #   #   # # #   #     #   # # #   #     # # # #       #     #   # # #   #   #   #     # # #     # 
####### # ### ### ##### ### # ##### ### # # ### ### # # # # ##### ####### # ################### # # # # # ##### ### ### # ### # 
#       #   # #   #         # #   #   #   # #   #   # #             #     #   #               # # # #   #         #   #   #   # 
# ######### # ### # ##### ### ### ### ##### ##### ### # ### # ####### ####### # ############# # # # ##### ########### ##### ### 
# #       # #           #   #     # #     #     #   # # #   #   #     #     #   #     #                 # # #   #   #     # #   
# # ##### # ######### # ### ##### # ##### ##### ### ### # ##### # ##### # ####### ### # ############### # # # ### # # ##### ### 
# #   #   #     #   # #   #     # #   #       #   #     #     # # #   # #   #   # #   # #           #   #   #     #   #     #   
# ### ######### # # # ### # ##### # ### ### # ### ### ##### # # # # # # ### # # # # ### # ######### ################### ##### # 
#   #     #   #   # # #   # #     #   #   # # #   #   #     # # #   # # #   # #   #   #   #     #   #   #   #   #   #   #   # # 
### ##### ### ##### # ####### ##### # ### ### # ### ### ##### # ##### # # ### # ##### ### # ### ##### # # # # # # # # ### # # # 
# # #     #   #   # # #   #   #     #   #   # #   # #   # #   #     #   #   # # #   # #   #   # #   # #   # # #   # #     # # # 
# # # ##### ##### # # # # # ### ########### ##### # # ### # # # ########### # ### # # # # ### # # # # ####### ############# # # 
#   # #   #   #   # #   # # #       #     # #   # # #   #   # #     #       #     # # # #   # #   # #             #     #   # # 
##### # # ### # ### # ##### # ##### # ### ### # # # ### ### ####### # ##### ######### # ### # ######### ####### ### ##### ##### 
#   #   #       #   #       # # #   # #   #   #   #   #   # #   #   #   #   #         #   # #           #       #   #     #     
# ########### ### ### ####### # # ### # ### ####### # ### # # # ####### ##### ######### # # ### ### ##### ##### # ### ##### # ##
# #       #   #   #           #   #   #     #       # #   # # # #       #     # #       # #     #   # #   #   # #   # #     #   
# # ##### # ### ### ############# # ### ######### # # # ### # ### ####### ##### # # ### # ####### ### # ##### # # ### # ### # # 
# #   # #   #   #   #         #   # #   #     #   # # # #   #     #     #   #     # #   #   #   #     #     # # # #   # #   # # 
# ### # ##### ##### # ##### # ### # ##### ### ##### # # # ######### ####### ####### # ##### # # ########### # # # # ### # ##### 
#   #   #   # #   #   #   # #   # #   #   # # #     # # # #           #   #     #   #     #   #     #     #   #   #   # # #   # 
# ##### # ### # # ### # # ##### # ### # ### # # ####### ### # ### ##### # ##### # ##### # ##### # ### ### ####### ### # # # # ##
# #   # #   #   #     # #     # #   # #   # # #       #     #   #       #   #   # #   # #     # # #     #   #       # # # # #   
# # # # ### ######### # ##### # ##### ### # # # ##### ######### ############# ### # # # # ##### # # ######### ### ### # # # ### 
# # #   #   #         # #     # #   # #   # # #     #         #       #     # #   # #   #   #   #   #         #   #   # # # #   
# # ####### # ######### ######### # # # ### # ########### ### ####### # ### # ##### ### ##### ####### ######### ### ### ### # ##
# #       # # #       #   #       # # #   # # #       #   # #       # #   # #     #   # #   #     #   #     #       #   #   #   
# ####### # # # ######### # ####### # ### # # # ##### # ### # ####### ### # ##### ### ### # ##### # ### ### ##### ### ### ##### 
# #     # # #   #       #   #     # #   #   # #   #   #   #   #     # #   #     #   # #   # #   # #   # #   #   #     #   # #   
# # ##### # ### # ##### ######### # ### ### # ##### ### # ##### ### # # ########### # # ### # # # ##### # ### # # ##### ### # ##
#     #   # #   # #     #             #     # #   #   # #     # #   #   #     #     #     # # #   #   # #     #       #   # #   
### ### ### # ### ####### # ####### # ####### # # ### # ##### # ##### ####### # ########### # ##### # ######### ##### ### # ### 
#   #   #   # # # #       # #     # #       #   #     #     #   #   #     #   #     #   #   #   #   #           #   #   #   # # 
# # # ### ### # # # ##### # # ### # ### ### ########### ######### # ##### # ####### # # # ##### # # ########### # # # ####### # 
# # #   #   #   #   #   # #   #   #   # # #     #   #     #       #     #       # # # #   # #   # # #   #       # # # #       # 
### ### # ##### ### # # ####### ####### # ##### # # # # # # # ######### ### # # # # # ##### # ### ### # ##### ### # ### ##### # 
#   #   # #   # #   # # #     # #       # #   # # # # # # # # #   #   #   # # #   # #       #   # #   #     # #   #     # #   # 
# ### ### # ### # # # # # ### ### # ##### # # # # # # # # # ### # # # ### # ##### # ############# # ####### # # ######### # ### 
#   #     #       # # # #   #   # # #   #   #   # # # # # #     # # # #   # #   # #     #         #       #     #     #   #   # 
### ##### # ####### # ##### ### # ### # ### ##### # # # ######### # # # ### # # # ##### # ################### ##### ### # ### # 
# # #       #       # #   #   # #   # #   # # #   # # # #     #   # # # #   # # # #   #   #   #     #       #   #   #   #   #   
# # ### # ### ##### # # # ### # ### # ### # # # ##### # # ### # ### # # # ### # # ### ##### # # ### # ##### ### # ### ### # ####
# #   # # #   #   # #   #     #     #   # #   # #     #   #   #     # # # #   # #       #   #   #   #   # # #   # #   #   # #   
# ### # # # ### ### ############### ##### ### # ### # ##### ######### # ### ### ######### ####### ##### # # ### # # ### ### # # 
#       # # # # #           #     # #     #   #   # #   #   #       # #     # #   #       #     #     #   #   # # # #   #   # # 
########### # # # ########### ### # # ####### ### # ### # ######### # ####### ### # ####### ######### ####### # # # # ### ### # 
#     #     #   # #         #   # # # #     #       #   #           # #         # #         #                   #   #   #     # 
# ### # ####### # # ####### ### # ### ### # ### ####### ############# # ##### ### ########### ############### ### ##### ####### 
# #   # #     #   #   #   #   # #   #     #   # #     # #             # #   #   #     #     #         #     #     #     #   #   
# ##### # ### ####### # # ### # ### ######### # # ### # # ############### # # # ##### ##### # ######### ### # ### # ####### # # 
#     #   # #   #   # # # # #   # # #       # # # # # # #     #         # # # #   #   #       #         #   #   # # #     #   # 
##### # ### ### # # # ### # ##### # ### ##### # # # # ####### # ####### # # # # # # ### ##### # ############### # # ##### ##### 
# #   #     #   # # #     #       #   #   #   # # # #     #   #   #   #   # # # # #   # #   #   #             # # #     # #     
# # ### # ### ### # ############# ### ### # ##### # ##### ####### # # ##### # # ##### ### # ### # ########### # ##### # # ##### 
# # #   #   #     # #     #         # #   # #     #     # #   #   # #     # # # #   #   # #   # #   #     # # # #   # #   #   # 
# # ##### # ####### # ### # ####### # # # # # # ##### # # # # # ### # ##### # # # # ### ##### # ### ### # # # ### # ####### # # 
# #   #   #       # #   #   #   # # # # # # # #     # # # # #   # # #   #   # # # #   # #     #         # #   #   #     # # # # 
# ### ########### # ####### # # # # # # # # ##### # # # # ####### # ### # ### ### ### # # ####### ####### ##### ####### # # # # 
#     #     #   # #         # # #   #   # # #   # # # #   #   # #   # #   #       # #   # #     # #   #   #   #   #     #   #   
# ##### ### # # # ########### # ######### # # # # # # ##### # # # ### ##### ####### ##### # ### ### # # ##### ### # ####### ####
#   #   # #   #   #         # #   #         # # # # #       # #           # # #   # #   #   # #     # #     # #   #   # #   #   
### # ### ####### # ####### # ### # ##### # # # ### ######### # ####### # # # # ### ### ##### ####### ##### # # ##### # # ### # 
#   # #     #     # #     # # #     #     # # #   #     #     # #     # # # #   #   #     #     #     #   # # # #   # # # #   # 
# ### ### # # # ### # ### # # ####### ### # ##### # ##### ##### # ### # # # ### # ### ### # # ### ####### # # # # ### # # # ### 
# #   #   #   # #   #   # # #   #     #   #       # #   #     #   #   # # #   # # # #   # # # #   #         # # # #   #   #   # 
# ##### ##### # # ##### # ##### # ### # # ########### # ##### # ####### # ### # # # ##### ### # ########### # # # # ### ##### # 
#   #       # #   #     # #     #   # # #   #       # #             #   #     #       #   #   # #         #     #   # # #     # 
### # ##### ####### ##### # ####### # # ### # ##### ### ##### ##### # ######### ##### # ### ### # ####### ##### ##### # # ##### 
# # # #     #       #   #   #       # # #   # #   #   # #   # #   # #               #     # # # # #     #     #     #   #   # # 
# # ### ##### ####### # ##### # ##### # # ### # ##### # # # # # ### ##### ######### ### # # # # # # ######### # ### ####### # # 
# #   #   #   #       #     # # #     # #     # #     #   # #   #   #     #       #   # #     # # # #       # # #   #     #   # 
# ### ##### ### ### # ##### # # # ##### ####### # ##### ### ##### # ####### ##### # # # ####### # # # ####### # # ### # ##### ##
#   # #     #   #   #   #   # # #     #   #   #   # #   # #     # # #       #   # # # # #       # # #   #     # #     #     #   
# ### # ##### # ####### # ### ####### # # # # ##### # ### ##### # ### ##### # ### # # ### ####### # ### # ##### ##### ### ##### 
#     #   #   #       # #     #   #   # #   #         #   #   # #     #   # # #   # #     #     # # #   # # #       #   # #     
# ####### ### ##### # # ####### # # ##### ##### # ##### ### # # ####### # ### # ### ########### # # # ### # # ##### ### # # ####
#   #     #   #   # # #     # # #   #   # # #   #     #   # #   #     # #     #   #     #           #     # # #     #   #   #   
### ### ### ### # # ####### # # ##### # # # # ####### # ### ##### ##### ####### # # ##### # ##### # ####### # # ######### ##### 
# #     #   #   # #       #   # #     # # # # #     #   #   #   # # #   #       # #       #   #   #           #     #   #     # 
# ####### ### ### ### ######### # ### # # # # # ### # ### # # # # # # ### ####### # ######### # ########### ##### # # # ##### # 
#       # #   # #   # #       # # #   # #   #     # #   # # # # # # #   #       # #     #   # #     #     #     # #   #     # # 
####### # # ### ##### # ##### # ### ### # ######### ### # ### # # # ### ######### # # # ### # ##### # ######### # ######### # # 
#   #   # # #   #     # #   # #   #   # # #   #     # # #     # # #   #           # # #     #   #   #       #   #     #     # # 
# # # ### # # # # ##### ### # ### ##### # ### # ##### # ####### # # # ############# ########### ########### # ####### # ##### # 
# # # #   #   #   #     #   #   # # #   #     #   # # #       # # # #         #           #     #   #       # #       #   #   # 
# # # # ########### ##### ##### # # # ####### ### # # # ####### # ######### # ##### ##### # ##### # ####### # # # ####### # ### 
# #   #     #     #     # #   #   # # #     # #   # # # #   #   #   #   #   #     #     # # #     #       #   # #   #     #     
# ######### # ### ##### # # # ##### # # ### ### ### # # # # # ##### # # # ####### # # ### # # ########### ##### ##### ######### 
# #   #     #   # #   # # # # #     # #   #     # # #   # # # #   # # # # #     #   # #   # # # #       #     # # #   #       # 
# # # # ### ### ### # # # # # ##### # ### ####### # ### # ### # ### # # # # ### ####### # # # # # ##### ##### # # # ### ##### # 
#   #   #     #     #   #   #             #             #     #       #   #   #         # #   #   #           #   #     #     # 
