################################################################################################################################
#           #                           #                 #   #   #   #           #   #     #       #           #     #     #   
##### ##### # ######### # ############# ### # # ######### # # # # ### # ######### # # # ### # # ### # ######### # ### # ### # ##
#     #   #   #         #   #     #   # #   # # #       #   #   #   #           # # #   # # # #   # #   #     # #   # # #   #   
# ##### # ######### ### ### # ##### # # # ### # # ##### ########### ### ####### ### ##### # # ### # ### # ##### ### # # # ##### 
# #   # # #       # #     #   # #   # # # # # # #     #     #     #   # #     #     #     #   #   # #   # # #   #   # # #     # 
# # # ### # ##### ### ### ##### # ### # # # # # ##### ### ### # ##### # # ### # ##### ### ##### ##### ### # # ### ### # ##### # 
#   #   # #     #   #   #       # #   #   #   #     # #   #   #       #     # #         #   # #       #     #     #   #   #     
# ##### # ##### ### ### ### # ### ####### ######### # # ### ########### ##### ####### # # # # ######### # # ####### ### # ##### 
# #     #       #   #   #   #   #     #   #     #   # #   # #     #     #   #   # #   # # #   #       # # # # #   # #   # #     
# # ############# ### ####### # ##### ##### ### # ####### # ### # # ##### # ### # # ### # ##### # ### # # # # # ### # ### # ### 
# #           #   # #       # #     # #   # #   # #       #     # # #     # # # #   #   #       #   #   # #   #     #   # #   # 
####### ####### ### ####### # ##### # # # ### ##### # ########### # # ##### # # ##### ############# ### # ############### ##### 
#     #         # #     #   #     # #   #   # #     #           # # #     # #   #               # #   # #     #         # #   # 
# ### ########### ##### # ### ### # ####### # ### ##### ### ##### # ####### ################### # # # ### ### ######### # # # # 
# #   #               # # #     # #     #   #   # #   # #   #   # #   #     # #   #     #       # # #   #   #   #     # # # # # 
### ######### # ### # # # ##### # ####### ##### # # # ### ### # # # ### ##### # # # ### # ####### ##### ### ### # # ### # # # # 
#   #         # #   # #   #   # # #     # #   #   # #   #     #         #   #   # # #     #     #   #   #     #   #   # # # # # 
# ##### ####### # ### ##### # ### # ### # # # ### # ### ########### ####### # ##### ### ### ### ### # ### ### ####### # ### # # 
# #   # #   #   # #         #     #   # #   #     #   #     #     #       #     #   #   #   #   #   #   #   # #     #   #   # # 
# # # # # # ### # # ##### ############# ##### ####### ##### # ### ##### # ##### # ### ### ####### ##### # # # # ### ##### ### # 
#   # #   #   # # # #   #       #       #     #     # # #   #   #     # #     #   # #   #       # #     # # #   # # #   # # # # 
##### # ##### # # ### # ######### ####### ### # ### # # # # ### ##### # ##### ##### # # ####### # # ####### # ### # # # # # # # 
#   # #   # # # # #   #       #   #       # # # # #     # #   # #   # #   #   #       #   # #   # # #   #   #   # #   # #   # # 
# # # ### # # ### # ######### # ########### # # # ####### ### # # ### # # # ######### ### # # ### # # ### ### # # ##### ##### # 
# # #   #   #   # # #     # # # #     #   #   #     #     #   # # #   # # #   #   # #   # # # #     # #   #   # # #   #       # 
### ### ####### # # # ### # # # # ### ### # ####### # ##### ### # # ### # ### # # # # # # # # ####### # ##### # # # ########### 
#   # #       # #   # # # #   #   # # #   #   #   # #   # #   # #   # # # #   # # # # # #   #   #       #     #S  #             
# ### ####### # ##### # # ######### # # ##### # # # ### # ### # # ### # # # ##### # # # ####### ######### ### ##### ####### ####
#         #   #     # # #     #     # # #   #   # # #   #     # #   #   # #   #   #   #       #     #   # #   #     #       #   
# ##### ### ####### # # ##### # ##### # # # ##### # # ######### ### ####### # # ####### ### ####### # ### # # # ### # # ##### # 
#     # #   #       # #   #   # #     #   #       # #     #   #   #       # #   #     #   # #       #     # #     # # # #     # 
# ### # # ### ### ### # ### ### # ####### ######### ##### # # ### ####### ########### ### ### ############# ####### # ### ##### 
# # # # # #   #   #   #   #   # # #   #   #       #   # # # #     # #   # #         #     #   #       #   #     #   #   # #     
# # # # # # ####### ##### ### # # # # # # # ##### ### # # # ####### # ### # ####### # ##### ######### # # # ##### ##### # ######
#   # # # # #G    # #   #   # # # # #   # # #   #   # # # # # #   #   #   #   #   # # #     #   #     # # #     # # #   # #     
### # # # ### ### # # # # ### # # ####### # ### # ### # # # # # # # ### ##### # # # # # ##### # ##### # ####### # # # # # # ### 
#   # # # #   # #   # # # #   # #     # # #     #   # #   # #   #   #   #   # # #   # #   #   #     # #         # #   # #   #   
# ### ### # ### ####### # # ### ##### # # ##### ### # ##### ####### # ### # ### ##### ### # # ##### # ####### ### ##### ##### ##
#   #   # # #     #     # #   #     # # # #   # #   #   # #     #   # #   # #   #   #   # # #   # # #   #     #   #     #   # # 
### ### # # ##### # ##### ### # ##### # # ### # # ##### # ##### # ### # ### # ##### ### # ##### # # # # ##### # ##### ### # # # 
#   # #   # #     #         # # #     #         # #       #     #   # #   # # #   #     #   #   # #   #       #     #     # #   
# ### ##### # ############# # # # ##### ##### ##### ####### ##### ### ### # # ### ######### ##### ########### ##### # ######### 
# #   # #   # #             # # # #     #               #   #         # # #   #   #       #     # #         #     # # #   #   # 
# ### # # ### # ############# # # # ##### ### ########### ##### ####### # ##### ### ##### ##### # ### # ### ##### # ### # # # # 
#                     # #   # #   # #     #   #         # #   # #         #             #     # #     # # #       #     #   #   
# ##### ############# # # # # # ##### ##### # # ####### ### # # # ##### ### ######### ##### # # ##### # # ####### ##############
#     # #   #       #   # # # #     # #     # # #     #     # #   #   #     #   #   # #     # #   #   #   #   #         #       
# ### ### # # ##### # ### # # ##### ### ##### # # ### ####### ### # # # # ### # # # # # ### ##### # ####### # # # ####### ##### 
#   #     #       # #   # # # #   #   # #   # # # # # #   # #   #   # # #   # # # # # #   # #     #   #     # # #       # #   # 
### ############### # # # ### # # ### # # # # # # # # # # # ### # ### # ### # ### # # ### ### ######### ##### ######### # # ### 
# #     #           # # #     # # #   # # # # #   # # # # # # # # #   #   #   #   # #   #     #       # #     #   #     # #     
# ##### ############### ####### # # ##### # # ##### # # # # # # # # ##### ##### ### # ######### ##### # # ##### # ####### # ####
#       #   #   #   #   #       # #     # #         # # # #   # # # #     #   #   # # #       # #   # # #       # #     # #     
# ####### # # # # # # # # ##### ####### ### ######### ### ### # # # ### ### # ### # # # ##### # # ### # ######### # ### ####### 
# #   #   # # #   #   # #   # #       #   #   #   #   #   #   #   # #   #   #   # # # # #     # #     #       # #   # #     #   
# # # # ### # ######### ### # ####### ### # # # # # ### ### ##### # # ### ### ### # # # ####### ############# # ##### ##### # ##
# # # # # # # #       # #   #       #   #   #   # #     #   #   # # #     # #     # # #       # #     #     #     #   #   #   # 
# ### # # # ### ##### # # ### ### ##### ### ############# ### # # # ####### ####### # ####### # # ### # ### ##### ### # ####### 
# #   #   #     #     #       # # #   #     #   #   #   # #   # # #     # #       # #         # # # #   # #     #   #     #     
# # ############# ##### ##### # # # # ####### # # # # # # # ### # ##### # # ### ### # ######### # # ##### # ####### # ### # ### 
#           #   #   # # #   #   # # # #       #   #   # #   # #       # # # # # #   #             #   #   #         # #   #   # 
# ######### # # ### # # # # ##### ### # ############### ##### # ####### # # # # # ####### ### # ### ### # ############# # ### # 
# #       #   # # # #   # #     # #   #       #   #   # # #   # #       #   #   # #     #   # #         #         #   # # #   # 
# # ##### ### # # # ### # ##### # # ######### ### ### # # # ### # ####### ##### # ##### ### # # ########### # ### # # ### # ### 
# #     #   # # # #   # # #   # #     #     #   #   # # #       # #     # #   # #       #   # #     #       # #   # #     #   # 
# ######### # # # ### ### # # # ####### ##### # ### # # ######### ### # # # # # ######### # # # ##### ####### # ##### ######### 
#     #     # #     #     # # # #     # #   # # #     #       #   #   # # # #       #     # # # #     #   #   # #   #       #   
##### # ################### # # # ### # # # ### ##### ####### # ### ### ### ####### # ####### ### ##### # # ### # # # ### ### ##
#     #   #   #       #   # # # #   # # # #     #         # #   #     #   # #     # # #       #   #     #   #   # # # # #       
# ### ### # # # ##### # ### # # # ### # # ####### ####### # ######### ### # # ### # # # ####### ### # ##### # ##### # # ########
#   #   #   # #   #   # #   # # # #   # # #     # #   #   # #       # # #   # #   # # #   #   #   # #     # # #   #       #     
# # ### ##### ### ##### # ### # # # ### # ##### # # ### ### # ####### # ##### # # # ##### # # ### # ##### # # ### ### ##### ### 
# # #       # #   #   # # #   # # #     #     # # # #   #   #         #       # # #     # # #     #   #   # #     #   #     # # 
### ##### # # # ### # # # # ### # ########### # # # # ### # ############# ##### # ##### # # # ####### # ########### ### ##### # 
#   #   # #   #     #     #     #   #   #   # # #   #   # # #       #     #   # # #     # # # #     # #             #         # 
# # # # # ####### ####### ######### ### # # # # ####### # # ### ### ### # # # ### # ##### # ### ### # ##### ### ### # ######### 
# # # # #         #     # #             # # # # #     #   #   # #       # # #   # #   #   #     # # # #   # # #   # # #         
# # # # ####### # # ### # # # # ####### # # # # # ########### # ######### # ### # ### # # # ##### # ### # # # ### # # # ### ####
# # # # #     # # # #   #   # #   #     # # # #   #   #         #   #     # #   #   # # # #       #   # #   #     #   # #   #   
# ### # # ### ### # ##### ####### # ### # # # ### # # # ### # ### # # ##### # ### ### ### # ### # ### # ######### ##### ##### # 
#   # # #   #     #     # #   #   #   # # # #   #   #   #   # #   # #   #   #   #   #     #   # # #   # #   #     #   #       # 
### # ##### ########### ### # ####### # # # ### ######### ##### ### ##### ##### ### ######### # # # ### ### # ### # # ######### 
# # #     # #     #   #     #         #   #   #         #   #   # #   #   #       #           # # #   #   #   #   # #         # 
# # ##### # ##### # # ################### ############# ##### ### ### # ######### ############# ##### ### ##### ### ######### # 
# #     #   #     # # #   #         #   #   #         #     #     #   #         # #   #             #   #     # #   #   #     # 
# ### # ##### ####### # # # # ##### # # ### # ############# ##### # ########### # # ### ########### ### ##### ### ##### # ##### 
# #   #   #   #       # #   # #     # # #   # #       #   #       #       #     # #     #         # #   #   # #     #   #   #   
# # ### ### ### # ##### ##### # ##### # ### # # ##### ### ############### # ##### ##### # ####### ### ### # # # ##### ##### # ##
# #   #     #   #         #   # #   # # #   #   #                       # # #   #     # # #   #   #   #   #   # #   #   #   # # 
# ### # ##### ############# ##### # # # # # ##### ############### ##### # # ### ##### ### # # # ### ##### ### # # # ### # ### # 
#     #           #   #   #       # # #   #       # #             #   # # # #   #   # #   # # #   # #     #   # # # #   # #     
####### ### ### # ### # # ### ##### # ##### ####### # ########### # # # # # # ### # # # ### # ##### # ######### # # # ### # # ##
#   # #   # #   #     # #   #     # #   #   #       # #     #     # #   # #   # # #   # #   #   #   #   #       # # # #   # #   
### # # # # ########### ### ####### ### ##### ####### # ### ####### ### # ##### # ##### # ##### # ##### # ####### # # ### # ### 
#   # # # #     #   #   #             #         # #   # #     #     # # #   #     #   # # #     # #   # #   #     #   #   #   # 
# ### # # ##### # # # ############### ######### # # ### ##### # ##### # # ### ##### ### # # ##### ### # ### # ######### ### # # 
#   #   # #   # # #   #   #   #     # #       #   #   #   #     #   #   #     #   # #   # #   #   #   #     # #       # #   # # 
### ##### # # # # ##### # # # # ### ### ##### # ######### ####### # ### ####### # # # ### ### # ### # ####### # ##### # # # # ##
#   #   #   # # #       #   # # #   #   # #   #   #       #       #   #         #   # #   # #   #   #     # #   #   #   # # #   
# ### # ##### # # ########### # ##### ### # ####### ####### ######### # # ######### # ### # ######### # # # ##### # ##### # ### 
# #   # #   # # #           # #       #   #         #   # # #   # #   # # #       # # #   #         # # #   #     #       #   # 
# # ### # ### # # ####### # # ######### ############# # # # # # # # ### ### ##### # # # ########### # # ### # # ##### ####### # 
# #   # #     # #   #     # # #     # # #   # #   #   # # #   # # #   # #   #     # #   #   #     # # # #     # #     #       # 
# ### # ####### # # # ##### # # ### # # # # # # ### ### # ##### # ### # # ### ##### ##### ### ### # ### # ####### ##### ####### 
#     # #     # # # #   #   #     # #   # #   #   # # # # #       #   # #   #       #   # #   #   # #   # #       # #   #     # 
####### # ### # # ##### # ####### # ### # ####### # # # # # ####### ### ### ####### # ### # ### ### # # ### ####### # ### ### # 
#   #   # # #   # #   # #   #   # #   # #       #   #   # #   #     #   # # #   # # #   #   # # # #   # #   #     # #     # # # 
# ### ### # ####### # # # ### # # ### # ####### ##### ### ### ####### # # # ### # # ### ##### # # ##### # ### ### # ####### # # 
#   #     #         # # # #   # #   # # #         # #       #         #   #   #   # #         #   #     #     #   # #     #   # 
### ####### ### # ### # # # ### ##### # ######### # ####### ########### ##### ### # ##### ####### # ########### ### # ### # ### 
#   #       #   # #     # # #   #     #   #   # # #   #   #     #     #   #   #   #     #   #     #           #     # #   # #   
# ### # ### # ### # ####### ### # ####### # # # # # ### ### ##### ### ##### ### ####### ### # ##### ##### ### ####### # ##### # 
#     # #   #   # # #     #   # #   #   # # # # # # #   #   #   # #       # #   #     #     #     #     # #       #   #   #   # 
##### # # ##### # # # ### ### # ### # ### ### # # # # ### ### # # # ##### # # ### ### ##### ##### ####### ##### # # ####### ####
#   # # #   # # # # #   #   # #     #     #   # # # #   # #   #   # #   #   # #   #   # #   #   #   #   #   # # # #       #     
# ### # ### # # # ######### # ####### ##### ### # # # ### # ### ##### # ##### # ### ### # ### ##### # # ### # # # ####### ##### 
# #   #   # # # #     #     #   #     #     #         #   #   # #   # #   #     # #   # #     #   #   #     # # #   #   #       
# # ### # # # # ##### # ####### # ##### ##### # # ##### ##### ### # ##### # ##### ### # ##### # ############# # ### ### ########
# #   # # # # #   #   #       # # #           # #     # #   # #   #     # # #   #             #   #   #       #   #   #         
# ### # # # # ### # ######### # # ### ####### # ##### # ### # # ##### ### ### # ##### ####### ### # # # ####### # ### ######### 
#     # # # #     # #   #   #   #     #     # #     # #   # #   #   # #   #   # #     #       #   # # # #     # #   #   #       
# ##### ### ####### ### # # ##### ##### ### # ##### ##### # ##### # # # ### ### # ##### ##### # ### # # # # # ##### # # # ######
# #     #   #     #     # # #   #         # #     #               # #   # # # # #     #   # # #   # # # # # #       # # # #     
### ##### ### ### ######### ### # ####### # ##### ########### ##### ##### # # # ######### # # ### # # # ### ######### # # ### # 
#   # #   #   #   #   #   #   # # #     # # #   #         #   #   # #     #   #   #       # # # #   # #     #     #   # #   # # 
# ### # ### ### # ### # # ### # # # ### ### # ########### # ### # ### ### ####### # ####### # # ##### ####### ##### # ##### # # 
#     #     #   #       #         #   #     #             #     #     #         #   #                               #         # 
