################################################################################################################################
#   #       #       #     #   #     #             #       #         #       #   #           # #           #     #   #           
# # # ####### # # # # ##### # # ##### ########### # # ### # ####### # ##### # # ### # # ### # # ######### # ### ### # ######### 
# # # #       # # # # #   # #     #   # #   #     # #   # #   #   #   #   # # #     # # #             # #   # #     #     #   # 
### # ### ####### # # # # # ####### ### # ### ##### ### # ### # # ##### # # # ####### # # ########### # ##### ######### ### # ##
#   # #   #       # #   # #     #   #   # #   #   #   # # # # # # #     # # # #   #   # # #   #     #   #   # #   #     #   #   
# ### # ### ### ### ##### ##### # ##### # # ### # # ### # # # # ### ##### # ### # ### # ### # # ### ### # # # # ### ##### ##### 
#       #   #   #   #         # #     # # # #   # # #   # # # # #   #   #   #   #   # #     # # # #   # # # #   #   #     #   # 
# ####### ##### # # ### ##### # ##### # # # ### ### # ### # # # # ### ####### ##### # ######### # ### # ### ### # ### ##### ### 
# #       #     # #     #     #     #   #   #   #   #   #   #   #   #       # #   # # # #     # #   # #   #   #   #   #   #   # 
### ########### # ####### ### ### ##### ##### # # ##### ####### ### ####### # # ### # # # ### # # # # ### ### # ### ### # ### # 
#   #   # #   # #       #   #   # #   #       #       #     #     # #     #   #   # # # #   # # # #               # #   #     # 
# ### # # # # ############# ### # # ##### ########### ##### # ##### # ######### # # # # ### # ### ######### ####### # ######### 
#     #   # #           #   #         #   #         #     #   #     #   #     # #   #   #   #   #   #     # #     # # #       # 
# ####### # ########### # ### ####### # # # ####### ##### ############# # # ### ##### ### ##### # # # ### # # ### # # ### ### # 
#   #   # #   #         #   # # #   #   # #   #     # #   #           #   #     #       #     # # # # #   #   #   # # #   # #   
### # # ##### ######### ### # # # # ##### ### # ##### # ### ######### # ######### ########### # # # # # ####### ### # # ### ####
#   # #     # #       #   # #   # #         # #   #       # #   #     #     #   # #       #   # # #   # #     # #   #   #     # 
# ### ##### # # ##### ### # ##### ######### # ### # ####### # # # ######### # # # # ####### ### # ##### # ### ### ########### # 
# #   #   # # # # #   #   #     #         # # #   # #     #   # # #     # # # # #   #     # #   #     #   # # #   #       #     
# # ##### # # # # # ### ##### # ######### # # # ### # ### ##### # # ### # # # # ##### ### # # ### ### # ### # # ### ##### # ####
# #     #     #   #   #     # #   #   #   # # #   # #   #       # # # #   #   #       # #   # # #   # #     # # #   #   # #     
# ##### # ########### ##### ### # # # # ##### ### # ### ######### # # ################# ##### # ### # ### # # # # ### ### # ### 
#     # # #         # #   #     #   # # # #   #   # #   #   #   # #       #   #     # #       #   # #   # # # #   # #   # # # # 
### # # # # ##### # # ### ######### # # # # ### ### # ##### # ### ####### # ### ### # # ####### ### ### # ### ##### # # # # # # 
# # # # # #     # # # #     #     # # #   #   # #     # #   #     #       # #   # # # #     #   #   # # #   #     #   # # # #   
# # # # ####### # ### # ### # # # ### ######### # ##### # ######### ####### # ### # # ##### ### # ### # ### # ##### ##### # ####
#   # #     #   # #   #   # # # #     #           #   # #   #   # #     #         #   #   #   # # #   # #   # #       #   # #   
# ######### # ##### ##### # # # ####### ##### ##### # # ### # # # ##### # ####### ##### # ### # # # ### # ### # ####### ### ### 
# #   #     # #     # #   # # #   # #   #     #     # #     # # #     #   #       #     #   # #   #     #   # #   # #   # #   # 
# # # # ##### # ##### # ### # ### # # ### ##### ##### # ##### # ##### ### # ### ### ####### # # ######### # # ### # # ### ### # 
# # #   #     #   #   #   #     #   #   # # #   #   # #     # # #     #   #   #     #     # #     #     # # # #   # #   #   # # 
# # ##### ####### # ##### ##### ####### # # # ### # # ##### # # # ### ### ##### ####### ### # ##### ### ### # # ### ### # # # # 
# #       #   #   #       #     #       #   # #   # # #   # # #   #       #   #         #   # #     #   #   # #     #   # #   # 
# ######### # # ##### ########### ####### ### # ### # # # # # ############# # ####### ### ### # ##### ### # # ##### # ### ##### 
# #       # #   #     #           #     # #   # # # # # #   #   #           # #       #   #   #     #   # # #       #   # #   # 
# ####### # ####### ### ######### # ### # # ### # # # # ######### ##### ##### # ####### ### ####### ### # ############# # # # # 
#         # #       #   #     # # # # # #     # # # # # #       # #   # #   # # #     #       #   #   # #   #   #   #   #   #   
# ######### ######### ### ### # # # # # # ##### # # # # # ##### ### # ### # # # # ### ##### # # ##### # ### # ### # # ### ######
#     #     #       # #   # # #   # #   #   #   # # # #   #   #     #     # #       #     # #   #   # #   #   #   #   #   #     
##### # ##### ##### # # ### # ##### # ##### # ### # # ####### ############# # ##### ##### ####### ### ### ##### ####### ### ### 
# #   # #   # #       # #   #   #   #     # # #   # #   #     #           # # #   #     #       # #   # #   #   #     #   #   # 
# # # # # # # ######### # ##### # ### ### # # # ### # # ##### ##### ####### # # # ############# # # ### ### # ### # # ### ##### 
# # # #   # # #   #   # # # #   # #     # # # #     # # #   #       #   #     # # #       #   #   # # #   # # #   # #       #   
# # # ##### # # # # ### # # # ### ### # # # # ######### # # # ####### # # ##### ### ##### # # ##### # # # # # # ### ####### # ##
#   # #     #   # #   #   # # #   #   # # # #   #       # #   #       #   #   #     #     # #   #   # # #   # # #   #       # # 
##### # ######### ### ##### # ##### ### # # ### # ####### ### # ########### # ####### ##### ### # ### # ##### # # ### ####### # 
#   # #           #         #     # # # #   #   #   #     #   #   #     # # #   #         #   # #     # #     # #   # # #     # 
### # ############# ####### ##### # # # ##### ##### ### # # ##### ### # # # ##### ########### # ####### # ########### # # ##### 
#   #       #     # #   #       # # # #       #   # #   # #   #   #   #         #     #       # #   #   # #         # # #     # 
# ### ##### ##### ### # ### ### # # # ########### # # ### ### # ### # ######### # ##### ####### # # # ### # ####### # # ##### # 
#     #     #     #   #     # # #   #             # #   #  S# #     # #       #   #     #     #   #     # # #   #   # #     # # 
####### ##### ##### ######### # ####### ######### # ### ##### ####### # ##### # ### ##### # # ########### # ### # ### # ### # # 
#         #   #   # #   #       #       #     #   #   # #   # #       # # #   #   # #     # # #     #   # #   #   # #   # # #   
# ##### # # ##### # # # # ####### ########### # ##### ### # # # ####### # # ### # # ####### # ### # # # # ### # ### ##### # ### 
# #     #   #     #   # #   #   #   #         #   # #     # #   #       # # #   # #     #   #     # # # # #   # #         # #   
# # ######### ############# # ### # ### ######### # ####### ### # ####### # ### # ##### # ######### # # # # ### # ##### ### # ##
# #   #               #     #     #   # #       # #       #   # # #     #     # # #   #   #   #   # # # #   # # # #   # #   #   
# ### # ### ######### # ######### ### # # ####### # ### # ### # # # ### ##### # ### ####### # # # # # # ##### # # # # ### ##### 
#   # #   #     #   # # #   #       # #     #     #   # #   # # #   #   #   # #         #   #   #   # #         #   #     #   # 
### # # ####### # # # # # # # # ##### ### ### ####### # # # # ########### # # ### ##### # ########### ########### ### ##### ### 
#   # # #       # # # # # #   # #   #   #   #       # # # # # #           # #   # #     #     # #   #   #       #   #     #   # 
# ### # # ### ### # ### # ####### # ### # # # ##### # # ### # # ########### ### # # ### ##### # # # ### # ### # # # ### # # # # 
#   # # # #   #   #     #   # #   #   # # # # #   #   #   # #   #   #       #     # # #         # #       #   #   #   # #   # # 
# # ### # ##### ######### # # # ##### # # ### # # ### ### # ##### ### # ##### ##### # ######### # ################### # ##### # 
# #     #   #   #   #   # # # # #     # #     # #   # #   #         # # #   # #   #   #       #     #             #   # #     # 
# ######### # ##### # # ### # # # ####### ##### ### # # ########### # ### # ### # ### # ##### ##### # ########### ####### ##### 
#         #   #   # # #   #   # #   #   #   #   # # # #           # #     #     #   # #     #     # #         #   #   #   #     
##### ########### # # ### # ### ##### # ### # ### # # ########### # ############### ####### ##### # ######### # ### # # ### ####
#   #             #   # # #   #       #     # # #   #   #   # #   #   #     #     # #     # #     #   # #   # #     # #   # #   
# # ##### # ########### # ####### ##### ### # # ##### # ### # # ### # ##### # ##### # ### # # ##### # # # # # ####### ##### # ##
# #       #   #     #   #   #   # #   # #   #     #   #     # #   # #         #   # # # # # #       # #   # #   #     #     #   
# ######### # ##### # ##### # # ### # ### # ##### ##### ##### ### # ####### ### # # # # # ##### ##### ##### ### # ##### ##### # 
#         # #             #   #   # #   # #     #   #         #   # #     #     # # # # #   #   #   #       #   #     # #   # # 
######### ########### ### ####### # ### # ##### ### # ######### ##### ### # ##### # # # ### ##### # ####### # ####### # # # # # 
# #     # #         # # #         # # #   #   # #   # #   #   #       #   #     # # #   #   #     #   #     #   #   #   # # # # 
# # ### # # ####### # # ########### # ##### ### # ### # # ### ######### ######### # ##### ### ####### # ####### # # ####### # ##
#   # # # # # #     # #     #       # #         #   # # #   #   # #     #     #   #     #    G#       # # #     # #     #   #   
##### # # # # # ##### ##### ##### ### # ########### # # ### # # # # ##### ### # ####### ####### ####### # # ########### # ##### 
# #   # #     # #   #   #   #   #   #             # # #   #   # # #   #   # # #     #   #     #     # # # #       #             
# # ### ####### # # ### # ### # ##### ####### ##### # ######### # ### # ### # ####### ### ######### # # # ####### # ####### ####
#     #       #   # #   # #   #     #       # #   # # #     #   #   # # #   # #       #   #   #   # #       # #   # #     #     
# ### ####### ##### # ### # ####### # ##### ### # # # # # ### ### # # # # ### # ####### ### # ### # ####### # # ### # ### ##### 
# #         #     # # #   # #     # #     # #   # # #   # #   #   # # # #     # #   #       #           # # # # #   # # #       
### ####### ##### # # # ### ### # # ##### ### ##### ##### # ##### ### # ####### # # ################### # # # # ##### # ####### 
#   # #   #     # # #   # #   # # #     # #   #     #   # #     # #   #         # #       #   #   #           # #     #     #   
# ### # # # ### # # # ### ### ### ##### # # ### ##### # # ##### # # # ################### # # # # ### ######### # ######### # ##
#     # # #   # #   #       # #     #   #     #       # #       # # # #     #         #     #   #     #         # #       # # # 
# ##### # # # # ####### ##### # ### # ####### ######### ### ##### # # # # ### ####### # ############# # ######### # ##### # # # 
#   # # # # # # #       #   # # #   #       #   #   # #   #     # # # # #   #   #     # #   #         #       #     #   # #   # 
# # # # # ### # # # # ### # # # # ######### ### ### # ### # ### # # ### ### ##### ####### # # ####### ####### ####### # # # ### 
# #   # # #   #   # #     # #   # # #     # #   #   # #   #   # # # #   #   #     #     # # # #     # #     #         # # #     
# ##### # # ####### ####### ##### # # ##### # ### ### # ### # # # # # ### ### ##### ### ### # # ##### ### # ########### ### ####
# #     # # #       #     #           #     #         # #   # #   # # #   #   #   # # #     # #     #   # #     #     # #   #   
### ####### # ####### ### ############# ####### ####### # # ####### # # ### ### ### # ####### # ### ### # ##### # ### # # ### # 
#   #       #         #       #   #     #   #   #     # # #     # #   #   #   #     #     #   # #   #   #     #   #   # #     # 
# ##### ### ########### ####### # # ##### # # # # ### # # ##### # ####### ### # ##### ### ### # ##### ####### ######### # ##### 
#     # # #     #     # #       # # #     #   #   #   # #     #   #     #   # #   #   # #   # #     #     #       #       # #   
##### # # # # ### ### # # ####### # # ########### ##### # ### ####### ##### # ### # ### ### # # ### ##### ####### # ####### # # 
#   #   #   # #   #   # # # #     # #   #         #     # #     #   # #   #   #   #   # #   # # #                   # #   #   # 
### ######### # ### ### # # # ##### ### # ####### # ##### # ### ### # # # ##### ##### # # ### ### ############### ### # # ##### 
#     #       #   # #   #   # #     #   #       # # #     #   #       # #         #   # # # #   #   #   #   #   #     # #   # # 
# ### # ##### ### ### ####### ### ############### # ### ##### ##### ### # ####### ##### # # ### ### ### # # # # ### ### ### # # 
# #   # #   #   #   #     # #     #     #         # #   #     #   # #   #   #   #   #     #     #   #   # #   #   #     #   #   
# # ### ### ### ### ##### # ####### ### ##### ##### # ### ##### # # # ##### # # # # # ########### ### ### ####### # ##### ######
# #     #     #   #   #   #   #     # # #   #   #   #   #       # #   #   # # # # # #   #       # #     #     #   # #   #   #   
# ####### ##### # ### # ##### # ##### # # # # ### ##### ######### # ### # # # # ### ### # ##### # # ########### ### # # ### # # 
#     #   #     # # #   #     #     #   # # #   # #   #   #       #     # #   #   #     #     # #   #         # # #   #   # # # 
# ### # ### ##### # ####### ####### ### ### # # # # # ### # ####### ##### ####### # ######### # ### # ####### # # ####### ### # 
# #   # # # #     #       #       #   #       #   # # #   # #   #     # #       # #     #     #   # #   #   # #           #   # 
# # ### # # ### ######### ####### ### # ########### # ##### # # ### # # # # ##### # ### # ####### ##### # # # # ##### ##### ### 
# #   #   #   #     #     #     # # # # #     #   # #     # # #   # # #   # #     # #   # # #     #     # #   # #   #   #   # # 
# ### # ##### # ### # ##### ### # # # # # ### # # ####### # # ### # # # ##### ##### ##### # # ##### ##### ##### # # ##### ### # 
#   #   #     # #   #     # # #   #   # #   #   #   #   # #   #   # # # #     #             # #   # #   # #     # #       # #   
# ####### ####### ####### # # ######### ### ####### # # # ##### ##### ### ##### # # ######### # ### # # # ### # # ######### ####
# #   #   #     #       # #         #   # #     #   # #         #   #   # #   # # #   #   #   #     # # #   # #   #   #         
# # # # ### ### ##### # # # ####### # ### ##### # ########### ### # # # # # # ### ### ### # ######### ##### # ##### ### ##### # 
#   # #   #   #     # #           #     #   #   #         #   #   # # # # # #   #   #   # #         #     # # #         #     # 
##### ### ### ##### ####### ##### ##### # # # ########### ##### ### ### # # ### ### ### # ##### ##### ### # # # # ####### ######
#       #   #     #       #     #   # #   # #     #     #     # # #   # #   # #   #   #   #   # #     # #   # # #   #   # #     
# ######### ##### ####### # ### ### # ##### ##### # ### ##### # # ### # ##### ### ### ##### ### # ##### ##### # ### # # ### ### 
#         # #     #       #   #   # #       #     # #   #   #     #   #   #     #   #     #   #   #     #   # # # #   #     #   
####### # # ####### ############# # ####### # ####### ### # ####### ### # # # ##### ### # # # ######### ### # # # ########### ##
#       # #       # # #           #   #     # # #   # # # #       #   # # # # #   # # # #   #           #   #     #         # # 
# ####### ####### # # # ### ####### # ####### # # # # # # ####### ### # ### # # ### # # ####### ######### ### ### # ### ##### # 
#   #     #   #   # # #   # #     # #             #     #     # #     #     # #   # # #       # #   #   # #     # #   # #     # 
### # ##### # # ### # ### # # ### ########################### # ####### ##### ### # # ####### # ### # # # # ### # ##### # ##### 
#   #       # #     #     # #   #                             #             #   #   #         #       #     #   #       #       
