################################################################################################################################
################################################################################################################################
   #       #             #       #               #       #   #   #           #             #   #   # #   #   #   #             #
 ### ##### ########### # ### # # ############### # # ##### # ### # ######### # # # ### ##### # ### # # ### # ### # ##### ### ###
   #   # # #           #   # # #     #   #     #   # #   # #     # #       # # # #   #   #   #   #   #   # #       #   #   #   #
## ### # # # ############# # # ##### # # # # ####### # # # ####### # ####### # # ### ### # ##### ### ### # ##### ### # ### ### #
 #   # # # # #     #     # # #   #   # # # #       # # # # #     # #   #       #   # #   #     #   #       #   #     #   # # # #
 ### # # # # # # ### ### # ##### # ### # # ######### # # # # ### # # # # ######### # # ####### ### # ##### # # ##### ### # # # #
   #   # #   # #     #   #       # #   # #           # #   # #   # # #   #   #   # # # #     #   # # #   #   # #   # #   #   # #
## ##### ##### ################### # ### ####### ##### ##### # ##### ##### # # # # # # ### ##### # ### # ### # # # ### ####### #
 # #   #     # #       # #   #     #   # #     # #   #     # #     # #     # # # # # #     #   # #   # #   # # # #   # #   #   #
 # # # # ##### # ##### # # # # ####### # # ### # # # ##### # ##### # # ##### # ### # ####### # # ### # ### # # # ### ### # # ###
   # #   #     # #     #   # #         # # #   # # #       # #     # #   #   #     #   #     # # # #   # # # # #   #   # # # # #
 ### ##### ##### # ######### ########### # ##### # ######### ####### ### # ######### # # ##### # # ##### # # ##### ### ### # # #
   #     #   #   # #     #   #   #   #   #   #   # # #   #   #   #       #   # #     # #   # #   #       # #     #   #     #   #
 ####### ### # ### ### # ### # # # # # ##### # ### # # ### ### # # ######### # # ##### ### # ######### ### # ####### ###########
         # # #   # #   #       # # # # #         # # # #   #   # #     # #   #   #       #     #       #   #     # #           #
 ######### # ### # # ####### ##### # # # ######### # # # ### ### ##### # # ####### ### # ##### # # ### # ####### # ########### #
   #       #     # # # #     #     #   #   #       #   #     # # #   # # # #   #     # #     # # # # # # #   # # #           # #
## # ##### ####### # # # ##### ######### # # ####### ######### # # # # # # # # ##### # ### ### ### # # # # # # # # # ##### # # #
   #   #       #   # #   # #   #   #   # # #   #   #         #   # #   # #   #   #   #   #   #     #   # # # # #   # #   # # # #
 ##### # ##### # ### # ### # ### # # # # # ### ### ######### # ### ##### ####### # ### ##### ####### ### ### # ### ### # # ### #
 #   # #   # # # #   #   # #   # # # # # #   #   # #       #           #         # # # #       #     # #   #       #   # # #   #
 # # # ### # # # ### ### # ### ### # ### # ##### # # ##### ### ####### ########### # # # ### # # ##### ### ######### ### # # ###
   #   #   #         #     #   #   #   # # #     #   #   #   # #     # #       #   # # # #   # #   #     #     #   # # # # #   #
## ##### ### ############# # ### # ### # # # ######### # ### # # ### ### ##### # # # # # ######### ### # ##### # # # # # # ### #
   #     # # #           # #   # #       # # #   #     #       # # # #   #     # # #   #         #     #     #   # # #   # #   #
 ### ##### # # ######### # ### # ####### ### # ### ############# # # # ### ##### # ######################### ##### # ##### # ###
 #   #   #   #         # #     # #     #   # #         #       #   # #   # #     #           #       #     #     # #         # #
 # ##### ############# # ##### ### ### ### # # ####### # ##### ### # ### # # ### ############# ##### ##### ##### # ####### ### #
 #       #     #     # # #   #   # #   #   #   #   #   # #   #   # # # # # #   #     #       # #   #   #   #   # # #     # #   #
 ######### ### # ### # # # # ### # # ### ##### # # ##### # ####### # # # # ##### ### # ##### # # # ### # # # ### ### ### # ### #
         # #     #   # #   # #     #   #     # # # #       #   #   #   # # #   #   # # #   #   # # #   # #   #   #   #   #     #
 ### ##### # ####### # ##### ######### ##### # # ### ####### # # ####### # # # ### ### # ####### ### ####### # ### ### ####### #
 #   #   # # #     #   #   # #   #                 #   #     #   #       # # #   #   # #   #   # #   #       #   #   #         #
## # # # # # # ### ##### # # # # ################# ### # ########### # ### # ####### # ### # ### # ### ######### ### ######### #
   # # #   # #   #     # # #   # #         #     # #   # #   # #     # # # #   #     # #     #   # # #   #     #   # #       # #
 ##### ##### ### ##### # ####### # ####### # ### # # ### # # # # ##### # # ### # # ### # ##### ### # # # # # ##### # # ##### # #
     # #       #   # # #   #   # #   #   #   # # #     #   # #   #     # #   #   # #   # # #   #   #   # # #     # # # # #   # #
#### # # # ####### # # ### # # # ### # ####### # ##### ##### ##### ##### ### ####### ### # # ### ##### ### ##### # # # # # ### #
     # # #   #       #   # # # #     # #     # #   #       #       #     #   #       # # # #   #     #     #     #   #   #   # #
 ##### ####### ######### # ### ####### # ### # ### # ##### ######### # ### ### ####### # # ### ##### ### ############### ##### #
     #   #   #   #   #   # #           # #   #   #   #   #       #   #     # # #     # #     # #   #     #     #   #   #   #   #
 ### ### # # ### # # # ### # ### ####### ##### ##### # # # # ### # ######### # # ### # ##### # ### ##### # ### # # ### ### # ###
   #   # # #     # #   #   # #   #     #     # #     # # # # # # # #   #     #   # # # #   #           # # # #   #     #   #   #
#### # # # ####### ##### ##### # # ### ##### # # # ### # ### # # # ### # ######### # # # ### ######### # # # ########### ##### #
     # #   # #   # #   #    S# # #   #   #   #   # #   #     #   #   #   #       #   #       #     #     # #         #   #   # #
 ##### ##### # # # ### ##### ### ####### # ####### # ########### ### ### # ############# ##### ### ### ### # ####### # ### # # #
   # #       # # #     #   #   #         #   #   # #       #   #         #   #           #     #   #   #   # #     # # #   # # #
## # # # ### # ########### ### # ########### # # # ####### ### ##### ### ### # ####### ### ######### # # ### ### ### # # ### # #
   #   # #   #   #           # #     #     #   # #       #     #     #   # #   #       #   #         # # # #   #   # # # # # # #
 ####### # ##### # ### ####### ### # # ### ##### ############# # ### # # # ##### ##### # ### # # ##### # # ### # # # # # # # # #
 #   #   #     # # #   #     #   # #   # #     # #       #   # #   # # # #       #     #   # # # #   # # #     # # # # # # #   #
 # # # ### ### # # ##### ### ### # ##### ####### # ##### # # # ### # # # # ##### # ### ### ### # # # # # # ##### ### # # # #####
   # #   # # #   # #   #   #   # # #     #       # #     # # # #   # # # # #     #   #   #   # # # # # # # #   #   #   # # #   #
 ### ### # # ##### # # ### # ### # ##### # ####### # ##### # # # ### # # # ##### ### ####### # ### # # # # ### # # ##### # ### #
   #   # #       #   # #   #     #     # # #       #     # # # #   # # # # #     # #       #   #   #   # #       #     # #   # #
 ##### # ####### # ### # ############# # # ### ######### # # ##### # # # # # ##### ########### # ##### # ### ######### # ### # #
     # #       #   # #   # #   #       # # #   #       # # # #     # # #   # #         #   #   #     # # #   #   #   # #   #   #
###### ####### # ### ##### # ### ####### # # ##### ##### # # # ##### # ##### # ######### # ######### # # # ### # # ### ### ### #
       #   #   #             #   # #     # #     #     # # #   #     #     #   #   #   # #   #       #         # # #     #     #
 ####### # ####### # # # ##### ### # # # # ##### ##### # ############# ### ### # # # # ##### # ########### ##### # # # ####### #
   #   # #     # # # # #       #     # # #     # #   # #     #       #   #   #   # # # #   #   #         #   # # #   #   # #   #
## # # # ##### # # # # ######### ##### ####### ### # # ##### # ##### ####### ### ### # # # ##### ####### ### # # ####### # # ###
 #   #   #   # #   # #             #   #     # #   # # #   # # #   #   #   #   # #   #   #     # #       #     #       #   #   #
 ### ##### # # ##### ### # # ##### ##### ### # # ### # ### # # # # ### # # ### ### ########### # ############# ####### # ##### #
   #     # #   #     #   # #     #       #   #   #   #     # # # #   #   #   #   # #     #   # #     #     # # #   #   #   #   #
## # ##### ##### ##### ### # ############# # ##### ####### # # # ### ####### ### # # ### # # # ##### # ### # # # # # ##### # ###
   # #     #     #   # #   # #   #       # #   #   #     # #   # #               #   # # # # #     #   #   # # # # #   #   # # #
 ##### ##### ####### # # ##### # # ##### # # ### ### ### # ##### ##### ### ########### # # ####### ##### ### # # # ### ### # # #
   #   #     #     #   # #   # #   #   #   # #   # #   # #   #   #   # #   #             #         #   # #   #   #   #   # #   #
## # ### ######### ##### # # # ##### ####### # ### # # # # # # ### # ### # # ####################### ### # ### ######### # ### #
   #   #       #   # #   # # # #             #   #   # #   # # #   # #   # # #         #           #     #   # #         # # # #
 ##### ####### # ### # # ### # # ####### ### ### ##### ##### # # ### # ### # ### ##### # ### ##### # ####### # # ######### # # #
       #     #   # #   #   #   # #   #   #     #     #     #   # #     #   #   #     #   #   # #   #     #   # #         #   # #
############ ##### ### ### ####### # ##### ######### ########### # ########### ##### ##### ### # # ##### # ### ######### # ### #
     #     # #   #       #   #     #       #     # #   #       # # #   #       #   #   #   #     #     # # #   #         #   # #
 ### # ### # # # ##### ##### # ############# ### # ### # ##### # ### # # ####### # ### # ####### ####### # # ############### # #
   # # #   #   # #   # #     #         #     # # #   # #   # # # #   #   #   #   #     #       # #     # # # # #   #   #     # #
 ### # # ##### ### # # # ############# # ##### # ### # ### # # # # ######### # ############# # ### ### # # # # # # # # ### ### #
 #   # #     # #   # # #     #   #     #     # #   #       #   # # # #   #   #   #         # # #   # # # #   # # #   #   #   # #
 # ### ##### # # ##### ##### # # ########### # ### # ####### ### # # # # # ##### # ####### ### # ### # # # ### # ####### ### # #
 #   # #   # # #   #   #   #   #         # #   # # # #     #   # # #   # #       # #   # #   #   # # #   #     # #     #   # # #
 ##### # ### # ### # ### # ### ######### # ### # # ### ### ### ### ##### # ### ### ### # ### # ### # ####### ### # ### ### ### #
 #     # #       #   #   #   #   # #     # #   #   #   # #   #   # #   # #   #   #   #   #   #   #           #   #   # # #     #
 # ##### # ### # ### # ##### ### # # ##### # ####### ### ### ### # # # # # # ####### # ### ### ### ##### ##### ##### # # #######
 #   # # # #   #     #   # # #   # #   #   #   #   # # # #   #   #   # # # #   #   # # #   #       #   #   #   #     # #   #   #
 ### # # # # ### ####### # # # ### ### # ##### # # # # # # ### ####### # # ### # ### # # ### ####### # ### # ### ##### ### ### #
     #     # #   #     # #   # #   # # # #   # # #   #   #   #     # # #     #   #   # #   # #       # #   # #   #   #   #     #
#### ####### # # # ### # # ### # ### # # # # # # ##### ##### ##### # # ### ####### ### ### ### ####### ##### # ##### ### ##### #
     #       # # #   # # #   #   #   # #   # # # # #       # #   # #       #       #     #     #   #   #     # #     #   #   # #
 ##### ####### ##### # # ### ### # # # ### # # # # # ##### # # # # # ####### ######### ########### # ### ##### ##### # ### # # #
     # #   # #   #   # # # #   #   # #   # # # # # # # #   # # # #     #     #   #     #   #       #   #   #   #   # #   # # # #
 ### # # # # ### # ### # # ### ##### ### # ### # # # # # ### # # # ##### ##### # ##### # # # ######### ### # ### # # ### # # # #
   # #   # #   #   #   # #   #   #   # # #   #   #     # # # # #   #     #     # #     # # #         #   #   #   #     #   # # #
## # ##### ### ##### ### ### ### # ### # ### ######### # # # # # ### ##### ##### # ### # ########### ### ####### ##### ##### # #
   #     # #   #   #   #     # # #     #   #       #   #   # # # #   #     #   #   #               # # #       #   #         # #
 ######### # ### # ### ####### # ######### ####### # ####### # # # ### ### # # ##### ########### ### # ####### ### # ##### ### #
 #         # # # #   # #     #   #       #   # #   #   #     # # #   # #   # #     # #     #   #         #   #     # #     #   #
 # ##### ### # # ### # ### # # ### ##### ### # # ### ### ##### # ### # # ### ##### ### ### # # ######### # # ####### # ### # ###
 #     # #   # # # # #   # # # #     # #   # #   # #   #     # # #   # # # # #   #   #   #   # #   #   # # # #     # # #   # # #
 ##### ### ### # # # ### ### # ##### # ### # # ### # # ##### ### # ### # # # ### ### ### ##### # # # # # # # ### # # # ##### # #
     #     #   #   #   # #   #     # #   #   # # #   #     # #   # #   #   #     #     # # #   # # # # #   #   # # # # #   # # #
#### ####### # ####### # # ####### # # # ##### # # ####### # # # # ############# # ### # # # ##### ### ####### # # # # # # # # #
   #         #       #   #     # # # # # #   # # # #     # #   # #     #         #   # #   #       #         #   #   #   #   # #
 # ##### ##### # ############# # # # # # # ### # # ##### # ##### ##### # ########### ##### ######### ####### ####### ######### #
 #     #   #   #             # # # # # # # #   # # #   # #   #   #   # # #   #   # #       #         #     # #     #     #   # #
 ##### ##### ### ##### # # ### # # # ### # # ### # # # # # ### # # # # # # ### # # ############### # ### # # # ### # # # ### # #
 #   #       #     #   # #     # #   #   #   # #   # #   #   # # # # #   #     # #           #   # #   # # # # # #   # #   #   #
 # # ############### ### ####### ##### ### ### # ### ####### # # # # ########### ######### # # # ##### # # # # # ##### ### ### #
   #   #         #   #     #                   #     #       # # # #           #     #     # # #       # # # # # #     # # #   #
 ##### # ####### # ##### # # ####### ### # ### ##### # ####### # ### # ##### # ##### # ##### # ######### # # # # ### # # # # ###
   #   # #     #   #     #   #   #   #   #   #       # #   #   #     # #     #     #   # #   # #         # #   #   # #   #   # #
#### ### # ### ##### ##### ### ### ### ##### ####### # # # # ##### ##### ######### ##### # ### # ################# # ######### #
   # # # #   #   #   #   # #   #   #       #       # # # # #   #   #G    #               #     #       #       # # #       #   #
 # # # # # # ### # ##### # ### # ######### ##### # ### # ##### # # # ################# # ############# # ##### # # # ### # ### #
 #   #   # #   # # #     #     #   #   #   #   # # #   #   #   # # #           #       # #   #     #   # #   #   #   #   #     #
 ######### ### # # # ############# # ### ### # ### # ##### # ### ########### # # ##### ### # # ### # # # # # ######### ### #####
 #   #     #   # #   #       #     #     #   # #   # #     #   # #     #   # # #   # # #   #   #   # # # # #       #   #   #   #
 ### # # ### ### ##### ##### # ########### # # # ### # ####### # # # # # # # # ### # # # ############# # ##### ### # ### # ### #
     # #   #   #   #   #   # # #       #   # #   #   #       # #   # # # # # #   # # # #         # #   #       # #   #   #     #
###### ####### ### # ##### # # # ### # # ### ####### ####### # ##### ### # ####### # # ######### # # ########### ##### ### #####
   #     #   # #   # #   # #   # #   # # #   #       #     # #   #   #   # #       #         #   #                 #   #       #
 # # ##### ### # ### # # # ##### # ### ### ##### # # # ### # ### ##### ### # ############### # ####### ####### ### # ### ##### #
 #   # #   #   #     # # #       #   #   # #     # # # # # #   #     #   #   #             # # #     #       # #   # #   #   # #
 ##### # ### ######### ### ##### ### ### # # ##### ### # # ### ##### ### ################# # # ### # ######### # ### # ##### # #
       #     #             #       #   #   #     #       #   #         #                   #       #           #     #       # #
################################################################################################################################
