################################################################################################################################
################################################################################################################################
#   #               #       #   #         #   #       #       #     #         #     #       #   #           #             #     
# # # # ### ####### # ##### # # ##### ### # # # ##### # ### # # # ### ### # # # ### # ##### ### # ### # ### # ######### # # ### 
# #   #   #       #     # # # #     # #   # # # #   #   # # # # #     # # # # # # #   #   #     # #   #   #     #   #   # #   # 
# ########### ######### # # # ##### ### ##### # ### ##### # ### ##### # # ### # # ##### ######### ##### ######### ### ### ##### 
#   #       # #     #   # # # #               # #   #   # # #   #   #   #   # # # #   #             # #       #   #   # #   #   
##### ##### ### ### # ### # ### ##### ##### ### # ### ### # # ### # ####### # # # # # # ########### # # # ### # ### ### # ### ##
#   #   # #   # #   #   # #     #   # #   #   # # #       #   #   #     #   # # #   #   #   #     # #   # #   # #   # # # #   # 
# # ### # ### # ####### # ####### # # # # ### # # # ########### ####### # ##### # ######### # ### # ### # # ### # ### # # # ### 
# # # # # #   #   #   # # #     # # # # #   #         #       #   #   # # #   # # #         #   #   #   # # #   # #       # #   
### # # # # ##### # # # # # ##### # ### ### ####### ### # # # ### # # # # # # # # # ##### ##### ######### # # ### ####### # # ##
#   # # #   #       #       #     #   # # # #     #   # # # # #   # #   #   # # # # #   #     # #         # #   #     #   # #   
# ### # # ##### ############# ####### # # # # ### ### # # ### # ############# # # # # # ##### # ### # ######### ##### # ### ### 
# # #   #     #   #   #       #   # #   # #   # #   #   # #   # #           # # #     # #   # #   # #   #   #     #   #   #   # 
# # ######### ### # # # ####### # # ##### ##### ### ##### # ### # ######### # # # ##### # ### ### ####### # ##### # ######### # 
# # #       #     # #   #       # #       #   #   # #     #   #   #       #   # # #   # #       #       # #     #   #         # 
# # ### ### ##### # ############# # ##### # # ### # ####### # ##### ########### # # # # ##### ######### # ##### ### # ######### 
# # #   # #     # #         #   #   #   #   #     #       # #           #       # # # #   #       #     # #   # #   #       #   
# # # ### ##### # ######### # # ##### # ######### ####### ############### ####### # # ### # ### # # ##### # # # ########### # # 
# #   #   #         #     #   #   #   #       #   #     #         #       #       # # #   #   # # #       # # #           # # # 
# ##### ####### # # ##### ####### # ######### # ### ### ######### # ####### ####### # ######### ########### ######### ### # ### 
# #   #   #     # #         #     #     # #           # #       # # #     # #       #   #     #             #   #   # #   #   # 
# # # ### # ### # ####### # # ##### ### # # ####### # # # ##### # # # ### # # ######### # ### ####### # # # # # ### # ####### # 
# # #   # # #   #   #     # #   # # #   # # #     # # # # #   # #   #   #   # #         # #   #       # # # # # #   #         # 
# # ### # # ####### # ##### ### # # # ### # # ### # # # # ### # ##### # ##### # ######### # ### ####### # # ### # ############# 
#   #   # # #     # #     # #   #   #   # # #   # # # #       #       #       #   #       #   # #       # #     # #           # 
##### ### # # ### # ##### # # ######### # # ##### ### ##### ### ##### ########### # ######### # ### ##### ####### # ##### # ### 
#   #   #   #   #   #   # # #   #       # #   #   #   #   # #   #   #   #       # #     #   # #   #     # #       # #     # #   
### ### # ##### # ### # ### ### # ####### ### # ### # # # # # ### # ### # ####### ##### # ### # # ##### # # ### # # # ##### # ##
#   #   # #     # #   # #     # # #       #   # #   # # # # #   # #   # #     #   # #   #     # #   #   #   #   #   # #   # # # 
# ### ##### ####### ### # ##### # # ####### ### # ##### # # ##### ### # ##### # ### # ######### ### # ####### ### ### # # # # # 
# #   #     #     # #   # #     #     #   # # # #   #   # # # #   # # #     #   # # # #   #     #   # #     #   # #   # #   #   
# # ######### ### # # ### # ##### ##### # # # # # # # ### # # # ### # ########### # # # # ####### ### ##### ### ### ### ####### 
# #   #       # #   # #   #   #     #   # #   # # #   #   #   #   # #           # # # # #         #   #   #   # #   #   # #   # 
# ### # ####### ##### # ##### # ##### ### # ### # ##### ######### # ########### # # # # ########### # # # ### # # ##### # # # # 
#   #   #               #   # # #     #   # #   #     # # #       #   #       # # # #   # #   #     #   #   #   # #   # # # #   
# # ##### ##### ####### # # # ### ##### ### # ##### ### # # ######### # ##### # # # ##### # ### # ######### ##### # # # # # ####
# # #       #   #     #   # #     #   # #   # # #   #   # #   #             # # #     #   #     #   #       #     # # #   # #   
# ### ##### # # # ### # ############# # # ### # # # # ### ### ### ##### ### # # ##### ### ##### ##### ############# # ##### ### 
#     #     # # # #   #       #   #   # #   # # # # # #   # #   # #   # # # # #   #           #   #   #   #         # #     #   
####### ### # ### ##### ####### # # ### ### # # # # # # ### ### # # # # # # ##### ########### # # # ### # # ######### # ##### # 
#       #   #   #     #   #   # # #   #   #   #   # # # # #   # # # #     # #   #   # #     #   # # #   # #     #   #   #   # # 
# ############# ##### # # # # # # # ##### # ####### # # # ### # ### # ##### # # ### # # ### ##### # # ### ##### # ####### # ### 
#     #             # # # # # # # # #           #   #   #     #   # # #   #   # #   #   #         #   #       # # #       #     
# ##### # ########### # ### ### ### # ######### # # ##### ####### ### # # ##### # ####### ####### ##### # ### # # # # ######### 
# #     # #         #   #   #           #       # #         #   #   #   #     # # #     #   #         # #   # # #   #   # #   # 
# # ####### ####### ### # ### ####### # ######### # ##### # # # ### # ####### ### # ### ### ### # ### # ### # # ####### # # # # 
# #     #   #     #   # #     #     # #     #     # #     # # #   # # #     #     #   #   #   # # #   # #   # #   #     # # #   
# ####### ####### ### # ##### # ### # ##### # ##### # ### ### ### # # ##### ######### ### ### # # ##### # ####### # ##### # ####
# # #   # # #     #   #       #   # #   #   # #   # # # # #   # # # #   #   #         # #     # # #   # #       #   #   #   #   
# # # # # # # ### # ##### ####### # ### # ##### # # # # # # ### # # ### # # # # ####### ####### # # # # ####### ##### # # ### # 
#   # # # # # #   #       #     # #     #   #   # # # # # #   #     # #   # # #   #   #       # #   # #     #   #   # # #   # # 
# ### ### # # # ########### ### ####### ##### ### # # # # ### # ##### ##### # ### # # # ##### # ##### ##### # ### # # # ### ### 
#   #     #   #       #       #   #   #   #   #   # # #   #   # #   #     # #   # # #   #   #   #   #   #   # #   #   #   # #   
# ######### ######### # ######### # # # # # ### ##### ### # ##### # # ##### ### # # ##### # ### # # ### # ### # ########### # ##
# #   #   # #       # #   #     # # #   #     # #   # # # #     # # # #     #   # #       #   # # # #   # #     # #   #     #   
# # # # # ### ##### # ### # ### # # # ######### # # # # # ##### ### # # ##### # # # ######### # # ### # # ### ### # # # ##### # 
# # #   #   #   #   # # # #   #   # # #     #   # #   #       #   # # #   #   # # #   #       # #     # #   #       # # #     # 
# # ####### ##### ### # # ########### # ### # ############# ##### # # ### # ##### # ### ####### ########### ######### # # ##### 
# #   #   # # #   #     # #     # #   # # # # #           # #     # # #   #   #   # #   #       #     #   #     #     # #     # 
# ### # # # # # ### # # # ### # # # ### # # ### ######### # # ### # # # ### ### ##### ### ##### # ### # # # ### ####### # ##### 
# #S#   # # # # #   # # #     # # #   # #   #   #   # #   # #   # # #   #   #   #   # #   #     # #   # # #   # #             # 
# # ##### # # # # ### # ####### # ### # ### # ##### # # ####### ### # ### # # ### # # ### # ### # # # # # ##### # ########### ##
# #       # # #   #   # #     # #   # #   #   #   #   #     # #     #   # # #   # # #   # #   # # # # # #   #   #     #   # #   
# ######### # # ##### ### ### # ### # ### ####### # ####### # ######### # # ### ### # # ##### # # # ### ### # ### ##### # # ### 
#   #       #   #   # #   # #   #   # #   #   #   # #       #     #   # # #   #     # #   #   # # #   # # # #     #     # #   # 
# ### ####### ### # # # ### ##### ### # ### # # ### # ########### # # # ############# ### # ##### ### # # # ####### ##### ### # 
# #   #   #   #   # # # #   #       # #     #   #     #       # # # # #       #   # #   # #       #   # # # #       #   #   #   
# # ##### # # # ### ### # ### # ### # ########### ##### ##### # # # # ####### # # # ### # ### ##### ### # # # ####### # ### ### 
# #     #   # # #   #   # #   # # # #   # #     # #     #   # #   # #       #   # #     #   # #   # #   #     #   #   #   # #   
# ##### # ##### # ### ### # ### # # ### # # ### # ####### # # # ### ##### ####### ##### ### # # ### # ######### ### ####### # ##
#       #     # # #   # # # # # # #   # # #   # #   #     #   #     #   #     #   #       # # #   # #     #   #   #G#   #   # # 
##### ### ### # # # ### # # # # # ### # # ### ##### # ##### ##### ### # ##### # ########### ##### # ##### # # ### # # # # ### # 
#   #     # #   # # #   #     # #     # #   # #   # # #   #       #   #     # #           #     # #     # # # #   # # #   #     
# # ####### ##### # # # # ##### ### ### # ### # ### ### # ####### # ####### ############# ##### # # ##### # # # # # # ##### ####
# # #     #       # # # # #   # #   #       # #   #   # #       # # #     #         #   # #   # # # #     # #   #   #     # #   
# # # ### ######### # # # # # # ##### ##### # ### ### # ####### # # # ####### ####### # # # # # # # # ##### # ##### ##### ### # 
# # # # # #       #   #   # # #       #   #     #   #   #   #   # # #       #       # # # # #   #   #   #   # #               # 
# ### # # # ##### # ####### # # ####### # # ####### ##### # # ### # ####### ####### # # # # ########### ####### ######### ######
#     #   #   #   #   #   # # # #     # # #   #     #   # # #     # #   #   #     #   #   # #         #       #   #     #       
####### ##### # ### # # # ### ### ### # # ##### ##### # ### ##### # # # ### # ############# # ##### ######### ### ##### ####### 
#       #     #   # #   #     #   #   # #   #   #     #   # #     # # # #           #       # #   #     #   #   #   #   # #   # 
# ############### # ####### ### ####### ### # ### ####### # # ##### # # # ####### # # # ##### ### ##### # ##### # # # ### # ### 
#   # #   #         #     #   # #       # # #     #       # #   #   # # #   #     # # # #   # #   #     #   #   # #   #   #     
### # # # ### ##### # ### ##### # ####### # # ##### ####### ### # ### # ### # ##### # # # # # # ### ### ### # ### ##### # ######
#   #   #   # #     #   #     #   # #     # # #   #     #     # #     #   # #     #   #   #     #   #     #   #       # # #   # 
# ######### ### ### ### ##### ##### # ##### # # # ##### ##### # ######### ####################### ### ######### ### ### # # # # 
#   #   #       #     # #       #   # #     # # #   #         #   #     #     #     #           # #     #     #   #     #   # # 
### # # ########### ### # ### # # # # # ##### # ### ######### ### # ######### # ### # ######### # ####### ####### ########### # 
# # # #           #   # # #   #   # # #     # # # #     #   # # # #     #     # # # #         #   #     #       #           #   
# # # ########### ### # # # ######### ##### # # # ##### ### # # # ##### # ##### # # ### ##### ##### ### ####### ##### # ### ####
# # # # #       #   #   # #   #       #       # # #   #   # #   #   #   # #   # # #   # #   # #   # #   #     #       # #   #   
# # # # # ### ##### # ### ##### ####### # ##### # # # ### # ### ### # ### # # # # ### # # # # # # # ### ##### ######### # # # ##
# #   # #   # #     # # # #         #   # #     # # # #   #   #         #   #   # #   # # # # # # #   # #       #     # # # #   
# ##### ### ### ##### # # # ######### ### # ##### # ### ##### ### ##### ######### # ##### # ### # ### # # ##### # ### # # ##### 
#         #   #     #   # # # #       #   # #   # # #   #         #   # #   #     # # #   # #   #   # #   # #   # #   # # #     
# ##### # ### ##### ### # # # # ####### # # # # # # # # ########### # # # # # ### # # # ### # ##### # ##### # ### ##### # # ####
#   #   # #   #   # # # # # # # #       # # # #     # # #   #       # #   # # #   #   # #   #     #   #     # #   #     # #     
# # ####### ### # # # # ### # # ######### # ####### # ### # # ####### ##### # # ##### # ######### ##### ##### # ### ### # ##### 
# # #     #     # # #         #         # #         #   # # # #     # #     # #     # #   #     #   #   # #   # #   #   #       
# ### ### ####### # ##### ### ######### # ######### ### # # ### ### # # ##### ### ### ### # # # ### # ### # ### # ##### ########
#   # #   #       #     # #     #   #   #     #   # # #   #   # # # # #     #   # #   # # # # #   # #     # # #   # #           
### # ##### ##### ##### ### ### # ### ### ##### # # # ####### # # # # ##### # # # # ### # # # ##### # ##### # ##### # ### # ### 
#   #       #         #     #   #     #   #   # #   #       #   # #   #   # # # #         # # #   # #       #     #   #   #   # 
# ######### # ####### ##### ### ####### # # # # ########### ##### ##### # # ### ######### # # # # ### ######### # ##### ####### 
#           #   #           #         # #   # # #     #   #   #       # # #   #   #     # # # # #     #         #       #       
### # ### # ### # ### ### # # ####### # ##### # # ### # # ### # # # # ### ### ### # ### # # ### ####### ######### # ############
# # # # # # # # # #   #   # #     #   #   #   #   # # # #       # # #             # # #   #   #         #     #   #   #         
# # # # # # # # # ### # ######### # ### # # # ##### # # ########### # ##### ####### # ### ### ########### # # # # ### # ####### 
#   #   # # # # #   # # #   #   # #     # # #     #   #     #       # #   # #   #   # #     #   #         # #   #   # #   #   # 
######### # # # ### # # ### ### # ######### # ##### ######### ######### # ### # # ### # ### ### # # ####### # ####### ### # ### 
#         #   #   # # #     #   #   #   #   #   #   #       #     # #   # #   # # #   # #     #   # #       # #   #   #   # #   
# ####### ####### # ######### ##### # # # ##### # ### ##### # ### # # ### # ### # # ### # ### ### ### ### ##### # # ### ### # ##
# #   #   #       # #             # # # #     # #     # #   #   #   # # # #   # # # #   #   #     #   # # #     # # # # #   # # 
# ### # ### ####### # # ########### # # ##### # ####### # ####### ### # # # # # # # ####### # ### # ### # # ##### # # # # ### # 
#   # # #   #       # #   #       #   # #   # #         # #     # # # # # # # # #   #   #   #   # #   #   #   #     #   #     # 
### # # # ### ####### ### # ##### ##### # # # # ##### # # # ### # # # # # ### # ##### # # # ### # ### ####### ########### ##### 
# #   # #   #       # #   #     # # #   # #   # #     # #   # # #   # # #   # #       #   #   # #   # #     #         #   #     
# ##### ### ######### ########### # # # # ##### # # ######### # ##### # ### # ############### # # # # # ### ####### ### ##### ##
#     #   #           #           #   # # #     # # #         #   #   #   #   # #     #       # # # #   #         #   # #   # # 
# ####### ############# ############### # # ##### ### # ######### # ### ####### # ### # ####### # # ##### ####### ### # # # # # 
#               # #   # #             # # # #   #     #   #     # # #       #   # #   # #     # # # #   #   #       #   # # #   
########### # # # # # # # ########### ### ### # ######### # # # # # # ##### # ### # ### # ##### # # # # ### ##### ######### ### 
#         # # # # # #   #   #   #   #   #     #     #   #   # # #   # #   #   #   # #     #     # # # #   #   #         #   #   
# ####### # # # # # ####### # # ### ### ########### # ####### # ##### ### ##### ### ####### ##### # # ### ### ########### ### ##
#       #   # #   #         # #                     #         #               #   #         #     #   #     #                   
################################################################################################################################
