################################################################################################################################
################################################################################################################################
#       #     #     #       #         #         #     #   #   #       #               #   #                     #           #   
# ##### # ### # ### # ##### # # ##### # # ##### ##### # ### # # ##### # # ########### # ### # # ############### # ### ##### # # 
#   #   # # #   # #   #   # # # #   #   #     #             # #     # # #   #         #     # # #   # #         #   # #   # # # 
### # ### # ##### ##### ### # # # # ######### ############### # ##### # ### # ############# # ### # # # ########### # # ### # # 
#   # #   #   #         #   # # # #     #   #         #       # #     #   # # # #   #   #   # #  G# # # #           # #     # # 
# ### # ##### # ### ### # ### ### ##### # # ######### # # ##### # ####### # # # # # # ### # # # ### # # # ##### ##### ##### # ##
#   # #   #   #   #   # # #   #   #   # # # #       # # # #     # #       # # #   # #     # #   # # # #   #   # #   # #   # #   
##### ### # ##### ### ### # ### ### # # # # # ####### # ### ##### ######### # ##### ####### ##### # # ##### # # # # ### # # ### 
#       #   #   # # #     # #   # # # #   # # #   #   #   # #   #         # #                     # #       #   # #   # # # #   
# ##### ####### # # ####### # ### # # ##### # # # # ##### # # ########### ################# # ##### ####### ##### ### # # # # # 
# #           # # #       # # # # # #     # #   #   #     # # #   #     # #         #       #     #       #     #   #   # # # # 
# # ####### # # # # ####### # # # # ##### # # ####### ##### # # # ##### # # ####### # ####### ########### # ####### ##### # ### 
# #     #   #   # #     #   #   #   #     # # #     # #   #     #     # # #       # # #       #       #   # #     #     #       
######### ##### # ##### # ##### ##### ##### # # ### ### # # ####### ### # # ####### # # ####### ##### # ##### ### ######### ####
#   #   #     # # #   #   #   #     #     # # #   #   # #   #     # #   # # #   #   # # #   #   #   #   #     # #       #   #   
# # # # ####### # # # # ### # ##### ##### # ##### ### # ##### ### # # ### # # # # ### ### # # ### # ##### ##### ####### ### # # 
# # # #       # # # #   #   #     #   # # # #   # # #   #   #   # #   # #   # #   #   #   #   #   #     # #   # #     #   # # # 
# ### ####### # # ##### # ########### # # # # ### # ##### # ### # # ### ##### ####### # ##### # ####### # ### # # ### ### # # ##
#     #   #   #         # #       #   # #   #   #   #     # #   # #         #   #   # # #     # #     # #     # # #   #   # #   
######### # ########### # # ##### # ### ####### ### ##### # # ### ####### ##### # # ### ##### # ##### # ####### # # ### ### ### 
#     #   # #       #       #     #     #   # # # #     # # # #     #   # #     # #   #   #   #       #   #       #   # #     # 
# ### # ### # ##### ######### ### ##### # # # # # ##### ### # ##### # # # # ### # ### # # ############### # ########### # ##### 
#   # #   # #     # #         #       #   # # # #         # #     # # # # #   # # #   # #           #   # #       #     #   #   
##### ### # ####### # ####### # # ### ##### # # ### ##### # ####### # # ##### ### # ##### ####### # # # # # ##### # ####### # ##
#   #     #     #   # # #     # #   #     #         #   #           # # #   # #   #     #       # # # #   #     # #     #   # # 
# # ##### ##### # ### # # ### # ### ##### ### ####### # ######### ### # # # ### ####### # ### ### ### ##### ### ####### # ### # 
# # #     #   # #     #   #   #   # #         #       # #       #     #   #   # #       #   #   #   # #   #   #   #     #   # # 
# # # # ### # # ########### ####### # ##### ### ####### # ##### # ########### # # ####### ##### ### # # # ### ### # ####### # # 
# #   # #   # #     #   #   #       # #   #   #       # #   #   # #   #       # # #       #   #   #   # #     # # # #     # #   
# ##### # ######### # # # ### ####### # # ### ####### # ### # ### # # # ######### ##### ### # # # ##### ####### # # # ### # ### 
# #     #     #   #   # #   # #   #     # # #   #   # #   # #       # #   #       #   #     # # # #       #   #   # # # #   #   
# # ######### # # ##### ##### # ### # ### # # ### # # ### ### ##### # ### # ####### # # ##### # ### # ### # # ### # # # ### # ##
# # #     # #   #     #       # #   #   #   #     # #   #   #     # #   #   #       # # #     #     # #   # # #   # # #     #   
# # # ### # ######### ######### # # ############### ### ### # ### ##### ##### ####### # # ########### # ##### ### # # ##### ### 
# # #   # #       #           # # # #      S  #       # #   #   # #   # #     #     # # #   #       # #       #   #   #   # #   
# # ### # ####### # # # ##### # # # # ####### # ####### # ##### # # # ### ##### ##### ##### # # ##### # ####### ####### # # # ##
# #     # #         # # #   # #   # #   #   # # #   #   #   #   # # #   # #     #   # #   #   # #   # # #   #       #   # #   # 
# ####### ########### # # # # ### ##### ### # ### # # ##### # ### # ### # # # ### # # # # ####### # # # # # ######### ### # ### 
#       #           # #   # #     #     #   # #   #   # #   #   # # # # #   # #   # # # #         #   # # # #       # # # #     
####### ########### # ##### ##### # ##### ### # ####### # ### # ### # # ##### # ### # # ############### # ### ##### # # # ##### 
#     #   #       #     # # #   # #   #     #   #       # #   #     # #       #   #   # #   #           #     #   #   # # #     
# ### ### ##### # ### # # # ### ####### ### ##### ### ### # ######### # ######### ##### # # # ####### # ######### ##### # # ####
#   #     #     # #   #   #   #   #     # #       # #     #     #   # #     #   # #   # # # # #       # #               # # #   
### ####### ##### # # # ##### ### # ##### ######### ########### # # # ##### # # # # ### # # # # ##### # ### # ### ##### # # # # 
#   #   #   #       # # #       # #   #   #                     # # # #     # #   # #   # # # # #   # #   # #   # #   # # #   # 
# ### # # ########### # # ####### ### # ### ####### ### # ######### # ##### # ##### # ##### # # # # # ### ####### # # # # ##### 
# #   #   #     #     # #         #   #   # #     # # # #           #     # # #     #   #   # # # #   # # #     #   # # #       
# # ##### # ### # ##### ########### ##### # # ### # # # ######### ####### # # # ####### # ### # # ##### # # ### # ### ######### 
# # #   # #   #   #       #   #   #     #   # # # # # #   #     #   #   # # # #         #     # #   #   #   #   # # #   # #   # 
# # # # # ### # ########### ### # ##### ##### # # # # ### # ### ##### # # # # ################# ### # ####### ### # ### # # # # 
# #   # #   # # #   #     #     #   # #       # #   #   # #   #       # # # #   #     # #   #     #   #     # #   #   #   # # # 
# ##### # ### ### # # ### ######### # ######### ##### # # ### ######### # # ### # ### # # ### # # ##### ### # # ### ####### # # 
# #     #   #     #   # #         # #   #     #   # # # #   # # #   #   # #   # # #   # # #   # # #   # #   # # #   #       # # 
# ######### ##### ##### ######### # ### # ### ### # # # ### # # # ### ### ##### # # ### # # ### # # # # # ### # # # # ####### # 
#   #   #   #   #     #         #   #     #   #   # # # #   # # #     # #       # #     #   #   # # # # #     #   # #   #   # # 
### # ### ### # ### # # ##### ####### ######### ### # ### ### # ####### ######### ##### ####### # # ### ########### ### ### # # 
#   #     #   #   # # # #   #           #   #   #   # #   #   #         #     #     #           # # #   # #   #   # # #   #   # 
# ####### # ##### # # # # ##### ##### # # # # ### ### # ### ### ####### # ### # ### # ### # ##### # # ### # # # # # # ### # ### 
# #       #   #   # # # #   # # #     # # # #   #   # #   # #   #     # # #   # #   # #   # #     #   #     # # # # # # # #     
# ############# ### # # ### # # # ##### # # ### ### # ### # # ### ### # # # ### # ### # ### # # ####### ##### # # # # # # ##### 
#     #         #   #   #     # #     #   #   #   # #   #   # # #   #   # #   # #   # # #   # # #     #     # # #   #   #     # 
# ### # ######### ####### ##### # ### ########### # ### ##### # ### ##### ### ####### # # ##### ##### # ### # # ####### ##### # 
# # # #       #         # #     #   #   #         # #   #   #     #     # #   #       # #   #   #       # # #           #     # 
# # # ####### ##### # ### # ####### ### # ######### # ### ####### ####### # ### ##### # ### # ### ####### # ############# ##### 
# # #       #     # #     #     #     #   #       #   #   #   # #         #   # #   # #   # #     #     # # #     #       #     
# # # ### # ##### # ########### # ### ##### ##### # ### ### # # ############# # # # # ##### ####### ### # # # ### # ####### ####
#   # #   #   #   #           # # #             #   #   #   #         #     #   # # # #     #   #   #   #   # # # #   #   # #   
##### # ####### ############### # ########### ####### ### ########### # ######### # # # ##### # # ######### # # # ### # # # # ##
#     # #     # # #             #           # #     # #   #   # #   #   #     #   # # # #   # #     #   #   # #       # # # #   
# ####### ### # # # ############# ##### ### # # ### # ### # # # # ##### # ##### ### # # # # # ####### # ### # ######### # # ### 
#     #   # # # #   #     #     # #   # #   #   #   #     # # # # #     # #   # # # # #   # # # #     #   # #   #       # #   # 
##### # ### # # ##### ### # ### # # # ### ### ### ######### # # # # ##### # # # # # # ##### # # # ####### # ### # ########### # 
#   # # #   # #     #   # # #   # # #     #   # #   #       #   # #     #   # # # #       #   # # #   # # # #   # #     #   #   
# # # # # # # ##### ### # # # ##### ####### # # ### ### ######### ##### ##### # # ### ### ##### # ### # # ### ### # ### # # ### 
# # # # # # #       #   # # #   #   #   #   # # # #   #           # #   #   #   #     #   #     #   #     #   #     #   # #     
# # # # ### ######### ### # ### # ### # ##### # # ### ### ######### # ### # ##### # # # ####### ### ##### # ### ######### ######
# # # # #   #       #   # #   # # #   #     # #   # #   #       #   #     #       # # #         # # #   #   #           #       
# # # # # # ### ### ### ##### ### # # ##### # ### # ### ####### ### ### ########### # ######### # # # # ##### ######### ### ####
# # #   # #   # #         #   #   # # #   #   #   # # # #     # #       #       #   #     #   #   #   #     # #       #   # #   
### ##### ### # # ####### # ### ### # # # ##### ### # # # ### # # # # ### ##### ######### # # ############### # ##### # # # # # 
#   #     #   # #   #     #     #   #   #     # # # # #   # # #   # # # #   #             # #             #   #   #   # #   # # 
# # # ##### ### ### # ### ####### # ######### # # # # ##### # ##### # # ### ############### ############# # ##### # # ####### # 
# #   #   # #     # #   #   #   # #     #   #   # #       #   #   # #   # #         #     # #     #   #   #   #   # # #   #   # 
####### # # ####### ### ### # # # ##### ### ##### ####### ##### # ### ### ######### # ##### # ### # # # ### ### ### ### # # ### 
#       # #         #   #   # #   #   # #   #           # #     #   # #     #     #   #     # # #   #   #       # # #   #     # 
# ####### ######### # ### ### ### # ### # ### ######### # ### ##### # ##### # # ####### ##### # ######### ####### # # ######### 
# #     #     #   # #   #   # # # #     # #           # #   # #   # # #   # # # #       # #   # # #               #   #       # 
# # ### ##### # # ######### # # # ####### # ######### # ### # ### # # # # # # # # ####### # ### # # # ########### ########### # 
#   # #   # #   # #         # #                     # # #   #   #   #   #     # # #   #   # #       # #   #     #     #   #   # 
##### ### # ##### # ##### ### ####### # ##### ##### # ### ##### ############# ### ### # # # ##### ##### # # ### ##### # # # ### 
#   #   #   #   #   #     #   #       #     #   #   #         #   #   #     # #   #   # # # #   #   #   # # # #   #   # #   #   
# # # ####### # ##### ##### ##### ######### ### # ######### # ### ### # ### # # ### ### # # # # # # # ### # # ### ##### ##### ##
# # #         #   #       #     #     #   # #   # #   #   # #   # #   # #   # #     #   # #   # # # # # # #   # #       #   #   
# # ### # ####### # ########### ##### ### # ####### # # # # ### # # ### # ########### ### ##### # ### # # ### # ######### # ### 
# # #   #       #   #     #   # #     #   #       # #   # # #   # # #   # #           # #       #     # #   #   #         #     
# ### # ########### # ### # ### # ##### # ####### ####### # ##### # # ### # ########### ######### ##### ### ### ######### ##### 
#   # #   #         # #   #     # #     #     # #       # #     # # # # # #   #         #       #     #   # # #   #   #   #   # 
### # # ### ####### # # ######### ####### ### # ##### ### # ### # # # # # ### ### ##### ##### # ### ##### # # ### # # # ### # # 
# # # #   #       # # #         #     #   #   # #   #   # #   # # #   # #   # #   #           # # # #   # # #   # # # # #   #   
# # # ### ####### # # ############### # ### ### # # ### # ### # # ##### ### # # ############### # # # # # # # # # # # # # ##### 
# #   #       # # # #       #       # #   #     # #   #   #   #   #       # # #         #   #       # # #   # # #   # # #   # # 
# ##### ### # # # # ####### ### ### # ### ##### # ### ##### ####### ##### # # ########### # # ####### # ##### ####### # ### # # 
#       #   #   # # #     #   #   # #   # #     #   #       #           #   # #         # #   # #     #   #     #   #   # # #   
####### ######### # # ### ### ### # ### # # ####### ### # # # ##### # ####### # ####### # ##### # ####### ##### # # ##### # ### 
#     # #       # #   # #   #     # #   # #   #   # #   # #   #   # # #       # #     #   #     #   #   #     # # #     #   #   
# ### # # ##### ####### ### ####### # ### ### # ### # # # ####### # # # ##### # ### # ####### ##### # ####### # # ##### ####### 
# # #   #   #   #   #           #   # #   #   #     # # #         # #   #   # #     #       # #   # #     #   # #     #   #   # 
# # # ##### # ### # ########### # ### # ##### ####### ############# ##### # # ############# # # # # ##### # ### ##### ### ### # 
#   # #   # #   # #     #     # # #   #   #     #       #         #       # #       #     # #   # #   #   # #   #   #   #     # 
##### # # # ### # ##### # ### # # # ##### # ### ### # # # # ############### ##### # # ##### # ####### # ### # # # # ### ####### 
#   # # #   # # #   # # #   #   #   #   # # #   #   # #   #       #     #   #     #   #     # #       #   # # # # #   #   #   # 
# ### # ##### # ### # # # # ### ##### # ### # ### ### ########### # ### # ### ######### ##### # ######### # # # # ### ### # # # 
# #   # # #   #     #   # #   # # #   #     #     # #       #     # #   # #             #   # #   #     # # # #   # #   #   #   
# # ### # # # ############### # # # ############### # # ### # ### # ##### # ############### # ### # ### # # ####### ### ####### 
# #   # #   #   #           # #   #     #     #   #   #   # #   # #   #   #             #     #   # #     #     #     #         
# ### # ##### # ### ####### # ### ##### ##### # # ### ### ##### ##### # ####### ### # # # ##### ##### ### ##### # ### ##### ####
#     #   #   #     #         #       #       # # #     #   # #     # #       # # # # #   #   # #   # #       # # #         #   
######### # ######### ######### # ### ######### # # # ##### # ##### # ####### # # # # ##### # # # # ### ##### # ### ######### # 
#   #   # #   #         #       # #             # # #     #     #   #       # #   # # #     # #   #   # # #   #   #       #   # 
# # # # # ### # ##### # # ####### # ############# # # ### ####### ####### ### # ### ### ############# # # # ##### ####### # ### 
# #   #   #   # #   # # # #       #   #   #         #   # # #     #       #   #   # #   # #     #     # #   #   #     #   #   # 
# ############### # ### # # # ####### # # ############# # # # ##### ####### ##### # # ### # ### # ##### # ### ####### ####### # 
# #   #           #   # # # # # #   #   #       # #   # # # # #   # #       #     #       #   # #       # #         #     #   # 
# # # # ############# ### # # # # ############# # # ### # # # # # # # ####################### # ######### # ### # # ##### # ### 
#   #   #                 # #   #               #       #   #   #   #                         #             #   # #     #   #   
################################################################################################################################
