################################################################################################################################
#         #             #     #   #           #               #     #     #   #       #           #           #   #   #         
# ##### # # # # ##### # ##### # # ### ####### # ############# # # ### ### # # # # ### # ### ##### ### # # ### ### # # ##### ### 
# #     #   # # #     #     #   #   #     # #   # #         #   #     #   # # # # # #   #   #   #     # #   #   #   # #   #   # 
### ####### # # # ######### ####### ##### # ##### # ################### ### # ### # ### # ### # ####### ### ### # ### # # ### # 
#   #       # # #         #     #       #   # #     #   #     #       #   # #     #     # #   # #     # #   #   #   #   #   # # 
# ### # ##### # ######### ##### # ##### ### # # ##### # ### # # ##### ### ########### # # # ### # ### ### ### ##### ####### # ##
# #   # #     #     #     #       #   #   # # # #   # # #   #   #   #   #     #       # #   #   # #     # # # #   #   # #   #   
# ####### ##### ### # ##### ####### # ### # # # # # # # # ### ### # # # ##### ####### ######### # ##### # # # # # ### # # ##### 
#       # #     #   #   #   # #     # #   # #     #   # # #   #   #   # #   #       # #       # #   # #   #   # # # # #   #   # 
##### # # ####### ##### ### # # ##### # # # ########### # ##### # ##### # # ####### ### ##### ### # # ##### ### # # # ####### # 
#   # # #       #     #   #   #   #   # # #       #       #     # #     # #   #   # #   #   #   # # #   #   #   #   #       # # 
# # ### ####### # ### ### ### ### # ### ######### ######### # ##### ### # ### ### # # ##### ### # # ### # ######### ####### # # 
# #           # #   #   #   #   # #   # #       # #     #   # #     #   # # #S  # #   #   #   # # # #   #       #   #   #   # # 
####### ##### # ### ####### ### # ### # # ### # # # ### # ##### ##### ### # ### # ##### # ### # ### # ######### # ### # # ### # 
#     #   #   #   #   #     #   #   # #   #   # #   # # #   #   #   #         #   #     #   # #   # # #     #   #     # # #   # 
# ### ##### ##### ### # ####### ### # ### # ######### # ### # # # ########### ####### ##### # ### # # # ### # ### ####### # ### 
# #   #   # #     # # # # #       # #   # #           #   # # # #   #       #         #         # #   # #   # # # #   #       # 
# # ### # ### ##### # # # # ### ### ### ####### ### ##### ### ##### # ##### # ############# ### # ####### ### # # ### # ##### # 
# #     #     # #   # #   #   # #   # #       #   # #   # #   #     # # #   # #           #   # #       #   # #   #   # #   # # 
# ############# # ### ######### # ### ##### # ### # # # # # ### ##### # # ### # ######### # # ######### ### # # ### # # # # # # 
# #     #       # #   #   #   #     # #   # #   # # # #   #   # # #   #   #   # #           # #   #     #   # #     #     # #   
# ##### ####### # # ### # # # ##### # # # ##### # ### ##### # # # # ####### ### # ######### # # ### ##### ### ######### ### # ##
# #     #   #   # # #   #   #   #   # # # #     #   #   # # # # # #       # #   # #       # #   #   # #     #         # # # #   
# # ##### # ### # # # ######### # ### # ### ####### ### # # # # # ####### ### ### # ##### # ##### ### # # ########### # # # ####
# #   #   #     #   #       #   # #   #   # #       # # #   #   #       #   # # # #     # #     #   #   #     #         #   #   
# ### # ####### ### ######### ### # ##### # ### # # # # ### ##### ######### # # # # ##### ### # ### # ##### ### ############# # 
# #   # #     #   #       #   #     #   #   #   # #   # #   #   #   #   #   # #   # #     #   # #   #     #     #   #   #     # 
# # ### # ### # ### # ##### ### # # # # ##### ### # ### ### # # # # # # ### ### ### # ########### ####### ######### # # # ##### 
# #     # # # #     # #   # # # # # # # #   # # # #   #   #   #   # # #   #     #   #           #   #               # # # #     
# # ##### # # ####### # # # # # # # # # # # # # # ####### ##### ### # ### ##### # ############# ### ########### ##### # # ######
# # #   #   # #         # # # # # # # # # # #   #   #   #     # #   # # # #     #     #   #   #   #   #     #   #     #   #   # 
# ### # # ### # ######### # # # # ### # # # ##### # # # ##### # # ### # # ### ####### ### # # ### ### # ### # # # ######### # # 
#     #   #   # # #     # # #   # #   # # # #   # #   #     # # #   # # #   # #       #   # #       # #   # # #             # # 
# ######### ### # # ### ### # ##### ### # # # # # ######### # # ##### # ### # # ####### ### ##### # # ### ### ############### # 
#         # #     #   #   #         #   # #   # #     #   # # # # #   #   # #             #   #   # #   #     #   #     # #   # 
# ######### # ####### ### # ############# ##### ##### # # # # # # # ### ### # ######### ##### # ### ### # ##### # # ### # # ### 
# # #       # #   #   #   #   #   #     # #   #     # # # #   #   # #   #   # #       # #     #   # # # # #  G# # # #   # #     
# # # ######### # # ### ### # # # # ### # # ####### # # # ######### ### # ### # ##### # # ####### # # # ### # # # # # ### ##### 
#   #   #     # # # #   #   # # # #   #   #         #   # # #     #   # # #   #     # # #   #     #   # #   #   # # # #       # 
# ####### ### # # ### ### ### # # ### ############### ### # # ### ### # # # ######### ##### # ##### ### # ####### # # ####### # 
#   #     #   # # #   #     # # # #   #                 # # # # #   # # # # # #     # #   # # #     # # #       #   #       # # 
# ### ##### ##### # ### ### ### # # ##### ### ### ##### # # # # ### # # # # # # ### # # # # # # ##### # ### ############### # # 
#   #   # # #   # #       # #   # #     #   #   # #     # #   #   #   # # # # #   #   # #   # #   #   #     #     #       # # # 
# # ### # # # # # # ##### # # ### ##### ######### # # ### ####### ##### # # # ### ##### ##### ### # ######### ### # ##### # # # 
# #   #   # # # #       # #     #     # #   #   # # #   # #         #   #       #       #   #   #   #   #     # # # #   #   #   
# # ####### # # # ##### # ### # ####### # # # # # # ##### # # ##### # # # ##### ######### # ### ##### # # ##### # # # ######### 
# #     #   # #   #   # #   # #   #     # #   # # # #     # # #   # # # # #   # #       # # #   #   # # # #     #   # #   #   # 
##### # # ##### ### # # ### ##### # ##### ##### # # # ##### # # ### # # # # # ### ##### # # # ### # # # # ##### ##### # ### # # 
#     # #     # #   # #   # #   # #   #     #     # # # #   # #     # # # # # #   # #   # # #     # # # #   #   #           # # 
# ##### ##### # # ### ### ### # ##### # # # ######### # # # # # ##### ### # # # ### # ### # ### ### # # ### # # # ### ####### # 
#   #       # # # #     #     #     # # # # #   # #   # # # # #     # #   # #   #   #     #   # # # # # # # # # # #   #     #   
### ######### # # ##### ##### ##### # ### # # # # # ### # # # ### ### # ### ##### ########### # # # ### # # # # ### # # ### ### 
#   #   #   #   #     #     # #     #   # #   #   # # #   # #   # #   # # # #     #   #     # #   #       # # # #   # #   #     
##### # # # ### ##### ##### # # ####### # ######### # ### # ### # # ### # # # ##### ### ##### ##### ####### # # # ### ######### 
#     # # #   # #   #   # # # #         # #   #     #     #   # #         # #   #     #   #   #   # #       # #   #     #   #   
# ##### # ### # # ##### # # ############# # # # # ####### ##### ####### ### ### ##### ### # # # # # # ####### ##### ##### # ### 
#     # # #   # #     #   #     #         # # # # #     # #   # #     # #   # #     #   # # # # # # #   #     #   # #     #   # 
####### # ##### ##### ######### # # # # ### ### ### ### ### # # # ### # # ### ##### # # # # # # # # ### # # # # # # # ####### # 
# #     # #       #   # #       # # # # #   #   #   # #     # # #   # # #   # #   # # # # # # # # # #   # # # # #   # #   #   # 
# # ##### # ##### # ### # ######### ### # ### ### ### ####### ####### # ### # # # # # # # # # # # ### ##### # ####### ### # ### 
# # #     # #     # #   # #   #     #   #   # #       #     # #       # #   #   #     #   # # # #     # #   #       #     #   # 
# # # ##### # ##### # ### # # # # ### ##### # # ####### ### # # ####### # ### ##### ####### ### ####### # ######### ######### # 
# # #       # #     # #   # # # # #   #   # # #   #     # #   # #       #     #   #   #     #   #       #     #   #   # #     # 
# # ######### # ##### # ### # # # # ### # # # ### # ##### ##### # ####### ##### # # ### ### # ######### ##### # ### # # # ##### 
# #     #   # #   # # # #   #   # #     # # #     # #   #     # #   #     #     # # #   # # #   #     #       #     #   #   # # 
# ##### # # # ### # # # # ############### # ####### ### # ### # ### # ##### ##### ### ### # ### # ### ####### ############# # # 
#   # # # #         # # #   #     #     # #   #   #     #   # #     #   # #   #     #   #     # #   # #     #       #       # # 
### # # ##### ##### # # # # # ### # # # # ### # # ########### ##### ### # ### ##### ### ##### # ### # # ### ####### # ####### # 
# # # #       #   #   # # # # #   # # # #     # #   #   #   #               #   #   #   #   # #   # # # #   #   #   # #     # # 
# # # ####### # # ##### # # # ##### # ############# # # # # ######### ####### # ### # # # # ##### ### # # ### # # ### # ### # # 
#           # # # #     # # #   # # #             # # # # #         # # #   # #   #   # # #     #     # # #   # #   # #   # #   
##### ##### # # # # ##### # ### # # ######### # ### # ### ######### # # # # ### # ##### # ##### ####### # ##### ### # ### # # ##
#     #       # # # #     #   # #   #       # #   # #     #             # #   # # #   # # #   #   #     #   # #   # #     # #   
# ##### ### ### # # ####### ### # ### ##### # ### # ####### ############# ### ### # # ### # # ### # ####### # ### # ####### # # 
# #   #   #     # #       #     # #   #   # #   #   #   #         #     #   #   # # #     # # # # # #       #       #       # # 
# ### ### # # ########### # ##### # ### # # ### ##### # ### ##### # ### ### ### # # ####### # # # # ### ####### # ### ####### ##
# #     # # #   #     #   #       #     # # #     #   #   #     #     # #   # # #   #       #   # #   #       # # #   #     #   
# # ##### # ##### ### # ####### # ####### # # ##### ##### ### ######### # ### # # ### ########### ### ####### ### # ### ### ### 
#   # #   # #     # # #     #   #   #   # # # #   # #   #   # #     #   # #     #       #         #   #     #   # # #   #   #   
# ### # ### # ##### # ##### # ##### # # # # # # # ### # ### # # ### # ### # ##### # ### # ######### ### ####### # # # ### ### ##
#     # #   # #   # #       #     # # # # # #   #     #   # #     # # #   # #     #   # #         # #           # # # #   # # # 
####### # ### # # # ############# # # # # # ### ######### # ##### # # ##### ### ##### # ######### ### ########### # # ##### # # 
#       #     # #             #   # # #   #   #     #   # #   # # # #   #   #   #     #         #   # #     #   # # #   #       
# ############# ########### ### ### # ####### ### ### # # ### # # # ### # ### ##### ### ##### ##### # # ### # # # # ### ####### 
#     #   #     #   # #     #   #   # #   #   #   #   # #     #   # # #   # #     # #   #   #     #   #   # # #   #   # #   #   
# ### # # # # ### # # # ##### ### ### ### # ####### ### ### ### ### # ##### ##### # ##### # ### ######### # ##### ### # # # ### 
# # #   # # #     # #       #   # #   #   #           #   # #   #   # #     #     #       # #   #   #     # #   #   # # # #     
# # ##### ######### # ##### ### ### ### ################# # # ### ### # ##### ##### ####### # # # # # ##### # # ##### # # ##### 
#       #   #   #   #     #   #   # #               #   # #     #   # #     #   #         # # # # # # #   # # # #   # #   #     
########### # # ##### ### ### ### # # ### ##### ### # # # ######### # ##### ### # ### ##### # ### # # # ### ### # # # ##### ####
#         #   # #   # #   #   #   # #   #     #   # # # # #       # # #   #     #   #   #   #   # # # #   #   # # # # #     #   
# ####### # ### # # # ######### ### ### ########### # ### # ##### # # # # ####### ##### # ### # # # # ### ### # # # # # ####### 
# #   # # # #   # # # #       # #   # #     #   #   # #   #   # #   # # # #     # #     #   # #   # #   # #   # # #   #         
# ### # # ### ### # # # ##### # # ### # ### # # # ### # ##### # ##### # # ##### # # ### ### # ##### ### # # ### # ##### ########
#   #   #     #   #   #   # # # #   #   #   # # #   # #   # # #   #   # #       # #   #   # #   # #     # #     #     # #   #   
# # ### ######### # ##### # # # ### ### ##### # ### # ### # # ### # # # ######### ### # ### # # # ####### ########### # # # # # 
# #   #   #       #     #   # #   # # # #     # #   #     # # # #   # # #     #     # # #   # #       #   #   #     #   # # # # 
# ### # # # ####### ####### # # ### # # # ##### # ######### # # ##### # # ### # ### # ### ########### # ##### ##### ### # # ### 
#   # # # # #       #       # #   # # # #     #       #   # # # #   # # #   #   #   # #   #         #   #   # #   #       #     
### # # # ### ##### # ########### # # # ####### ####### # # # # # # # # ### # ####### # ### ####### # ### # # # # ##### ########
#   # # #     #   # # #   #   # # # #   #     # #   #   # #   #   # # # #   # #       #     # #   # # #   # #   #     # #       
# ### ######### # # # # ### # # # # ### # ### # # # # ######### ### # # ####### ############# # # # # # ### ######### # # ##### 
#   # #         # # # # #   #   #   #   # # # # # # #       # #   #   #       #               # # # #     #       #   # #     # 
### # # ######### # # # # ############# # # # # # ######### # ### ########### ########### # ### # # ##### ####### # ### # ##### 
#   # #   #     # #     #   #           #   #         #   # #   #     #     #     # #     #     # # #   # # #   # #   # # #   # 
# ### ### # ### # ### ##### # ### ############# ##### # # # # # ##### # ### ##### # # ##### ####### # # # # # # # ### # # # # # 
#   #   #     # #     #   #   # # #             #   # # #   # #           # #   # #   #       #   #   # #   # #   # #   # # #   
### ### ####### ##### # ####### # # ### ######### # # # ##### ### ####### # # # # ##### ####### # ##### # ### ##### # ### # ####
#     #   # #   #   # #           # #   #         #   #     #   # #     # # # # #   #   #       #       #   # #   #   #   # #   
# ### ### # # # # # # ##### ####### # ### ### ####### ##### ##### # ### # ### # ### ##### ################# # ### # ### ##### # 
#   #   # # # # # #         #       # #   # # #           #       #   # # #   #   # #     #     #           #   # #   # #     # 
# # ##### # # # # ########### ######### ### # # # ####### ### ####### # # # ##### # # ##### ### # # ########### # ### # # ##### 
# #   #   #   # #         #   #   #   # #     # # #     #   # #       #   #   #   #   #   #   #   # #       #   #             # 
# ### # ####### ########### ### # ### # ##### # ### ### ### # # ######### ### ######### ##### ### # ####### # # ####### ##### ##
#   # #       #   #       #   # #   # #     # #   #   # #   # #     #   #   # #       #   #   #   #         # # #     # #   #   
### # ####### ### # ##### ### # ### # ##### ##### ### # # ### ##### # ##### # # ######### # ### # ########### # # ### ### # ### 
# # # #     # #   # #   #   # # # #   #   #     #   # # #   # #   #   #               #   # #   #   #       # # # # # #   #   # 
# # # # # # # ##### ### ### # # # ##### # ### ### # # # ### # # # ##### ############# # ### ### # ### # ### # ### # # # ##### # 
# # #   # # # #     #   # # #     #   # #     #   # # #   #   # # #     #     #     # #     #   # #   # #   #       #     #   # 
# # ##### # # # ##### ### # # ##### # ######### ##### ### ##### # # ##### ### # ### # ####### ### # ### # # ############### ### 
# #     # # #   #     #   # # # #   #   #     # #     # #       # #   #   # #   #   #           #   #   # # #         #     #   
# # ### # # ##### ####### # # # # ##### # ### # # ##### ############# # # # ##### ##### ####### ##### ### # # ######### ##### ##
# # #   # #     # # #     # #   #   #   # # # # #   #   #             # # # #   #       #       #   # # # # #     #     #     # 
# # # ### ####### # # # ### ######### ### # # # ### # # ######### ### # ### # # ### ##### ####### # # # # # ##### # ##### ##### 
# # # # #   #   # # # # #   #   #     # #   #     #   #         # #   #   # # #   # #     #   #   # # # # #     #   #   # #   # 
# # # # ### # # # # # # # ### # # ##### ####### # ############# # # ##### # # ### # # ##### # # ### # # # # # ####### # # # # # 
#   #     #   #       # #     #   #             #             #   #     #   #   #   #       # #   #   #   # #         #     #   
