################################################################################################################################
     #     #   #       #         # #       #               #     # #     #         #     #     #           #     #   #   #   # #
 ### # ##### # # ##### ### ##### # # ##### # ####### ##### # ### # # ##### ####### ##### # ### # # ####### # ### ### # ### # # #
 #       #   # #     #     #   # # #   #   # #     #   #   # # #   #   #   #     # #     # #   # # #     #     #       #   #   #
 # # ### # ### ############# ### # ### # ##### ### ### ##### # ####### # ### # # # # ####### ##### # ### ##### ######### #######
 # # #   #   #   #   # #     #   # #   #       # # # #   #     #   #   #   # # #   #   #   #       # # #     #     #     #     #
 # ### # ####### # # # # # ### ### # ########### # # ### # ##### # # ##### # ######### # # # ####### # ##### ##### # ##### ### #
 # #   # #     # # # #   #     # #   #   #     # # #     #   #   #   #     #   #       # # # #             #   #   #   #   # # #
## # ### # ### # # # ### ####### # ##### # ##### # # ####### # ####### # ##### # ######### ### ############### # ##### # ### # #
   #   #   # #   # #   #   #     # #       # #   # #     #   #   #   # # #   #           #   #   # #         # #     #   #   # #
 ######### # ##### ### ### ##### # # ##### # # ### ##### # ##### # # # ### # ### ### ### ### ### # # ####### # # # # ##### ### #
 #       # #   #   # #   # #   # # # #   # # # #   #     # #   #   # #     #   #   #   #   # #   # #     #   # # # #   #     # #
 # ##### # # # ##### ### # # # # # ### # # # # # ### ##### # # ##### ######### # # ### # ### # ### ##### # ### # # ##### # ### #
 #   #   #   # #     #   # # # # #     # # # # # # # #       #       #       # # #   # #     # #       # # #   # #     # # #   #
 ### # ####### # # ### ### ### # ####### # # # # # # # # ##### ####### ##### # # ##### # ##### ####### # ### ### ##### ### # ###
   # # #   #     #       #   # # #     # # # #   # # # #     #   #     #   #S  #   #   # #   #     # # # #   #   #   #G    #   #
 ### # # # # ######### # ### # # ### ### # # ##### # # ##### ### # ####### ####### # ### ### ##### # # # # ### ### ##### ##### #
 #   #   # # #   #   # #           # #   #     #     # #   #   # #       # #       # # #     # #       # #   #     #   # #     #
 # ####### # # # # # ######### # # # # ####### # ##### ### ### ######### # ######### # # ##### # ####### ### ##### # # ### #####
 # # #     #   # # #       #   # #   #       # #   #     #     #   #   #   #         #           # #     #   #       #     #   #
## # # ####### # # ####### # ####### ####### # ### ##### ####### # # # ##### ################# ### # ##### ####### ######### # #
   # #   #   # # #       # #       # #     # #       #     #     # # # #   #   #   # #       #     #     # #     # #     #   # #
 ### ### # # # ######### # ####### # ##### # # ##### # # ### ##### # # # # ### # # # # ##### # ######### # # ### # # ### # ### #
 #     #   # #     #     #     #   #       # # #   #   # #   # #   # # # #   #   # #   # #   #         #   #   #   #   # # # # #
 ### # ##### # ##### ######### # ### ####### ### # ##### # ### # ##### ##### ##### ##### # ##### # # ######### ### ### # # # # #
   # #     # #     #   #   #   #   # #       #   #   #   # # #   #     #   # #   #       # # #   # #         # #   # # # #   # #
## # ##### # # ### ### # ### ##### # # ####### ##### # # # # # ### ##### # # # ##### ##### # # ### ######### # # ### # ##### ###
   # #   # # #   # #   #   # #     # # #     #     # # # # # #   #     # # # #     #       #   # #       #   # #     #   # #   #
 ##### # # # ### ### ##### # # # ##### # ### ##### # # # # # ### ##### # # # ### ############### # # ### # ######### ### # ### #
 #     #   # #   #   #   # # # #     #   # # #   # #   # #   # #   #     #     # #       #     #   #   # # #     #     # #   # #
 ######### # # ### ### # # # # ##### ##### # # # # ##### ##### ### # ########### # ##### # ### ####### # # ### # # ### # # # # #
     #     # #     #   #   # # #   #         # # # #   # # #       #             #     # #   # #       # #   # #   #       # # #
#### # ##### # ##### ####### # ### ############# # # # # # # ####### ################# # ### # # ####### ### # ##### # ##### # #
     #     # #             # #                   #   # #   #   #   # #     # #   #   # # # # # # #     #   # # #   # # #   #   #
 ######### # # ##### ####### # ##### # ####### ########### ### ### # ##### # # # # ### # # # # # ##### # # # ### # # ### # ### #
 # #     # #   #   #   #   # # #   # #       #         #   # # #   #   #   #   # #   # # # # # #       # # #     # # #   # #   #
 # # ### # ### # # ### # # # ### # ######### # ####### # ### # # ##### # ### ### ### # # # # # ######### # ####### # # ##### # #
 #   # # #   # # #   # # # #   # # #   #   # #       #       # #     # #   #   #   #   #     # #   #     #       # # #       # #
 ##### # ### # # ### # # # ### # # # # ### # # ##### ######### ##### # ### # ##### ##### ####### # ####### ### ### ########### #
 #             # #   #   #   # # # # #   #   # #   #           #     # # #       # #     #   #   # #     #   #   #     #   #   #
 ############# # ##### ### # # # # ##### ##### # # ####### ##### ##### # # ##### ### ##### # # ##### ### ### ### ##### # # # # #
 #   #       # #   # #   # # #   #     # #   # # # #     #       #     # # #   # #   #     #   #     # #     #       #   # # # #
## # # ##### # ### # # # # ########### # # # ### # # ### ### # ### ##### # # # ### ### ######### ##### ####### ##### ##### ### #
   # #     #     # #   # #     #     # # # #     # # # #   # #   #         # #     # # #   #     #   # #       #     #   # #   #
 ### ##### ##### # ##### ##### ##### # # # ####### # # ### # ### ##### ##### ####### # # # # ##### # # # # ##### ### # ### # ###
   #       #   # #     #     #   #   # # #   # #   # # #   # # #     # #     #   #   #   #   #     # #   #   #   #   #   # #   #
## ####### # # # ##### ##### ### # ### # ### # # ### # # ### # ##### # # ##### # # # ######### ##### ### ### ##### ##### # ### #
   #     # # #   #   #   # #   #   #   # #   # # #   # # #     #   #   #     # # # # #       #     #   #   #   #       #   #   #
 ####### # # ### # ##### # ### ##### ### # ### # # ### # # ####### ######### ### # # # ##### ##### ### ##### # # ### # ##### ###
 #     #   #   #     #   #     #     #   # # # # # #   # #                 #   #   #       #     #   #     # # #   # #         #
 # ### ########### # # ####### # ##### ### # # # # # ### ##### ##### # ### ### # ######### ##### ### ##### # # ##### ##### ### #
 # # #       #   # #   #       # #     #   #   # # #   # #   #   # # # #     #     #   #   #   # # #   #   # #     # # #   # # #
 # # ####### # # # ##### ##### # # ##### ### ### # # ### # # ### # # # # ##### ##### # ### # ### # ### ########### # # # ### # #
 #   #         #   #   # #   # #   #     #     # #   #   # # #   #   # #   #   #     #   # #     # # #         #   # #   # #   #
 ################# # # ### # ####### ##### ##### ### # ### # # ####### ##### ### ####### # ####### # ######### # ### ##### ### #
 # #             #   #     # #     # #     #     # # # #   # #   #   #   #   # # #     # # #           #     # #   #     #   # #
 # # ########### # ######### # ### # ##### # ##### # # # ### ### # # ### # ### # ##### # # # ##### # # # ### # ### ##### # # # #
   #   # #             # #   # #   #     # #       # # #   # # # # # #   #           #   #   #   # # #   #   #     # #   # # # #
 ##### # # ########### # # # # # ####### # ######### ##### # # # # # ######### ##### ######### # ### ############### # ##### # #
     # #     #   #     #   # # # #   #   #       #   #     # #   # #   #   #   #   # #   #     #   #                 # # #   # #
###### # ##### # ############# # ### # ####### # # ### ##### ##### ### # # # ### # # # # # ####### ####### ########### # # ### #
     # # #     # #   #   #     #               #   # # #   #       # #   # #   # # # # #   #   #   #     # #     #     # # #   #
 ### ### # ####### # # # # ######### ####### ##### # # # # ######### ##### ### # # # # ####### # ### ### # # ##### ##### # ### #
 # # #   #         # # # # # #     # #     # #   #   # # #   #     #   #       # # # #     #   #   # # # #   #   #     #   #   #
 # # # ############# # ### # # ##### # ### ### # ### # ##### # # ### ### ####### # # ##### # ####### # # ##### # ##### # ### # #
 #   #         #   # #     # #     # #   #     #     #       # # #   #   #   #   # # #   # # #     #   #     # # #   # #     # #
 # ########### # ### ####### ##### # ### ########### ######### # # ### ### # # ### # # # # # # ### ### ##### # # # # # ####### #
 #         #   #   #   #         #     # #     #               # #     #   # # # # # # #   # #   # # #     #   # # #   #     # #
 ######### # # ### ### ### # ### ### # # # ##### # # ########### ### ### ### # # # # # ##### ### # # ##### ##### # ##### # # # #
 #     #   # #   #   #   # # #       # #   # #   # #     #       #   #   # #   # # #         #   #   #   #   # # #   #   # #   #
 ### ### ####### ### ### # # # # ### # ##### # ########### ####### ### ### ##### # # ####### # ####### ##### # # ### ##### #####
   # #   #       # # # #   # # # #   # #   # #   #       #     #   #   #   #     # # #     # #       #   # #   #   #   #   #   #
## # # ### ##### # # # ### # # # ### # ### # ##### ##### ##### # ### ### # ### # # ### ### # ####### ### # ### ### ### # # ### #
   #   #   #   # # #   #   # # #   # #     # #     #   #   #   # #   #   #     # #   #   # # # #     # #   #   #   # # # # #   #
 ### ##### # ### # ### # # # # ### # ####### # ##### ##### # ### # ### ######### ### ##### # # # ##### # ### ### ### # # ### ###
 #         #   #     #   # # # #   #         #   # #   #   #     # #     #         #       #   # #     # #   # #   # # #   #   #
 ############# ##### ##### # # # ####### ##### # # # # # ####### # ####### ####### ######### ### # ##### # ### ### # # ### ### #
     #   #         #       # # #       # #   # # #   #   # #   # # #     #       #           #   #       #     # #   #   #   # #
 ### ### ### ### # ####### # ######### ### # ### # ####### # # # # # ### # ##### # ######### # ##### ######### # ####### # ### #
   #   #   #   # #   #     #     #     #   #     #       # # # # #   #   #     # # #     #   #     # #   #     #     #   # #   #
## ### ### ### # ### # # # ####### ##### ############### # # # # ##### ####### # # # ### # ####### # # # # ##### ### # ### # ###
   # #   #   # # #     # # #   #   #   # # #           # #   # # #   #   # #   # # # #   #     #   #   # #       # #   #     # #
 ### ### ### ### ####### # # # # # # # # # # ######### # ##### ### # ### # # ### # # ########### ##### # ######### ##### # ### #
     #     #   #     #   # # # # # # # # #   # #   #   # #   #   # #     #   # # #   #     #   #     # # #   #   # #     #     #
###### # ##### ##### # ### # # # ### ### # ### # # # ### # # ### # ####### ### # ### # ### # # ##### # ### # # # # ##### # # # #
       #     #     # #   #   # # #   #   # #   # #   #   # # #   # #   # #     #   # # # #   #       # #   #   #   #   # # # # #
 ##### ########### ##### ####### # ### ### # ### ### # ##### # ### ### # # ####### # # # ############# # ########### # ### # ###
 #     #   #     #   # #   #     # #   #     #   #   # #   # #   #   #   # #       # #   #           # # #         # # #   #   #
 # # ### # # ### ### # ### # ##### # ### ### # ####### ### # ### ### ### # # ####### ### ### ##### # # # # ### ### # # # ##### #
 # #   # #   # #   # # #   #   #   # #     # #   #                 #   # # # #         # #   #   # #   # #   # # #   #   #     #
 ####### ##### # ### # # # ### # ### # ### ##### # ##### ######### ### # # # ####### ### # ### # # ##### ##### # ########### # #
     #   #     # #   #   #   # #   # #   #   #   # #   # #       #         #   #   # #   #     # #     #     # # #   #       # #
#### # ### ##### # ####### ### ### # ### ### ##### # # ### ##### ####### ##### # # ### ####### # ########### # # # # ### ##### #
   # # # #   # #   # #   #   #     # #   #   #   # # #     #     #     #     #   #   #       # #         # #   #   #   #   #   #
 # # # # ### # ##### # ### # ####### # ####### # # # ####### ##### ### # ##### ##### ####### # ####### # # ########### ### # # #
 # #   # #   #   # # #   # #   # #   #   #   # #   # #     # #     # # # #   #     # #   #   #       # #   #     #     #   # # #
 # ##### # ##### # # ### ### # # # ### # # # # ##### # ### ### ##### # ### # # # ### ### # ######### # ##### ### # ##### ##### #
 # # #         #   # # #     # # # #   #   # #     # # # # #       # #     # # #   #     # # #       # #   # # #   #   # # #   #
 # # # ####### ### # # ####### # # ### ########### # # # # # ####### ##### # ##### ####### # # ######### # # # ##### # # # # ###
 #   # #     #     # #       #   #   #             # #   # # #     #     # #   # #     #   # # #   #     # # #       #   # #   #
 ##### # ### ##### # ##### # # ##### ##### # ##### # ### # # # ### ##### ##### # ##### # ### # # # # ##### # ### # ####### # # #
 #     # #       # #       # #   #   #     #   #   #   # # # # # #   #         #       # #       #       # # #   #       # # # #
 # ##### ####### # ######### # # # ##### # ##### # ### # ### # # ### ########### ####### ##### ######### ### ########### # # # #
 #     #       #           #   # #   #   #   #   #         # #     # #     #   # #     #     # #   #       #             # # # #
 ##### ####### ### ##### # ### ##### # ### # # ####### ### # ##### # # ### # ### # ### ##### ### # ####### ############### ### #
     #   #     #   #     #     #     # #   # #   #   # #   #     # # # #   #     # #   #   #     #       #               #     #
#### ### # ######### ####### ### ##### ##### ##### # # # # ##### # # # # ######### # ### # ############# # # ######### # ##### #
     #   # #   #   #   #     #   #       #     #   #   # #     # # # # # #         #   # #         #       #   # #     #       #
 ##### # # ### # # ### ##### # ######### # # # # ##### # # ### # # ### # # ########### # ########### # ##### # # # ### ##### # #
 #     # #     # #   #   # # #       #   # # # # #     # #   #         # # #     #     #     #   #   # #   # #   #   # #     # #
 # # ####### ### ### ### # # ####### ##### ### # ### ### ####### ##### ### # ### ########### # # # ### # # # ####### # # ##### #
   # #     #   #   # #   #     #   #   #     # #   #   # #   #   #   #   #   # #       #   #   #   #   # # #       # # #     # #
#### # ### ####### # # ##### # # ##### ##### # ### ##### # # # ### # ### ##### ####### ### ######### ### # ### ##### ####### ###
 #   #   #         #   #   # #   #     #     #   # #     # # # #   #             #   # #     #     #   # #   #   #   #     #   #
 # # ### ############### ### ##### ##### ### ##### # ##### ### # ####### ##### # # # # # # # # ### ### # ### ### # ### ### ### #
   #   #   #   #       #     #     #       # #     #   # #     #       # #   # #   #     # #   # #     # # #   # # # # #   #   #
 ##### ### # # ##### # # ##### ##### # ### # # ### ### # ############# # # # ######### ### ##### ### ### # ### ### # # ##### ###
 #   #   #   # #   # #   #     #     # #   # # #   # # #   #     #     # # # #       # #   #       # #   #   #   # # #       # #
 # # ### ##### # # # ##### ############# ### # ### # # ### # ### # ##### # # # ##### # # ######### # # ##### ### # # ######### #
 # #     #     # #   #   #       #       #   #   #   #     # #   # #   # # #   #   # # # #     #     # #       # # #         # #
## ####### # ######### # ### ### # ####### ##### ########### # ### # # ### ####### # # # # ### ####### # ### # ### # ##### # # #
   #   #   # #         #   # #   # #       #   #       #     # #   # #   # #       # # #     #     #   # #   #     #   #   #   #
 # # ### ##### ########### ### ### # ### ### ########### ##### ##### ### # # ####### # ########### # ##### ######### # #########
 # #   # # #   #   #       #   #   #   # # #   #         #     #   # #   # # #       #   #       # #     # #       # #     #   #
 ##### # # # ##### # ####### ### # ##### # ### # ######### ##### # # # ### # # ####### ### ##### # ##### # # ##### # ##### # # #
 #     #   # #   # #         #   # #   #   #   #   #     # #   # #   #   # # # #     # #   #   # #     #   #     # #     #   # #
 # ######### ### # ########### # ### # ##### ##### # ### # # # # ####### # # # # ### ### ### ### ##### ######### # ##### ##### #
           #     #             #     #           #   #   #   #   #         #     #       #                       #       #     #
