################################################################################################################################
# #   #     #         #     #   #           #           #   #           #     #   #       #     #         #     #               
# # # ##### # ####### # ### # # ### ####### # ########### # ##### ##### # # ### # # ### # ##### # ### ##### ### # ######### ####
# # # #   # # # #   # #   #   #   #   #   # #   #   #   # # #   # #   # # #     #     # # #     #   #     # # #   #   #   #     
# # ### # # # # # # # ### ####### ##### # # ### # # # # # # # # ### # # # ############# # # ##### # ##### # # ##### # ### ##### 
# #     # # # # # # #   #   #   # #     #         #   # # # # #     # #   #       #   # #   #     # #   # #       # #   #   #   
# ####### # # # # # # # ### # ### # ############# ##### # # ######### ### # ##### ### # # ### ### ### # ######### ##### # ### ##
#           # # # # # #   # #   # #   #         #     # # #         #     #   # #   #   #     # # #   #           #     # #   # 
# ########### # # # ####### ### # ### # ####### ##### ### ######### ##### ### # ### ##### ##### # # ############### ##### # # # 
# #   #   #   # # #   #     #   #     # #     # #   #   #       # #   # #   #   # #   #       #   #     #   #     # #     # # # 
# # ### # # ### # ### # ##### # # ##### # ### # # # ### ####### # ### # ### ### # ### # ############### # ### # ### # ##### ### 
# #   # #   # # # # # #   #   #   #     # #   #   # #   #   #   # #   #     #   #     # #               #     # #   #   # #   # 
# ### # ##### # # # # ### # ####### ##### # # ##### # ### # # ### # ####### # ########### ##################### # ##### # ### # 
#     # #       # # #     #   #   #     # # # #   # #   # # # #   # # #   #   #           #                     # #   #   # #   
# ##### # # ##### # ####### # ### ##### # # # # # # ### # ### # ### # # # # ### ####################### # ### ### # # ### # ####
# #     # # #     # #   #   #   #   # #   # # # # #     #   # # # # # # #   #   #                   #   #   # #   # #           
# # ####### # ### # # ### # ### ### # ##### ### # ### ##### # # # # # # # ### ### ####### ######### # # ### # # ######### # ### 
# #         # #   # #     #   #   #   #   #     #   # #     #   # # #   # #   #   #     #     #   # # #   # # #     #   # # # # 
# ### ####### ##### ######### ### ### # # ########### # ######### # ##### # ### ### ### # # ### # # # ##### # ##### # # ### # # 
#     #     #     # #       #   #   # # # #         # #     #     #     # #         #   # #     # # # #   # #     #   #   # #   
##### # ### ##### # # ##### # # ### # # ### ####### # ### ### ######### # # ######### ### ######### ### # ##### # ####### # ### 
#     # #   #   #   # #   #   #   #   #   # #         #   #           # #   #   #   # #   #       # #   #     # #   #     # #   
# ### # # ##### ##### # # ##### # ####### # ### ##### # ### ######### # # ### # ### # # ### ##### # # ####### ### # # ####### # 
# # # # # #           # # # #   #         # #   #   #             #   # #     # #   # #   #     #   #     # #     # # #       # 
# # # # # ######### ### # # # # # # ####### # ### # # ####### ### ##### # ##### # ### # # ##### ######### # ####### # # ####### 
#   # # # #       # #   # #   # # #   #     # #   # # #     # #   #     # #     #     # #     # #   #     #   # #   #   #   #   
##### # ### ##### # # ### ##### # # # # ####### ### ### ### # ##### ##### # ########### # # ### # ### ##### # # # ######### # ##
#   # #     #   #   #   #       # # # #   #     # #   # # # #     #     # # #   #   #   # #   # #     #     #               #   
### # ######### ####### ######### ### ##### ### # ### # # # ##### ##### # ### # # # # ### ### # ####### ################# ##### 
#   #     #     #     # #     #   #   #     #   #   #   # # #     #     # #   # # # #   #   # #   #   #     #       #   # #S    
# ####### # ### # ### # # ### ### # # # ########### ##### # # ### # ##### # ### # # ##### # ##### # # ####### ##### # # # # ####
#   #   # # # #   # #   # #   #   # # #   #         #   # #   #         # # #   # # #   # #     #   #   #   #   # #   # #   #   
# # # ### # # ##### ##### # ### ### ##### # ########### # ############# # # # ### ### # ##### # ####### # # ### # ##### # ### # 
# #   #   #   #   #     # # #   #       # # # #           #   #     # # # # #   #     # #     #     #   # # # #   #   # #   # # 
# ##### ####### # # ##### # # ### ##### # # # # ########### # # ### # # # # ### ####### # ##### ##### ##### # ##### ### ### # # 
# # #   #       # # #   # # # #   # #   #   #     # #       # # #   # # # #   # #   #   # #   #     # #     # # #       # # # # 
# # # ########### # # # # ### # # # # ####### ### # # ####### # # ### # # ### # # # # ##### # ##### # # ##### # # ####### # ### 
#   #             #   # # #   # #   #   #       #   #     # # # #   #     #   #   #   #   # #   # # #   #       #     #   # #   
### ####### ##### ##### # # ### ####### # ### # ######### # # # ### ##### # ########### # # ### # # ##### ########### # ### # ##
#           #     #   # # # #   #   # #   #   #       #   # # # # #     # # # #         # #   # #           #     #   #   # #   
# ##### ### # ### # # # # # # ##### # ##### ##### ### ##### # # # ##### # # # # ############# # ### ##### # # ### # ##### # ### 
# #   # #   #   #   # # # # # #     #     # #   #   #         # #     #       #       # #     #   #   #   # #   # #     #   #   
### # # # ##### ##### # # # # # ####### ### # # # # ########### # ####### ##### ##### # # ####### ### # ### ##### ##### # ##### 
#   # # #     #   # # # # # # # #     # #   # # # # #           #     #   #     #   #   #   # #   #   #   # #   # #   # #   #   
# ### # ##### ### # # # # # # # # # # # # ### # ### # ############### # ### ##### # ####### # # ######### # # # # # # # ### # # 
# # # # #   #   #   # # #   # # # # #   #     #   # #   # #     #   # #   # #   # #   #     # # #     #   #   #   # # #   #   # 
# # # ### # # ####### # ##### # # # ############# # ### # # ### # # # ### # # ### ### # ##### # ##### # ########### # ### ##### 
# # #   # # # #               # # #       #       #   #   #   #   # #     # # #   #   # #   # #       #             # #   #     
# # ### # # ### ##### # ##### # # ##### # # ################# ##### ### ### # # ### ### ### # ######### ############# # ### ### 
# # # #   # #   #     #     # # # #     # #           #       #       #     # #   #   #   #   #       #             #   #   #   
# # # ##### # ####### ##### ### # ####### ########### # # ########### ##### # ### ### ### # ####### # # # ### ################# 
# # #   #   #   #   #   # #   #   #   # # #   #     # # # #       # #     #     #   #     #         # # #   #     #   #         
# # # ### ### # # # # # # ### ### # # # # # ### ### # # # # ##### # ##### ##### ### ################# # # # ##### # # ######### 
# # #     #   # # #   # # # #   # # # #   # #   # #   # # # #   # # #       # #   # #     #     #     # # # #     # #   #     # 
# # # ######### # ##### # # ### # # # ##### # ### ##### ### # # # # ####### # ### # # ### # ### ### ### # # # ##### ### ### # # 
# # # #         # #   #   # # #   # #       # #   #   #   #   # # #     # # #     #   #   #   #   #     # # #     # # #   # #   
# # # ### ####### # # # ### # ##### ######### # ### # ### ##### # ##### # # # ######### ######### ####### # # ### # # ### # ####
#   #     # #     # #         #     #         # #   #   # #     #     # # # #     # #       #     #   # # # # # #   #   # # #   
########### # ##### ### ####### ##### ####### # # ##### # # ##### ### # # # # ### # # ####### ##### # # # # # # ####### # # # # 
#     #   #   # #   #   #   #   #     # #   # # #   #   #   #     #   # #   #   #   # #     #   #   # #   # # #   #   #   #   # 
# ##### # ##### # ### ### # # ####### # # # # # ### # ####### ######### # ##### ##### # ### ### # ### ##### # ### # # ######### 
# #   # #   # # #   # #   # # #     #   # #   #   # # #     #           #     #     # #   # #   # #   #   # #     # #           
# # # # ### # # ### # ##### # # ### ##### ##### # ### # ##################### ##### # ### # # ### ##### # # # ##### # ### ######
#   #   # # #   #   #     # #   # #       # #   #     #           #   # #     #   # # #   # # # #       #   #       # #   #     
# ####### # # ### ### ### # ##### ######### # ######### ### ##### # # # # ##### # # # # ### # # ############# ####### # ### ### 
# # #   #   #   # # #   # # #     #         # #   #     # #     #   #   # #     #     # # # # # #     #   #   # #   # #   # # # 
# # # # ##### # # # # # # # # ### # ####### # ### # ##### ##### ######### ######### ### # # # # # ### # # # ### # # # # # # # # 
# # # # #     # # #   # # # #   #         #   #               # #   #   #         # #     #   #   #     #   # #   #   # # #   # 
# # # # # # ##### ##### # # # # ######### ##### # ########### # # # # # ######### # # ##### ####### ######### ######### # ##### 
#     #   #   #   #     # #   # #       #     # # #       #   #   # # #     #             # #   #   #     #       #     #       
# ####### ### # ####### # # ##### ##### # # # ### # ##### ########### ##### # ######### # ### # ##### ### ##### # # # ##########
# #     # #   #   #   # #   #         # # # #     # #   # #           #   # # #       # # #   #     #   #   #   # # #         # 
# # ### ### ##### # # ####### ####### # # # ####### # # # # ############# # ### ##### # # # ####### # ##### # ### # ### ### # # 
# # # #   # #   #   #     #   #     # # # #   #     # # # #   #   #       #     #   #   # #     # # # #     #   # #   #   # #   
# # # ### # # # ######### # ### ### ### # ##### ##### ### ### # # # ############# # # ######### # # # # ####### # # ##### # ####
# #   #   # # # #     # #     # # # #   # #     # #   #   #   # # # #     #   # # #   #     #   # # # #   #     # # #     #     
# ##### ##### # # ### # ####### # # # ### # ##### # ### ### ##### # # ### # # # # ### # ### # ### # # ### # # ### # # ######### 
# #   # #     # #   #     #   # # #   #     #     #     # #     # #   #   # # # # #   #   # # #   #   #   # #   #   #     #     
# # # # # ##### ### # ##### # # # ##### # ### ########### ##### # ##### # # # # # ### ### # # ### ##### ################# # ####
#   # # #   #     # # #   # #   #       # #             # #   # #     # # # #   #   #   # #           #         #   # #   #   # 
##### # ### ##### # # # # # ##### # ### # # ######### # # # ### ##### ### # ####### ### # ########### ##### ### # # # # ### # # 
#   # #   #     # # #   # #     # # #   #   #       # # # # #   #   #   #   #   #   #       #       # #   #   #   # #   # # #   
### # ### ##### # ##### ####### # # ############# ### ### # # ##### ### # ##### # ####### ### ##### ### # # ####### ##### # ####
#   # # #   #   #   #   #     # # # #             #   #   #   # #   # # #     # #     #   #   #   #   # # #     #   # #   #     
# ### # ### # ##### # # # ##### # # # ##### # ##### ### ####### # ### # ##### # ##### ##### ### # ### # # # ##### ### # ### ### 
# # # #   # # #   #   # #       # #   #   # #     # #   #     #   #   # # #   # #     #     #   #   #   # #   #   #   #   # #   
# # # # ### # ### ##### ######### ##### ### # ### # # ####### # ### ### # # ### # ##### ##### ##### ##### ### # ### # ### # ### 
#       #   #   #       #         #     #   #   # # # # #     #     #   #       # #   #     # #   #   # # # # # #   #   # #   # 
####### # ##### # ####### ####### # ##### ### # # # # # # ##### ##### ######### # # # ##### # # # ### # # # # # # ####### ### # 
#   #   #       #   #       #   #   #     #   # # #   #       #     # #     # # #   #   # # #   #   # #   #   # #   #   #   # # 
# # # # ########### ####### # # ##### ####### # ####### ##### # ### # ### # # # ####### # # ##### ### # ### ### ### # # ### # # 
# #   #           # #     #   #   #   #   #   #             # # # # #   # # # # # #   # # #     # #   #   # #   # #   #   #   # 
################# # # ### ##### # # ### # # # ### ######### # # # # ### ### # # # # # # # ##### # # ##### # # ### ####### ##### 
#             #   # # #   #   # # # # # # # #   # #     #   #     #   # #   #   #   # # #   # #   # #   # # # #     #     #     
# # ######### # ### # # ### ### ### # # # # # ### # ### # ######### # # # ### ####### # ### # ##### ### # ### # ##### ##### # # 
# # #     # # # # # # #   #     #   #   # # #   #   #   #   # #     # # # #           #   # #   # # #   #     # #     #     # # 
# # # ### # # # # # # ### ### ### ### ##### ### ##### ##### # # # ##### # ########### ### # ### # # # ######### # ########### # 
# #   #   #   # # #   #   #   #   #   #     #       #   #   #   # #     #       # #   # #   #     # # #   #   #   #     #   # # 
# ##### ####### # ##### ### ### ### ### ##### ### # ### # ####### # ########### # # ### ##### ### # # # # ### # ####### # # # # 
# #   #         # #   # #     # #   #   #       # #   # #   #   # #   #   # #   # #             # # # # #   # #   #   #   #   # 
# # # ########### # # # ####### # ### ##### # # # ### # ##### # ##### # # # # ### # ####### ### # # # ##### # ### # # ######### 
#   # #   # #     # # #         # #   # #   # # # # # # #     # #     # #   # #     #     # #   # # #     #     #   #           
##### ### # # ##### ############# # ### # ### # # # # # # ##### # ######### # ### ### ### # ### ### ##### ##### ############### 
#   #   #   # # #   #             # # #   #   # #   # #   #   # # #   #     #   #     #   #   # #   #                   #     # 
# ##### # ### # # ### ### ######### # ##### ### ##### ####### # # # # # ####### # ##### ### # ### ### ####### ##### ##### ### # 
# #   # # #   # # # #   # #   #     #       #   #       #     # #   # #               #   # # #   #   #   #   #   # #   # #   # 
# # ### # # ### # # ### # # # # ####### # ### ### ##### # ##### ##### ######### ######### ### # ### ### # ##### # # # # # # ### 
# # #                 # # # # # #     # # #   # #   #   # #   #     #         # #     # #   # # #   #   #       # #   #   #   # 
# # # ############### # ### # # ##### # # # ### ### # ### ### ### # ######### # # ### # # # # # ### # ########### ########### # 
#   # # #       #     #   # #   #     # # #   #     #         # # #       #   # #   # # # # # #   # # #   #   #   #     #   #   
# ### # # ##### # ####### # ##### ##### ##### ####### ####### # # # ####### ### # ### # ### # ### # # ### # # # ### ### ### ### 
#       #     # # #   # # #       # #       #       #   #   #   # # #     #   #   #   #   # # #   # #   #   # #     # #   #     
# ########### # ### # # # ######### # # ### ####### ##### # # ### ### ### ### # ### ##### # # # ### ### # ### ####### ### ##### 
#         # # # #   # # #   #     #   #   # #     #       # #   #     # # #   #   #     #   # #   # #   # # #           #     # 
# ####### # # # # ### # ### # ### ####### # # ### ######### ### ####### # # ### # ##### ##### ### ### ### # # # ############# ##
# #       #   # # # # #   #   # #         # #   #         #   #   #     #   # # #   #   #   #   #     # #   # #   #     #   #   
# # ########### # # # # # ##### ####### ### ### ##### # # ### ### # ### ##### # ### ##### # ########### ### # ##### ### # # ### 
# #             #   #   # #             #   #   #   # # #   # #   #G# #   #     # #       # #     #     # # #     #   #   #     
# ####### ############### # ### ### ##### ### ### # # # ### # ##### # ### # ##### ######### # ### ##### # # ##### ### ######### 
#       #     #   #       # #   #   #   #   #   # #   # #   #     #   # #   #     #   #     # #       # # #   # #   # #     #   
# ##### # ### # ### ####### # # # ##### ### ### # ####### ####### ### # ##### # # ### # ##### ####### # # ### # ### # # ### ####
#   #   #   # #   #       # # # #       # #   # #       # #     #     #       # # #   # #   #     #   #     # #     #   # #     
### ####### ##### ####### # # # ######### ### # ####### # # ### ####### ####### # # ### ### ##### # ### ##### ########### ##### 
#   #     #     #     #   # # #     #   #   #   #     # # #   #             # # #   # #   #       # #   #   #   #         #     
# ### ### ########### # ### # ##### # # # ####### # # # ### ########### ### # # # ### ### ######### # ### # ### # ######### ### 
#   # #   #         # # #   # #   #   #   #       # # #     #     #     #   #   #     #     #     # # #   #   # #     #     #   
### # ##### ######### # # # # # # ######### ### # # ######### ##### ##### ########### # ##### # ### # # ### ### ##### ##### # ##
#                         # #   #           #   # #         #       #     #           #       #           #         #       #   
