################################################################################################################################
#   #             #       #             #       #       # #   #   #   #         #   #   # #         #     #       # #           
# # ######### ##### ##### # # # ##### # # # # # ### ### # # ### # ### # # # ### ### # # # # ####### # # # # ##### # # ### ######
# # #     # # #     #   # # # #     # #   # # #   # #   #       #     # # #   #     # # #         # # # # #     # # # #   #     
# # # ### # # # ##### # # # # ##### # ##### # ### # # ####### ######### # ### ####### # ######### # # # ######### # # # ### ### 
# #   #   # # # #   # #   # # # #   #   #   #   #   #       #   #       #   # # #     #       # # #   # #         # # #     #   
# ##### ### # # # # # ##### # # # ##### # # ### ########### ### # ######### # # # ########### # # ##### # ######### # ##########
# #     #   # # # # #   #   # # #   # # # # # #   #     #         #   #     #   #   #         # #   # # #   #     #     #       
### ##### ### # ### ### ### # # ### # # # # # ### ### # # ######### # ######### ### # ######### ### # # ### # ### ##### # ##### 
#       #     #     # #     #   # #   # # #     #   # #   # #       #     #   # #   #   #   #       #   #   #   #     #   #   # 
# ##### # ########### ### ##### # ##### # ######### ### ### # ########### # # ### ##### # ### ########### ##### ##### ##### # # 
#     #     #       #     #   # # #   # #         #   # #   # #         #   #     #     #   #               #   #   #     # # # 
# ### ##### # ##### # ### # # # # # # ########### ### # ### # # ####### ####### ### ####### ##### ######### # ### # ##### ### # 
#   #   #   #     #   #   # # #   # #           #   # #   # # #   #   # #     #   # # #   #       #       #   #   # #   #   #   
# ##### ######### ##### # # # ##### ########### # # # ### # # ### # # # # ### ##### # # # ####### # ##### # ### ### ### ### ### 
#     #         # #     # # # #   # #     #   #   # #   #   #   # # # # # #   #   # # # #   #     #   # # # #   #     #   #   # 
# ### ######### # ### ### # ### # ### ### # # ############# ### # # # ### # ### # # # # ### ### ##### # # # # ####### ### ### # 
# # #         # #   #   # #     # #   # #   # #             #   #   #   # #     #   #   # #   # #     #   # #     # # #   #   # 
# # ######### ##### ##### ####### # ### ##### # ######### ### ######### # ############### ### ### ##### ######### # # ### # ### 
# #   #       #   # #           # #   # #   # #     #   #         #     #   #     #   #   # #     #   # # #     #   #   #   #   
# # ### ####### ### # ### ##### # ### # ### # ####### # # ######### ####### ##### ### # ### ####### # # # # ### ####### # ### # 
#     #     # #   # # #   #     # #   #   # #     #   # #   #     #         #   # #   #           # #   #   # #   #   # #   # # 
# ### ##### # ### # # # ### ### # # ##### # ##### # ### # # # ### ########### # # # ### ####### ### ##### ### ### # # # ### # # 
#   #   # #     #   # # #     # #   #   #       # #   # # #   # # #       #   # # #   # #   #   #   #       #   # # #   # # # # 
# # ### # ########### # ##### ######### ##### # # ##### # ##### # ####### # ### # ### # # # # ### ### ### # ### # # ##### # # # 
# #   #   #   #     # #     # #   #     #     # #   #         # #     #   # #   #   #   # # # #   #   #   #   #   #       #   # 
# ### ##### # # ### # # ### ### # # ##### ##### ### # ####### # # ### # ##### ##### ##### # # # ### ######### ##### ##### ##### 
# # # #     # # # #   #   #     # #G      # #   # #       #   # #   # #   #         #   # # #       #   #   # #         #       
# # # # ####### # ##### ##### ### ######### # ### ####### ##### ##### ### # ##### ### # ### # ####### # # ### # # ### # ########
# #   # #     #   #     #   # #   #       #   # # #     #     # #     #     #   #   # #         #   # # #   #   #   # #         
# ##### ### # ##### ##### # ### ##### ##### ### # # ### ##### # # ##### ##### # ### # # ####### # # # # ### ####### # ######### 
# #   #     #       #     #     #     #     # #   # #   #     #   #           # #   # # #     # # #   #   #   #     # #       # 
# # # ####### ##### # ##### ######### # ##### # ### # ### ########### ######### # ##### # ### ### ####### ### # ####### ##### # 
#   #         #     # #   # #   #   #   #       #   #   #   #         #     #   #       # #   #   #     #   #   #     # #   #   
# ####### ### # ##### # # ### # # # ### # ####### ##### # # ######### # ### ##### ####### # ### ### ####### ####### # # # ##### 
# #     #   # #     # # #   # # # #   # #     #   # #   # # #         #   #     #     #   #   # #         #     #   #   #     # 
### ### ### # ##### # # ### # # # ### # ##### # ### # ##### # ####### ### ##### # ##### ##### # ##### ######### # ########### # 
#   # #     #   #   # #   #   # #   # # #     # # #   #     #     #     #   #   #   #     #   #     # #   #   # #   #   #   #   
# ### ### ####### # # ### ##### ### # # # ##### # ##### ##### ### # ####### ##### # # ##### # ##### # # # # # # # # # # # # ### 
#     #   #       # #   #     #   # # #   #     #     #   #     # # #     #   # # # # # #   #     #   # #   #   # # # #   # #   
####### # # ####### ### ##### ### ### ### # ##### ### ### ####### # # ### ### # # # # # # ########### # ### ##### # # ##### ### 
#   #   # #   #     #     #   # #   #     # #     # #   # #     # #   #   #   # # # #   #   #         #   # #   # # # #     #   
# # # ####### ##### # ##### ### ### ##### # # ##### ### # # ### ### ### ### ### # # ### ### # ########### # # # ### # # ##### # 
# # # #       #     # #     #     #     # #   # #     #   # # #     #   #   # #   # # # # # #   #       # # # # #   # #       # 
# # # # ####### ##### # ##### # ####### # ##### # ### ##### # ##### ##### ### ### # # # # # ### # ##### # ### # # ### ######### 
# # # #     #       # # #   # #       # #     # # #   #     # #     #     #       #   # # #     # #   # #     # #   # #   #     
# ### ##### # ####### # # # # ### ##### ##### # # # ######### # ##### ##### ##### ##### # ####### # # # ####### # # ### # ######
#     #   # # #       #   # #   # #     #     #   # #   #     # #   #   # # #     #             # # # # #     # # # #   #   #   
####### # # ### # ######### ### ### ##### ######### # # ### ### # # ### # # # ##### ######### # # # # ### ### # ### # ##### # # 
#     # #   #   # #         #   #   #   # #   #   #   #   #       #   # #   #     # #       # #   # #   # # #   #   #   # #   # 
# ### # ### # ##### ######### ### ### # # ### # ######### ##### ####### ##### ##### # ##### # ##### ### # # ##### # ### # ##### 
# # # # #   #     # #         #   #   # #               #     #         #     #   # #   # # #   #   # #   #   #   # #   #     # 
# # # # ### ##### # # ##### ### ### ### ### # ##### ### ##### ### ############# # # ### # # ##### ### ####### # # ### ### ##### 
# #   # #       #   #     # #   #   #   #   #   #   #   #   #   # #             #   # # # #   #   #       #     #   # #   #   # 
# # ### # ### ########### # # ### ### ### ##### # ##### ### ### # # ################# # # ### # ### ##### ######### # ### # # # 
# #     #   # #           # #     # # #       # #     #     #   # #     # #   #     #   #   # # #       #           # #   # #   
# ######### # # # ################# # # ####### ##### ##### # ### ##### # # # # ### ####### # # # ##### ########### # # # ######
# #   #     # # #       #       #   # # #   #   #   # #   #       #     # # # # #   #     # # # #   # # #   #       #   #   #   
# ### # ####### ####### # ####### ### # ### # # # # ### # ####### # ##### # ### # ### ### # # # ### # # ### # ##### ####### # # 
# #   #     #   #     #   # #     #   #     # # # #     # #   # # #     #       # #     # # #   #   # #   #   # #   #       # # 
# # ### ### # ####### ##### # ####### ####### # # ####### # # # # ##### # ##### ### ##### # ##### ### ### ##### # # # ####### # 
#   # #   #   #       #   # #       # #       # #     #   # # #           #   # #   #     #   #   #   # # #   #   # #   #   # # 
##### # # ##### # ##### # # ####### # # ####### ##### # ### # ######### ### # # # ### ####### # # # ### # # # ######### # # # # 
#   #   #       # #     #   #   #   # #       #   #   #   # #   #       #   # # # # # #   # #   #   #   # # #           # # # # 
# # ##### ##### ### ####### # # # ### ##### # # ### ##### ##### # ####### ### # # # # ### # ### ##### # # # ############# ### ##
# #       # #   #   #   # # # # #     #   # # # #   #   #   # # #     #   # #   #   # #   #     #     # # #   #   #     #   #   
# ######### # ### ##### # # # ######### # # # # # ### ##### # # # ##### ### # ##### # # ##### # # ##### # ### ### ##### ### ### 
#           #   #       #   # #   #   # # # # # #     #     # # # #   #   #   #   # #   #     #   #     #     #   #   #   #   # 
# ############# ######### ### # # # # # # # # ######### ##### # # # # ### # ### # # ####### ####### ########### ### # # # ### # 
#             #   #     # #   # #   #   # # #       #   #   #   # # # #   # # # # #   # #   #       #   #     #     # # #     # 
# ####### ### ### # ### # # ### ######### # ### # ### ### # # ### # # # ### # # # ### # # ### ####### # # ### ####### # ##### # 
# #       #     # # # #   # #   #   #   # #   # #   # #   # # #   # # # #     # #     # #   #       # # #   #       # #     # # 
# # ####### ##### # # ##### # ### # # ### ##### ### # ##### # ##### # # # ##### ####### # # ####### # # ### ####### # # ### # # 
# # #       #   # #     #   #     #   #   #   # # # #   #   #       # # # #     #       # #       # # #   #   #     #   #   # # 
# # ### ### ### # ##### ### ######### # ### # # # # ### # ########### ### # ########### ######### # ##### ##### ##### ######### 
# #   # #   #   #     #   # #       # # #   #   # # #   #           #   #             #           #     # # #   #         #     
##### # ##### ##### ##### # # # # # # # # ####### # # ### ######### ### ####### ##### ####### ##### ### # # # ### ####### # ####
#     #       # #   #     # # # # # # # # #         # #   #   #   #   # #     #     #   #     #   #   #   #   # #       #   #   
# ####### ##### # ### ##### # # # # # ### ########### # ##### # # # ### # ### ##### ### ####### # # # ##### ### ### ####### ### 
# #     # #     #     #   #   # # #       #   #       #   #     # # #   #   #   #     #   #     # # #   #   #       #     #     
# ##### # # ### ####### # ### ### ### ##### # # ######### # ####### # ######### # ####### # ##### # # # # ### ####### ### ######
#       # # # # #   #   #   # #   #   #     # #   #         #     # # #         #   #     #   #   # # #             #   #       
######### # # # # # ### ### ### ####### ##### ### # # ##### # ### # # # ########### # ####### ##### ######### ##### ### ####### 
#       # #   # # #     #     #       # #   #   #   #     #     # #   #             #       #   #           # #   #   # # #   # 
# ### # # ### # ############# ####### # # ##### # ####### ####### ##### ### # ### ############# # ######### # # ####### # # ### 
#   # #     # # #       #   #       # # # #       #     # #               # #   # #   #     #   #   #   #   #   #     # #   #   
# # # ####### # # ##### # # ####### ### # # ####### ### # # ######### ### # ### ### # # ### # ### # # ### ### ### ### # # ### ##
# # # #       # # #   #   #   #   # #   #   #   #   #   # # #         #   # # #     #   # #   #   # #     #     # # #   # #   # 
### # # ####### # # # ####### ### # # ### ### ### ### ### # ### # ##### ### # ########### ####### # ######### ### # ##### # ### 
#   # #   #   # # # #     #   #   #   #   #   #   # #   # #   # #   # # #   #                   # # #     #   #   #       # #   
# ### ### # # # # # ####### ### ####### ### ### ### ### # ### ##### # # # ######### ##### # ### ### # ### # ### ######### # ### 
#   # #   # # # # #     #   #       #   #     #     # # #   #     # # # #         # #   # #   # #   # #   # # # #         # #   
# # # # ##### # # ##### # ### ####### ### ######### # # ### ##### # # # # ####### ### # ##### # # ### # ### # # ######### # # ##
# # #   #   # #   #   #   #   #   #   #   #       #   # #   #     # #   #       # #   #       #   #   #   #   #         #   #   
# # ####### # ##### ####### # # # # ### ### # ####### # # ######### ############# # ############### ##### ############# ### ### 
# #     #   # #             #   #   #   #   #       # # # #   #   #           #   # #             #   # #             #   # #   
# ##### # ### # ######### ##### ##### # # ######### # # # # # ### ########### # ##### ########### ### # ####### ##### ### # # ##
#     # # #       #     #     #       #   # #   #   # # #   #   # #       #   # #     #       #   #   #   #   # #   #   # # #   
### # # # # ####### ### # ### ### ######### # ### # # # ####### # # ##### # ### # ##### ##### # ### ##### # ### # # ### # # ### 
#   # #   #     #   # # #   #   #           #     # # #   #     # #   #   # #   # #   # #     #     #   # #   #   # #   # # #   
# ### ######### # ### # ####### # ######### ####### # ### # ##### ### ##### # # # ### # # ############# # ### ##### ##### # # # 
# #           # #   #           #         #   #   # # #   # #   # # # #     # #   #   # # #       #   # # #       #     # #   # 
# ### # ### ### ### ######### ########### ##### # # # ##### # # # # # # ##### ##### ### ### ##### ### # # # ##### ##### ####### 
#   # #   #       #       #   #       #   #   # # # #   #   # # #   # #     #             #     #   # # #   #   #     #   #   # 
### # ### ############### ##### ##### ##### # # # ##### # # ### ### # ### # ##### # ##### ##### ### # # ##### # ##### ### # # # 
#   # # #               #   #   #   #       #   #       # #   #     #   # #   #   # #       #   # # # #       # #     #   # #   
# ### # ############### ### # ### ####################### ### # ####### # ### # ##### ####### ### # # ######### # ##### ### ####
#   #   #       #     # #   # #   #           #         #   # # #     # # # # #     #     #   # # # # #       #   #   # #   #   
### # ### ####### ### # # ### # ### ##### # # # ####### ### # # # # ### # # # # ### ##### # ### # # # # ##### # ### # # # ### # 
#   #       #     #   # # #   #   # #   # # #   #     # #   # # # # #   #   # # #   #   # # #   #   #   # #   # #   # #   # # # 
# ######### # ##### ### ### ##### # # # # # # ##### ### ##### # # ### ####### # # ### # # # ### ######### # ### # ### ##### # # 
#         # #   #   # # #   #   # #   # # # # #   # #   #   # # # #   #   #   # # # # # # #   #   #       # # #   #   #   #   # 
######### ##### # ### # # ### # # ##### # # ### # # # ### # # # # # ### # # ##### # # # # ### # ### # # ### # # ### ### # ##### 
#       # #     # #   # #   # # #       # #     # #       #   # # #     # # #     #   # #   # # #   # #   # # # # #   # #     # 
# ##### # # ##### # ### ### ### ######### ####### ############# # ####### # # # # ##### ### # # # ### ##### # # # ### ####### # 
# #   # # # # #   #   #     #   #         #     #       #   #   #   #   #   # # # #     #   # # # # #       # # #   #         # 
# # ### # # # # ##### ####### # ####### # # # ######### # # # # # ### ####### # ### ##### ### # # # ######### # # ############# 
# #     # # # # #         #   #        S#   #         #   # # #   #   #     # #   #   #       #               # #   #   #       
# ####### # # # # # ### # # ############# ################# # ##### ### ### # ### ### ### ##### ### ######### # ### ### ####### 
# #     # # # # # # #   #   #                   #   #     # #       #   #   #   #   #   #         #         #   # # #   #     # 
# # ### # # # # # # # ####### ####### ### ### # ### # ### # # ##### # ### ### # ### ### # ### # # # # ### # ##### # # ### ### # 
# # #   #   #   # # # #       #   #   #     # #     # #     # #   #   #   #   # #   # # # #   # # # #   # #           #   # #   
# # ############# ### # # # ### # # ####### # ####### ######### # # ### ### ##### # # # # ##### # ##### # ####### ### ##### ### 
# #   #   #     # #   # # #   # # # #       #   #   #   #   #   # # #   #   #     # # # #   #   #     # #   #   #   #     #     
# ### # # # ### ### ### ##### # # # # ####### # # # ### # # # ### # ##### ### ##### # # ### ##### ### # ##### # ### ##### # ####
# # # # #   # #     #     #   # # # #   #   # # # # # #   #   # # # #     #   #   #   # # # #   #   # #     # #   #     # # #   
# # # # ##### ########### # ### ### # # ### # ### # # ######### # # # ### # ### # ##### # # # # ##### ##### # ### ##### # # ### 
#       #                 #   #     # #     #     #           #   #   #   #     #       #   # #       #     #   #       #       
