################################################################################################################################
#         #       #   #   #   #   #         #                   #   #       #     #                   #   #   #           #     
# ### ### # ##### # # # # # # ### ### ##### # ####### ####### # ### # ##### # ### # ##### ### # ####### # # # ########### # ### 
# #   # #   #   # # # # #   # #   #   #     # #       #     # #     #   # # # # #   #     #   #     #   #   #           #   # # 
# # # # ##### # # ### # ##### # ### ### ##### ############# # # ####### # # # # ######### # ##### # # ################# ### # # 
# # # #     # # #     # # #   #     #                 #     # # #     # #   #   #   #     # #   # # #       #   #     #   # # # 
# # ####### ### # ##### # # ######### ############### # ##### # # ### # ######### # # ### # # # ### ####### ### # ### ### # # # 
# #       # #   # #     #   #       # #   #   #       #       # # #   # #         #   #   #   #   #       #   # # # #     # # # 
# ####### # # ### # ######### ##### # # # ### # ############### # # ### # # ### ####### ######### # # ####### # # # ####### # # 
# #   #   # # #   #         # #     #   #   #   #                 # #   # # #   #     #         # # # #     #   # #   #     #   
# # # # ### # # ########### # # ##### ##### ##### ### # ########### # ### # ##### ### ### ### ### # ### ####### # ### # ########
# # # #     #     #       # # # #     #     #     # # # #         # #   # #         #   #   #   # #       #   # #     #     #   
### # ########### # ### ### # # # ##### ##### # ### # # # ####### # ### # ##### ####### ### ### # ######### # # ########### # # 
#   #     #       #   #   #   # # #   # #     #     # # #   #     # #   # #   #   #     #   #   #   #   #   #   #     #   # # # 
# ####### # ##### ### ### ##### # # # # ##### ####### ##### # ##### # ##### # ##### ##### # # ##### # # # ####### ### # ### ### 
#     #   # # #   # # # #     # #   # #   #         #     # # #     #       #       #     # #     #   #   #     # # # #   #     
##### ##### # # ### # # ##### # ##### ### # ############# # # ####################### # ### ### ########### ### # # # # # ##### 
#     #     # #   # #     # # # #   # #   #   #           # # #       #   #           # #     #     #         # # # # # #       
# ##### ##### ### # ##### # # # # # # # # ##### ##### ##### # # ##### # # ####### # ### ##### ### # ##### ##### # # # # ########
# #     #       # #     # # # # # # # # # #   # #   # #     #   #   #   #     #   #   #   #   #   #       #   # #   # # #       
# ### # ### ##### ### # # # # # # # # # ### # # # # ### ######### # ######### # ######### # ### ########### # # ##### # ####### 
#   # # #   #     #   # #   #   # # # #     # # # # #   #     #   #   #   #   #   #     # #   #   #         # # #     #   # #   
### ### # ### ##### ### ### ##### # # ####### # # # # ####### # # ### # ### ##### # ### # ### ### # ######### ### ####### # # ##
# #     # #   #     # # # # #   # # #   #     #   # # #   #   # #   #     # #   # # # # # # #   #   #     # #     #   # # #   # 
# ####### # ### # ### # # # # # ### ### # ######### # # # # ####### # ### # # # # # # # # # # # ######### # ####### # # # ### # 
#   #   # # #   #   #     #   #   #   # # #     #   #   # # # #   # #   # # # #   # # #   # # #         # # #       #   #   #   
### # # # # ####### ##### ####### ### # # # ### # ####### # # # # ### # ### ####### # ##### # # ### # # # # # ##### # ##### ### 
#     #   # #       #   #   #   # # # # #     # #       #   #   #     # #   #     # # #   #   # #   # #   # # # #   #   #   #   
# ####### # # ####### # # # # ### # # # ##### # ##### ############### ### ### ### # # ### ####### ### ##### # # # ####### ### ##
#   #   #   #   #     #   #   #             # #     # #       #   #   #   #     # # #     #       #         # # #         #   # 
# # # # ### ### # ######### ### ########### ####### # # ##### ### # ### ####### # # ##### # # ######### # # # # ########### ### 
# # # #   #     #   #     #   # #   #   #   #       # # #   #   #     #       # #   #   #   #   #     # # #   #     #     # #   
### # ### ### ##### # ### # # # # # # # ##### ####### # # # ### ##### ####### # ##### # ### ### ##### # # ##### # # # # ### ### 
#   # # #   # #     # # #   #   # #   #   #   #   #   #   # # #     #       #   #     # #   #   #   # # #   #   # # # #   # #   
# ### # ### # # ##### # # ####### ####### ##### # # ####### # ##### ##### # ##### ##### # # # ### # # # ### # ### ### ### # # ##
#   # #   # # #     # # # #   #   # #     #   # # # #     #   #   #     # # #         #   # # #   #   #   # # # #     # #   #   
### # ### # ### ### # # # # # # ### # ##### # # # # # # ##### # ### ### # # ############### # # ######### # # # ####### ####### 
#   #     #   # #   # # # # # # #   #   #   # # # #   #   #   #   # #   # #   #   #   #   # # #           #   #   #     #     # 
# ########### ### # # # # # ### # ##### ### # # # ##### # # ##### ### ### ### # # # # ### # # ############# ### ### ### # ### # 
# #         #     # # #   #     #   # #     # # #     # # # #   #     #   # #   #   #   # # # #   #               #   # #   #   
# # ####### ######### # ########### # ####### # ##### ### # # # ####### ### ########### # # # # # # ##### # # ### ##### ####### 
# #     #   #     #   #     #     # #   #   # # # #   #   #   # #       #         #   # #   #   # # # #   # #   #     # # #     
# ##### ##### ### # ####### # ### # # # ### # # # # ### ####### ### ### # # ##### ### # ### ##### # # # # # ### ##### # # # ####
# #   #     # # # # #     # # #   # # # #   #   # #   # #   # #   # #   # # #     #   #   # #   # # # # # #   #     #   # #   # 
# # # ##### # # # # # ### # # # ### # # # # ##### ### ### # # ### ### ### # ### ### ##### # # # # # # # # ### # # # ##### ### # 
#   #     # # #   # # #   # # #   #   #   #       #   #   # #   #   #   # #   # # #   #   # # # # #   # #   # # # #     #     # 
# ####### # # # ##### # ### # ### ### ##### ####### ### ### # ##### ### # ### # # ### # ### # ### ##### ##### # # ##### # ##### 
#       # #   # #     # #   #   #     #   #     #   #     # #     #     # #   # #     # #     #   #     #     # # #   #   #   # 
# ####### ##### ### ### # ##### ### ### # # ### # ### ##### ##### ######### ### ### ### ####### ### ##### ##### # # # # ##### # 
# #     #     #   #   # #       #   #   # # # #   #   #     #   #   #       # #   #   #         #       # #     #   # #         
# # ### ##### ### ### # ######### # # ### # # ##### ######### # ### ### # ### ### ### ################### ########### # # # ### 
# #   #   # #   #     #     #     # #   # # #     #     #     # #   #   #   #       #   #     #           #   #     # # # # #   
# ### ### # ### ########### ##### # ### # # # # ####### ### ### # ### # ### ####### ### ##### # ########### # # ### # # # # ### 
#     # #   #   #       #   #     #   # # #   # #     #   # #   #     #   #       #   # #   # #     # #   # #   # # # # # #   # 
# ##### ##### ### ##### # ### ####### # # ##### # # ##### # # ######### ######### ### # # # # ##### # # # # ##### # # ### # # ##
#     #   # #   #     # # # # #       # # #   # # #   #   # #       #         #   #   # # #     #   # # #   #     #   #   # #   
# ##### # # ### ##### # # # # # ####### # # # # # ### # ### ####### # # ####### ### ### ##### ### ### # ######### ##### ####### 
#     # #   # #     # #   #   #   #     # # #   #   # # #   #   #   # # #   #   #   # # #     #   # #   #               #   #   
# ### # ##### ### # # ########### # ##### # ####### # # ##### # # ### # # # # ### ### # # ##### ### ##### ####### ### # # # ####
#   # #   #     # # #     #       # # #   #     #   # #     # #       # # #   # # #       #     #           #     #   #   #     
# # # ### # # # # # ##### ####### # # # ### ### # ### ##### ########### # ##### # # ### ### ##### # ### ##### ### # ########### 
# # # #   # # # # #     # #   #   # #     # #   #   #     #   #     #   # # #   # #   # #   #     # #   #     #   # #   #   #   
# # # # ### # ### # ### # # # # ### # ### # # ##### ######### # ### ##### # # # # # # ### ### ##### # ### ####### # ### ### # ##
# # #       # #   #   # #   # # #   # #     # #   #       #   #   #       #   # # # # #   # # #     #   # #       # #   #   #   
# # ########### ### # # ##### ### ##### # ##### # ####### # ##### ##### ####### # # ### ### # # ####### # # # # ### # ### ##### 
# #   #         #   # #     #     # #   # #     #   #     #   #   #     #     # #   #   #     # #   #   # # # # # #   #     #   
# ##### # ############### # ####### # ### # ######### ####### # # ####### ### # ### # ### ####### # ##### # ### # ##### ##### ##
#   #   # #           #   #   #     #   #   #     #   #         # #       # # #     # #   #       # #     #   # # #     #   # # 
### # ##### ######### # ### ### # ######### # ### # ####### ####### # ##### # # ##### ##### ####### # ####### # # # ##### # # # 
#   #   #   #         # #     # # #   #   #   #   #   #   # #     # # #     # #     #     # #         #       #         # # # # 
####### # ### ######### # ### # # # # # # ##### # ### # # # # ### # ### ##### ### ####### # ##################### # ### # # # # 
#       #   # #     #   #   # # #   # # #     # #   #   #   # # # #     #   # #   #     # # #                   # # # # # #   # 
# ######### # ### ### # ### # # ##### # ##### ##### ####### # # # ####### # # # ### ##### # # ################# ### # # # ##### 
#         # #   #     #   # # # #   # #     #           #   # # #         # #   #   #     #   # #   #   #     # #   #   # #   # 
######### # ### ######### # # # # # # ##### ########### # ### # ########### ### # ### ######### # # ### # ### # # ####### ### # 
#     # # # # # #       # # #   # # # #   #   #       #   #   #   #     # #   # # #   #         # #     #   #   #       #     # 
# ### # # # # # # ##### # # ##### # # # # ### ####### ### # ##### # ### # ### # # ### # ####### # ######### ########### ####### 
#   # # #   #   # #   #   #     # #   # #   #       #     #     # #   #     # # #     #       # #   # #   #   #       #         
### # # ######### # ####### ### # ##### # # ####### ########### # # # ##### # # ####### ##### # ### # # ##### # ##### # ##### # 
# # #             #   #   # #   #       # #       #           # # # # # #   # #   #   # #     #   #   # #     #   #   #   #   # 
# # # ####### # # ### # ### ############# ### ### ####### # # # # ### # # ### ### # ### ####### ### ### # ##### # # ##### # ####
# # # #       # # #   # #   #             #   #         # # # # #     #       # # #     #   #   #   #   #   # # # #   #   #     
# # # # ####### # # ### # ### ############# ####### ### # # # # ######### ##### # # ##### # # # # ### ##### # # # ### # ### ### 
#   # #   #   # # # # #   #   #           # #   #   #   # # # # #       #   # #         # # # #     #     # #   # #     #     # 
# ####### # # ### # # ### # ### ######### ### # # ####### # ### # ##### ### # # ######### # # ########### # ##### ############# 
# #     #   # #   # #     #     #   #   #   # # #   #     # #   #   #   #   # #   #     # # #     #   # # #     #   #       #   
# # ### ####### ### ### # ####### # # ##### # # ##### ####### # ### # ### ### ### # ### # # ##### # # # # ### # ### ####### # ##
# #   # #   #   # #     #       # # #     # # #   #   #       #   # #   #   #     #   # # #     # # # # #   # #   #       # #   
# ### # # # # ### ####### # # ### # ##### # # ### # ### ####### ### ### ### ### ##### # # ##### ### # # ### ### # ##### ### ### 
#   # #   #   #   #       # # #   # #   #   # #   # #   #     # #   #     #     #     #   #   #   # # #   #   # # #   #   #   # 
##### ######### # ### ### # ### ### ### ##### ##### # # # ### ### ####### ##### # ######### # ### # # ### ### ### ### ### ### # 
#     #   #   # # #   #   #     # #     #   # #     # # #   #   # #     # #   # #   #   #   #   #   #       # #   #     #     # 
# ### # # ### # # # # # ######### ####### ### # ##### # ####### # # ### # # ### ### # # ####### ########### # # ### ### ####### 
# #   # #     # #   # #               #     #   # #   # #       #   #   # #   # # # # #   # #         #   # #   #   #           
# ##### ####### ############### ### # # ### ##### # ##### ########### ### ### # # # ##### # # ##### # # # # ####### # ####### # 
# #   # #     #               # #   # # # #   #   #     # #           # #   #     #       #   #     # # # #         # #       # 
# # # # ##### # ##### ####### # ####### # ### # ####### # ####### ##### ### ##### ############# ##### # # ##### ##### # ####### 
#   #   #   # # #   #       # #   #     #   #   #       #         #       #     #     #         #       #       #     # #     # 
######### # # # # # ######### ### # ####### ##### ### ############# ### ####### ##### # # ####### ########### # # ##### # ##### 
#       # #   # # # #           #   #           #   # #   #       #   #       #     #   # # #     # #     #   # # #   # #       
####### # ##### # # # ####### ####### ##### ####### ### # # ### # ### ##### # ##### ##### # # # # # # ### # ### # # ### ####### 
#       #   #   # # # #           #       # #     #   # # #   # #     #   # #     #       #   # # # # # # # # # #   #   #       
# ##### ### ##### # # ######### # # ##### ### # ##### ### ### # ####### # # ################### # # # # # # # # ##### ######### 
# #   #   #       #   #       # # # #   #     #     #         # #     # # # #     #     #       #   # #   #   #   #   #     #   
# ### # ############### ##### # # # # # ######### ############### ### # ### # ### ### # # ##### ##### ########### # ### ### # ##
# #   # #   #           #   #   # # # # #       #   #           # #   #     # # #   # #   #         #       #     #     #   #   
# # ### # ### # # ### ### # ####### ### # ##### ### # ######### # # ####### # # ### # ##### ##### ######### # ### ####### ##### 
# # #   #     # #   #   # #   #   #   # # #   #     # #       #   #   #     #   #   # #         #   # #     # #       #   #     
# # # ######### ### ### # ### # # ### # # # ######### ##### # ####### ####### ### ### ### ##### ### # # ##### ##### ### ### ####
# #         #   #   #   #   #   #   # # # #         #     # #     #   #       #   #   #   #   # #   # #       #   # #G  #   #   
# ######### # # # ### ##### ##### ### # # ######### ##### # ##### # ### ####### ### ### # # ### # ### ######### # # # ### # # # 
# #     # # # # #   #   #   #   # #   # #   #       #   # # #   # #     # #     #   #   # #     #     #   #     #   #   # #   # 
### ### # # # # ### ### # ##### # # ### ### # ######### # # # ### ####### # ##### ############### ##### # ######### ### ####### 
#   # # #   # #   # #   # #     #   #     # #     #     #   # #   #       #     # #       #       #     #       #   # #       # 
# ### # # ### # # # # # # ##### ##### ### # ##### # ### ##### # ### ##### ##### # # ##### ####### # ########### # ### ####### # 
#   #   #     # # # # # #   #   #   # #   #     # #   # #     #     #   #     # #   #     #     # # #   #   #   # #       #   # 
### # ######### # # # ##### # ### # ### # ##### # ### # # ############# ##### # # ### ##### ### ### # # # # # ### # ####### ### 
#   #           # # #       # #   #   # # #   #   #   # # #       #     #     # #   # #   #   #     # #   #   #   # #     # #   
# ############### # ######### # ##### # # # ########### # ####### # ##### ##### ##### # # ########### ######### ### # ### # # # 
# #   #           #           # # #   # # #           # #   #   # # # #   #   # #   #   # #           #             # #     # # 
# ### # ### ####### ##### # ### # # ### # # ### ### # # ### # # # # # # ### # # # # ####### ####################### # ####### ##
#   # #   #   #   #   # # #   # #       # # # #   # #   #     #   #   # #   # #   #     #   #                 #   # #   #   #   
### # # # ### # ##### # # # ### ######### # # ### # # ### ########### # # ### ######### # ### ############### # # ##### # ##### 
#   # # #   # #     # #   #   #     #     # # #   # #     #   #     # # # #         #   # #         #       #   # #   # #     # 
# # # ##### # ##### # ####### ####### ##### # # ### ##### # # # ### # # ### ####### # ### ##### ### # ########### # # # ##### # 
# # #     # # #     # #       #   #   #   # # #   # #   # # #  S# # # #     #   # # #     #   #   # # #           # #   #   #   
# ####### # # # ##### ######### # # ### # # # ### # # # ### ##### # # ####### # # # ####### # ##### # # ########### ####### ### 
#         # #       #           #       #   #     #   #           #           #   #         #       #               #           
