################################################################################################################################
################################################################################################################################
#   #       #   #   #   #   #   #             # #       #     #                   #   #   #         #           #   #   #       
# # # ##### ### # # # # # # # # # ########### # # ##### # ##### ####### ####### # ### # # # ##### # ########### # # # # # ##### 
# # #     #     # #   # # #   # #           #   #   #   #       #   #   #       #   #   # #   # # #   #   #     # #   # # #     
# ####### ####### ##### # ##### ########### ######### ########### # ### # ######### ### ##### # # ### # # # ##### ##### # # ####
#   # #   #     #     #   #         #     #   #   #   #     #     #   # #     #   #   #     # # #   #   #       #   # #   # #   
### # # ##### ####### ### # ####### ### ##### # # # ### ### # ####### # ##### # # ### # # ### # ### ######### # ### # ##### ### 
# # # #       #   #   #   #   #   #     #   # # # # #   # # #   #   # #   #   # # #   # #         #         # #   # # #     #   
# # # ####### # ### ### ##### ### ##### # # # ### # # ### # ### ### # # # # ### # # ### ####### # ######### # ### # # # ##### ##
#   #   #     #     #   #   #     #     # # # #   # #   #   # #     # # # #   # #   #     #   # # #       # #   # # # # #   #   
# ##### # ########### ### # # ##### ### # # # # ### ### ##### ##### # # # ### # ##### ##### # ### # ##### # ### ### # # ### ### 
#   #   #   #   #   # #   # #     #   # # # # # #   # #   # # #     # # # # # # # #         #   #     #   #   # #   # #     #   
### # # ### # ### ### # ### ######### # # ### # # ### ### # # # ####### # # # # # # ########### ####### ##### # # ### ####### ##
# #   #   # #   #     # # #         # #         #     # # # # #         #   # # # #           #       # #   # # # # #           
# ####### # ### ### ### # # ####### # # ####### ##### # # # # ######### ##### # # # ######### ####### # # ### # # # # # ####### 
#   #   # # #       #   #   #   #   # # #     # #     # # # #   #       #     # # # #     #   #       #   #   #   #   #       # 
### ### # # # ### ### ##### # # # ##### # ### # # ##### # # ### # ### ### ##### # # # ### ##### ########### ### ### ######### # 
# #   # # #   #   #   #     # # #     # #   #           # #   #   #   #   #     # # #   # #     #           #   #   #     #   # 
# ### # # ##### # # ##### ### # ##### ##### ##### ### ### # # ### ##### ### ##### # ### # # ####### ########### # ### ### # ####
# #     #   #   # #     # #   # #   # #     #     #     # # #     #     #   # #     #   # #       # #   #     #   #   # # #     
# # ####### ##### ##### # # ### ### # # ########### # # # # # ##### ##### ### # ##### ### ####### ### # # ### ##### ### # ##### 
# # #       #   #     # # # # #     #   #   #       # #   # # #     #     # #   #   #   # #     #     #   # #   #   # # #     # 
# # # ####### # # ##### # # # ############# # ############# # # ####### ### # ### # ##### # ### ### ####### ### # ### # ##### ##
#   #   #     #   #     # #   #   #         #           #   # #   #   #   #   #   #       # # #   #         #   #     # #   #   
# ##### # ####### # ######### # ### ####### ########### ### ##### # # ### ### # ########### # ### # ######### # ##### # # # ### 
# #     # #       #           #   #   #   # # #   #     #   #   # # #   #   # #   #   #   # #     #     #     #   #   # # # #   
# # ##### # # # ############### # ### # # # # # ### ##### ### ### # ### ### # ### # ### # # ########### # ####### # ### # # # ##
# #   #   # # #   #     #     # # #   # # #   # #   #     # #   # #G# # #         #   # #   #   #   #   #   #     # # #   #   # 
# ### # ### # ### # ### ### ### # # ##### # ### # ##### # # ### # # # # ######### ### # ##### # # # # ##### ##### # # ######### 
# #   # #   #   #   # #   #     # #   #   # #   #     # # # # #   #   #     #   #  S# # #     #   # #     #   #   # # #   #   # 
# # ### # # # ####### ### # ######### # ### # ####### # ### # ############# # # ### # # # ######### ######### ### # # # # # # # 
# #     # # #         #   #       # #   #   #       # #     # #       #   #   #   # #       #     #         #   # # # # #   #   
# ######### ### ### ### ######### # ##### ######### # # ##### # ##### ### ####### # # # ### # ### # ####### ### ### # # ########
#     #       #   #   # #       #   #   # #     #   # #       #     #     #   # # #   # #     # # #   #   #   #   # #           
# ### ########### ##### ####### # ### # # ### # # ### # ### ### ### ####### # # # ####### # ### # # # # # ### ### # # ######### 
#   #             #   #       #   #   # #     # # #   #   #       #   #     # # #   #   # #   #   # #   #   #   #     #       # 
### ######### ##### # ####### # ### ########### # # ##### ##### # ### # ##### # ### # # ### # ##### ####### ### ####### ##### # 
# # #   #     #   # #     #   #                 # #   # # #   # #   # #   #   #   #   #   # # #   # #     # # #         #     # 
# # # # # # # # # # ##### # ##### ######### ##### ### # # # # ##### ####### ### ######### # # # # # ##### # # ########### ##### 
# # # #   # # # #   #   #   #   # #       # #   #     #   # #       #           #   #   # # # # # #     # #   # #       #   #   
# # ####### # # ### # # ##### # # # ##### # # # ########### ######### ########### # # ### # ### # # ### # ##### # ##### ### ### 
#   #       # # #   # # #     # # #     # #   #           #           #   #       # #   #   #   # #   # #   #   # #       #   # 
##### ####### # ##### # # ##### # ##### # # ##### # # ### ####### ##### # # ####### ### ### # ### ##### ### # ### ##### ##### # 
#   #   #   # #     # # #     # # #   # # # #   # # #   #       #   #   #   # #   #   # #   # # #     #         # #   #   # # # 
# # ### # # # ##### # # ##### # ### # # # ### # # # ### ####### ### # ####### # # ### # # ### # ##### ####### ### # # ### # # # 
# #     # # #   #   # #       # #   #   # #   #   #   #     #     # # #     #   # #   # #   # # #   # #     #     # #   #   # # 
# ##### # # ### # ### ######### # ####### # ####### # ##### ##### ### # ### ### # # ### ### # # # # # # ### ### ### ### ### # # 
#   # # # # # # #     #   #     # #     #   #       #     #     #     # # #   # #   # #     # # # #   # # #   #   # #     # # # 
### # # # # # # ####### # # ##### # ### ##### ### # ### ####### ### ### # # # # ##### # ##### # # ##### # ### ##### ##### ### # 
#   #   # # # #   #     # # #   # # #   #     #   #   #     #   #   #   # # # #   #       #   # #   #     #   #   #     #     # 
# ####### # # ### # ####### # # # # # ### ### ######### ### # ####### ### # # ### ####### # ### ##### ##### ### # ############# 
#       # # #   # #       #   # #   # #     # #       # #   #         #   # #   #   #     #         #   #   #   #           #   
# ##### ### # # # # ##### ##### ##### # ##### # ##### ### ######### ### ####### ### # ### ######### ### # ### ############# ####
#   # #     # # # # #   #     #   #   # #     # #     #   #       #   # #   #   # # # #             #   #     #   #       #     
# # # ####### # # # ### ##### ### # ### # ##### # ##### ### ##### # ### # # # ### # # ### ######### # ######### # # # ### ##### 
# # # #       # # #       # #   # # #   #     # # #     #   # #   # #   # #   # # # #   # #       # #           # # # #       # 
# # # # ######### ####### # ### # # ########### # ####### ### # ##### ### ##### # # ### # # ##### # ############# # ### ##### # 
# #   # #     #   #     # #     # # #       #   #         # # # #   #     #   #   # #   # # #   # #       #     # #   #     # # 
# ##### # ### # ##### ### ####### # # ##### # ############# # # # # ### ### # ### # ##### # # ### ##### # ### ### # # ####### # 
#       #   # # #   #   #     # # # # #   # # # #   #   #     # # #   # #   #   # #     # # #   #   #   #   # #   # #   #     # 
# ### ##### ### # # ### ##### # # # # # # ### # # # ### # ##### # ### # # ##### # ##### # # ### ### # ##### # # ##### ### ### # 
#   #     #   #   #   #     #   # #   # #     # # #     # #     #   # # #   #   #     #   # #   #     #   #   # #   # #   #   # 
# # ##### ### ####### # ##### ### ##### ####### # ####### # ####### # # ### ##### ##### ### # ######### # ### # # # # # ### ####
# #     #   # #   #   #   #   #   #   # #         # #     # #       # #   #   #   #     #   # #   #     #         # # # # #     
# # # ##### # # # # ##### # ### ### # # # ######### # ##### # ####### ### ### ### # ### # ### # # ####### ######### ### # ##### 
# # #     #   # # #     #     # #   #   # #   #     # #   #   #     # # #   #   #   #   #   # # # #   #   #       #     # #   # 
### # # # ##### ####### ##### # # ####### # # # ### # # # ##### ### # # ### ### ##### ##### # # ### # ##### ##### ####### # ### 
#   # # #             #   #   #   # #   # # # # #     # #     # # # # #   # #   #         #   #   # #       #     #       # #   
# ### # ################# ### ##### # # # # # # ##### # ##### # # # # ### # # ### ####### ####### # ######### ##### ##### # # ##
#   # #   #           # #   #         #     # #   #   # #       # #   #   # #   # #   # #     # #   #       #   # # #   #       
### # ### # ######### # ### ################# ### # # # ######### ##### ### ### # # # # ### # # ##### # ####### # # # # ####### 
# # # #   # #       # #   #             #   #   # # # #     #   #   #         # # # #   #   #   #     # #       # # # # #       
# # # # ### # ####### ### ############# # # ### ### # ##### ### # # # ######### # # ##### ####### ### ### ####### # # # # ##### 
#   # #   # #   #     #         #     # # #       # #     #   #   #   #       # # # #     # #     # #     #     #   # # # #   # 
##### ### # # # # ##### ####### # ##### # ####### ####### ### ######### ##### # # # # ##### # ##### ####### # # ##### # # # # # 
#     #   # # # # #   # #       # #     # #     #       #   #           #   #   # #   #     #   #           # # #   # # #   # # 
# ##### ##### # # # # # # ####### # ##### # ### ####### # # ############# # ##### ##### ####### ####### ##### # # # # # ##### # 
# #   # #     # # # # # # #       # #     # # #   #   #   #   #   #       #   #       #     # # #     #   #   #   #   #     # # 
# ### # # ##### # # # # # # ####### ####### # ### # # ##### # # # ####### ### # # ### # ### # # # ### ##### # ############# ### 
#     #   #   #   # #   # # #       #       #       #       # # # #       # # # #   #   # #   #   #         # #       #     #   
# ######### # ########### # # ####### ####### ############### # # # ####### # # ### ##### ##### ############# # ##### # ##### ##
#           #         #   # #     #   #       #     # #   #   # # #     #   # #   #       #   # #   #   #     #   # # # #       
# ##### ######### # # # ### ##### ############# ### # # # # ### ####### # ### ##### # # # # # ### # # # ######### # # # # ##### 
#     #   #       # #   #   #   #   #   #       #   #   # #   #       # # #   #   # # # # # #     # # #         # #       #     
# ### ### ######### ##### ##### ### # # # ####### ### ####### ####### # # # ### # ### ### # ####### # ######### ### ############
#   #   #         #       #       #   # # # #   # #   #       # #   # # #   #   #     #   # #       #   # #   # #   #           
####### # ####### ##### ### ########### # # # ### ### # ####### # ### # # ### ######### ### ########### # # # # # ### ######### 
#       # #     # #   #   #           # #   #   # #   #   #     #   # # #     #     #     #     #   #   #   #   #   # #     # # 
# ####### # ##### # # # # # ##### # ### # ##### # # ##### ### # ### # # ######### # ##### ##### ### # ############# # # ### # # 
#     #   # #   # # # # # # #   # #   # # #     # # #   #   # # #   # #     #     #         #   #   #     #   #       # #   #   
# ### # ### # # ### # # # # # ### ### # # # ##### # # # ### # # # ### ### # ############# ### ### ####### ### ##### ### # ##### 
# #   #     # # #   # # # # #   #   # #   #   #   #   #       #         # # #   #       # #   #   #     #   #       #   # #     
### ### ##### # # ### # ### ### # # ######### # ####################### ### # # # ##### ### ### # # # ##### ####### # ### ######
#   #   # #   #   # # # #   #   # #         #   #     #             # #   # # #   #   #     #   #   #     #     #   # # #   #   
# ### # # # ####### # # # ### ######### ########### # # ########### # ### # # ####### ####### ################# # ### # ### # # 
# #   #   # #     #   # #   #       #   #   #   #   #   # #   #   # #   #   # #   #   #             #       # # #   # #   #   # 
# ### ##### # ##### ### ### ####### # ### # # # # ####### # # # # # ### ### # # # # ### ########### # ### # # # # # # ### ##### 
#   # #   #   #     #     # # #     #     # # #   #   #   # # # # #   #     # # # # #   #   #     # # # # #   # # #       #   # 
### # # # ##### ####### ### # # ######### # # ##### # # # # # # # ### ##### # # # # # ### # # ### ### # # ##### # ######### # # 
# # # # # #     #       #     #   #     # # # #     # # # # #   #   #     # #   # #   #   #     #     # #           #   #   #   
# # # # ### ##### # ##### ####### # ### ### # # ####### # # ####### ##### # ##### ### # ########### ### ######### ### # # ##### 
# # #   #   #   # # #     # #     #   # #   # #   #     #   #     #       #     #   # # #         # #     #     #     # # #     
# # ##### ### # # # # ##### # ####### # # ### # # # ######### ### ############# ### # # # ####### # # ### # ### ##### # # ### ##
# #       #   #   #   #   # #     #   # # #   # #   #           #       #   #   #   #         #   # #   # #   #     # # #   #   
# ########### ### ##### # # ##### # ### # # ### ##### ### ######### ##### # ##### ##### ##### # ### ##### ######### ### ### # # 
#     #   #   #         # # #   #   # #   # #   #       # #       # #   # #       #   # #   # # #   #     #       # #   #   # # 
##### # ### ##### # ##### # # # ##### ####### ######### ### ##### # # # # ########### # # # ### # # # ##### ##### # # ### ### # 
#     #     #     #     # # # # #   #         #     #   #   #     # # #   #       #   # # #     # #   #   #   # #   #   #   # # 
# ############# ### ### # # ### ### # ######### ### ##### ### ##### # ##### # ##### ### ######### ####### ### # ####### # # ### 
#               #   #   # #   #   #   #         #         #   #       #     # #     #       #     #       #   #         # #   # 
########### # ########### ### ### # ### ##### ### # ######### ####### # ##### # ##### ##### # ##### ####### ##### ####### ### # 
#   #       #         #   #   #   # #     #   #   # #       #       #   #   # # # #       # # #     #       # #   #       #   # 
# # # # ############# # ### ### ### ####### ####### # ##### ####### # ### # # # # # ##### # # # ##### ####### # ### # ##### ### 
# # # # #   #   #   # #   # # # # # #     # #   #   #   #   #   # #   #   # #   # # #   # # #       #   #   #   #   # #   # #   
# # # # # # # # ### # ### # # # # # # ### ### # ######### ### # # ### # ### # ### # # ### # ########### ### ##### ### # # # # ##
# #   # # #   # #   #   #           # # #   # #   #     # #   #     # # #   # #     #   # #             #           # # #   # # 
# ##### ####### # ##### ### ##### ### # ### # ### # ### # ####### ### # ##### # ##### # # ############### # ##### # ### ##### # 
# #   #     #   #     #   #     #   #   # # #   #   # # #       #     #     #         # #       #   #     # #   # #   # #   #   
# ### ##### # ####### ### ##### # ##### # # ### ##### # ####### # ######### ################### # # ##### # # # ##### # # # # ##
# #     #   #   #   #   # #     #   #   #   # #     #   #     # #   #   #   #   #               # #   #   #   # #     # # # #   
# # ##### ##### # ### ### ######### # ####### ##### ##### # # # # # # ### ### ### ############### ### # ####### # ##### # # ### 
# # #     #   # #   # #   #     #   # #   #   #     #   # # # # # # #   #   #     #       #   #   #     #       # #   #   # #   
# # # ##### # # # # # # ### ### # ### # # ### # ####### # # # # # # ### ### ####### ##### # # # # # ##### ####### ### ##### ####
#   #       #   # # # # #   #   #     # # #   #       #   # # # # #       # #       #   #   # # # # # #   #     #     #   # #   
# ############### # # # # ### ### ####### # ######### # ### ### # ######### # ####### # ##### ### # # # ####### ######### # # # 
#                 #   #   #   #                           #                 #         #     #     #   #                   #   # 
################################################################################################################################
