################################################################################################################################
   #           #         #       #       #     #     #   #             #             #     #     # #   #     #   #     #   #   #
## # ### # ##### ####### # ##### # ##### # ##### # ### # # ######### # # ##### ### ### ### # ### # # ### ### # ### ### # # # # #
   # # # #   #   #     # #     #   #   # #   #   #   # #   #   #   # #   #   #   # #   #   #   # #       #   #     # #   # # # #
 ### # # ### # ### ### ####### ##### # # ### # ##### # ##### # # # ### ### ##### # # ### ##### # # ##### ########### ##### # # #
 #     #   # #   # # # #     #     # #   #   #   # # #   #   #   #   #     #   # # #   # #     # # #   # #   #   #   # #   # # #
 # ####### # ### # # # # ### ##### ####### ##### # # ### # ######### # ##### # # # ### # # ##### ### # # # # # # # ### # ### ###
 #     #   #     #   #   #      G#   #     #   #   #   # # #         #   #   #   #   # # #   # # #   # #   #   #           #   #
 # ### # ########### ##### # ####### # ### # # # ####### # # ########### # ####### # # # ### # # # ### ### ############# ##### #
 #   # # #         #     # #     #   #   #   #   #   #   # #     #       #     #   #   #   #   #   #   #   #   #   #   #       #
 ### # ### ####### ##### # ##### # ##### ######### # # ### ##### ############# ##################### ### # # # # # # # # ##### #
 #   #     #     #       # #     #   #       #     #     # #           #       #   #         #     #   # # # #   #   # # #   # #
 # ############# ######### # ####### # ####### ########### # ######### # ####### # # ####### # ### ### # ### ######### # # # # #
 #             #         # # #       # #   #   # #   #     #   #   #     #       #   #   # #   # #     #   #       # # # # # # #
 ############# # ### ##### ### ####### # # # ### # # # ##### ### # ##### # ############# # ##### ####### # ####### # # # # # ###
 #   #     #   #   # #   #           #   #   #   # # # #   # #   #   #   # #   #   #   # #     #     #   #   #   #   # #   #   #
 # # # ### # ### # ### # ######### # # ####### ### # # # # ### ##### ##### # # ### # # # # ##### ### ##### # # # ##### # ##### #
   # #   # #     # #   #       #   # #     #     # # #   #   # #   #     #   #   # # #   #         # #     # # # # #   #   # # #
#### ##### ##### ### ######### ##### ##### # ### # # ####### # # # ##### ####### # # ##### ######### # ####### # # # ##### # # #
   #     #     # #   #   #   #     #       # #   # #   #   #   # #     #     #   #   # #   #     #   #         #   # # #   #   #
 ####### # ### # # ### # ### ##### # ####### # ####### # # ##### ##### ##### # ### ### # ### ### # ######### ####### # # #######
 #       #   #         #   # #   # #         #       #   # #     #         #   #   #   #   # #   #     #   #     #   # #       #
 # ######### # ########### # # ### ############### ####### # ##### ####### ##### ### # ### ### ####### # # ####### ### ####### #
 #     #   # # #     #     #     #     #         #         #   #   #   #         # # #   # #   # #   #   #       # #     #   # #
 ##### # ### ### ### # ######### ##### # ##### # # ######### # ##### # # ##### ### # ### # # ### # # ########### # # ### # # # #
       #     #   #   #         #   # #   #   # # # #       # #     # #   #   #       # #   # #   # #           #   # #   # # # #
 ############# ### ########### # # # ##### # ### # # ##### # ##### # ##### # ##### ### ##### # # # ####### ######### ##### # # #
   #   #       # # #   #     #   # # #     #   # #   #   #       # # #     #     # #   #       # #   #   #                 # # #
## ### # # ##### # # ### ### ##### # # ####### # ##### # ### ##### ### ######### # # # # ### ### ### # # ##### ##### # ##### # #
 # #   # # #     # #     #   #   # # #     # # # #   # #   # #   #     # #   # # # # #   # #   #       #     #     # #   #   # #
 # # # # # # ##### ####### ### # # # ##### # # # # # # ### # # # ####### # # # # # # ##### ### ################### # ##### ### #
 # # # # # #   #   #   # #   # # # # #     #   #   # # # # # # # #   # #   #   # #       # #   #   #               #     #     #
 # # # # ##### # ### # # # ### # # # # ######### ### # # # # # # # # # # ####### ####### # # ### # ##################### # #####
 # # # #     # # #   # #   #   # #   # #     #     # # # # # # # # #       #   #       #   # #   #       #               #     #
 # ### ##### # # ### # ### # ### ### # # ### ####### # # # ### # ### ####### # ####### ##### # ######### ####### # ####### ### #
 #   #   #   # #   # #       #   #   #   # #   #     # # # #   # #   #       #     #   #     # # #       #       # #   #   #   #
 ### # # # ### ### # ####### ##### ####### ### # ### # # # # ### # # # ####### ### # ### ##### # # ####### ####### ### # # ### #
 #   # # #   # # # # #     #     #   #   # #   # # # # # #   #   # # # #   #   #   #   #   #     #     #       #   #   # #   # #
 # ##### ### # # # ### ### ### ##### # # # # ### # # # # ##### ##### # # # # ######### ##### ######### # ##### # # # ####### # #
 # # #   # #   # #   # # #   #     #   # # #   # #   #   #     #       # #   #       #   #     #       #   #   # # # #   # # # #
 # # # # # ##### ### # # ### # # ####### # ### # ####### # ########### ####### ##### ### # ##### ######### # # # ### # # # # # #
   #   #   #   #   #   #   # # # #       # # # # #     # #   #   #   #   #   #   #     # #   #   #   #     # # #   # # # #   # #
 ######### # # # # ##### # # # ### ####### # # # # ##### ### # # # # ### # # ### # ### # ### # ### # # ##### ##### # # # ##### #
 #   #   # # # # #   #   #   #     #     #   #   #     #   #   # # #       #   # #   # #     # #   # #     #     #   # #   #   #
 # # # ### # # # ### # ####### ######### ### ######### ### ##### ######### ### # ### # ####### # ### ################# ### # # #
 # # #       # # #   #       # #             # #       #       #         #   # #   # # # #   #   # #         #         # # # # #
 # # ######### # ########### # ##### ##### ### # ####### ####### ####### ### ##### # # # # ####### ######### # ######### # # ###
   #       # # # #     #   # #       #   #     #     #   #     #   #     #   #   # # #   #   #   #         #   #   #   #   #   #
########## # # # # ### ### # ####### # # # ####### ### ### ### # ### ##### ### ### # ####### # # ######### ##### # # # ####### #
       # # #   #   #   #   #   #     # # # #     # #   # #   # #   #   # #   # #   #   #     # # #       #     # # # #         #
 ### # # # # ####### ### ##### ### ### # ### ### # # ### ### # ### ### # # # # # ##### # ##### # # # ### ##### # ### # ####### #
 # # #   # # #     # #       #   # #   #       # # # # #     #   # #   #   #   # #   # #       # # #   #       #   # # #     # #
 # # ##### # # ### # ##### # ### # # ########### # # # ######### ### ##### ##### ### # ######### # ### ####### ### # # # ### # #
   #     # # #   # # #   # #   # # # #   #       # # #         #   # #     #     #   #     #     #   #   #   #   #   #     # # #
## ##### # # ### ### # # ##### # # # # # # ####### # ### ##### ### # # ### # ##### # ####### ####### ##### # ### ### ####### ###
 # #     # #   #   # # # #   # # #   # # #         # #   #   #   #   # #   #       #       #       # #     #           #   #   #
 # ####### ### ### # # # # # # # ### # # ########### # # # # ### ##### ### ############### ####### ### # ####### # ##### # ### #
 #     # #   #         #   #   #   #   # #     #     # # # #         # #     #   #       #       # #   # #     # #   #   #     #
 ##### # ### ################# ### ##### # ### # ##### # # ######### ### # # # # ##### # ##### ### # ##### ### ##### # #########
 #   #     #           #     #       #   #   # # #     # # #   #   #   # # #   #     # #   #   #   #         # #     #S#       #
 # # ##### ########### # ### ####### ### ### # # # ### ### # # # ##### # # ######### ##### # ### ### ######### # ### # # ##### #
 # #     # # #   #   #   # #     #     #     #   #   # #   # #   #   #   #     #     #   # # # #   #   #     # #   # #   #     #
 # ##### # # # # # ####### ##### ##### # ############# # # # ##### # ####### # # ##### # # # # ### # ### ### ##### ####### ### #
 #     # # #   #   #     #     #     #       #       # # # #     # #   #   # # #     # # # #     # # #   # # #   # #       #   #
 ##### # # # ####### ##### ### ##### ### ### ##### # ### ####### # ### # # ### ##### # # # ##### # ### ### # # # # # ####### # #
       # #   #       #   # #       #   #   #   #   #   #         # # #   #     #   #   # # #     #   #   # #   # # #   # #   # #
 ########### # ####### # # # ##### ### ### ### # ##### ######### # # ########### ####### # # ####### ### # ##### # ### # # ### #
 #       #   #   #     # # #   #   #       # # #     #         # # #       #   # #     # # # #   #   #   #     # #   # # # #   #
 # ##### # ##### # ##### # ##### # # ####### # ##### ######### # # ### # # # # # # # ### # # ### # ### ### ### # ##### # # # ###
 #     #   #   #   #   #     #   # #   #   #   #   #   #     # # #   # # #   #     #       # #   #     #   #   #   #   #   #   #
 ##### ##### ####### # ##### # ### ### # # ##### ####### ### # # ### ### ######### ######### # # ######### # ##### # ######### #
     #     # #       # #     #   #     # # #             # #   #   #   # #         #         # #   #       #     #   #         #
 ### ##### # # # # ### ### # ####### ### # # ######### ### ####### ### # # ####### # ############# # ########### ####### # ### #
 #   #   # #   # #   #   # #   #   # #   # # #       #     #     # #   # #     #   #     #     #   # #     # #   #       #   # #
 # ##### # ### ##### ### # # # # # # # ### ### ##### ##### ##### # # ######### # ####### # ### # # # # ### # # ### ### ##### # #
 #             #     #     # # # #   #   # #   #   #     #     #   #   #   #   #       # #   # # # # # #   # #     # # #     # #
###### ##### ### ########### ### ### ### ### ### # ##### ##### ### ##### # # ### ### # # ##### ### # ### ### ####### # # ##### #
   #   #   #   #   #     #   #   # #   # #   #   # #   #   # # #   #     #   #   #   # #     #   # #     # #       #   # #   # #
 # ##### # ### ### # ### ##### ### ### # # ##### # # # ### # # ##### ############# ### ##### ### # ####### # # ### ### # # # # #
 #       # #   #   #   #       #     # # # #   # #   #   # # #     # #           #   #     # #         # #   # #       # # # # #
 ######### ##### ##### ######### ### # # # ### ######### # # ##### ### ######### ######### # ######### # ### # ######### ### # #
   #     # #   #     #         #   #   # #     #       # # #       #   #       #         # #       # #       #   #     #   # # #
## # ### # # # ### # ######### ### ##### ####### ##### # # ####### # ### ##### ######### # ####### # ### ### ### # ### ### # ###
 # #   # #   # #   #     #   #   #     #   #         #   #       #   # # # #   #               #   #   # #   # #   # #   # #   #
 # ### ####### # ### ##### # ### ##### ### ### # ##### ######### ##### # # # ##### ### ##### ### ##### # # # # ##### ### # ### #
   # #     #   #   # #   # #   #   # #   #     # #   #       #   #   #   # # #   # #   #     #   #   # # # # #   #     # # #   #
#### ##### # ### # ### # # ### ### # ### ### ### # # # ####### ### ####### # # # # # ### ### # ##### # # # # ### # ##### # # ###
 #     #   #   # #     #   #   #   # # #     #   # # #       #   #       # # # #   # #   #   #     #     # #     #   #   #   # #
 # ### # ##### ############# # # ### # # ### # ### # ### ### ### ##### # # # ####### # ### ####### ####### # ####### # ####### #
 # # #   #   #               # #     #   #   #   # # #   #     #     # # # #         #   # # #   #     #   #   #   # #         #
 # # ####### ################# ########### ##### # # ##### ### ##### # # # ### ######### # # # # ##### # ### # ### # ####### # #
                 #             # #       # #     # #   #   #   # #   # #       #     #   # # # #     #   #   #     # #   #   # #
 # ########### # # ######### # # # ##### # # ##### ### # ### ### # ### # ####### ### # ### # # ########### # # ##### # ### #####
 # #     #     # #   #       #   # #   #   #     # #   #   # #   #   # # #     # #     #     # #       #   # #         #   #   #
 ### ### # ##### ### # # # ####### # ########### # ##### # # # # ### # ### ### # ######### ### # ##### ##### ### ####### ### # #
 #   # # # #   # #   # # # #       #   #       # #     # # #   #   # # #   # # # #         #   #   # #     #   #   #   #   # # #
 # # # # # # # # # ### # # # ######### # ##### # ##### ### ####### # # # ### # # # ####### # ##### # ##### ### # # # # ### ### #
 # # # #   # #   #   # # # # # #   # # # #   # #   # # #   #       # # #     # # #   #   # #     # #     # #   # #   #   #     #
## ### ##### ##### # ### ### # # # # # # # ### # # # # # ### ####### # ##### # ####### # # ##### # # ### # # ### ####### #######
   #   #   #   #   # #   #   #   # # # #   #   # #   #   #       #   #     # #       # # # #   #   # #   #   #   #     #       #
 ### ### # ### ##### # ### ####### # # ##### ### ######### ####### ### # ### ####### # # # # # ##### # ######### # ### # # ### #
     #   #   # #     #   # #       #         #   #   #   #         #   #   #   #   # # # # # # #     #   #     # # # #   #   # #
########## # # # ##### ### # ####### ######### ### # # # # ########### ### ### ### # # # # # # # ####### # ### # # # ####### ###
         # # # # #     #   # # #   # #       #   # #   #   #         # # # # #   #   # #   # #   #       # #     #   #   # #   #
 ### ### # # # # # ##### ### # # # # # ##### ### # ####### # ####### # # # # ### ######### # ##### ####### # ######### # # ### #
 #   # #   # #   #     #     #   #   # # #       # #   #   #   #     #   #     #         #     #   #       # #   #   # # #     #
 # ### ##### ##### ### ########### ### # # ##### # # ### ##### ######################### # ##### ### ##### ### # # # # # #######
 #   # #           #   #     #     #   #   #   # # #   #     #   #   #       #     #     #   #   #       # #   #   #   #       #
 ### # # ##### ### # ####### # ##### ##### # # ### ### ##### ### # # # ##### # ##### ####### # ####### # ### ################# #
   #   # #     #   # # #   # #   # # #     # #     #           # # # #     #   #     # #   # #       # #   #       #         # #
######## # ##### # # # # # # ### # # ##### # ################# # # # ##### ##### ##### # # # ####### ##### ####### # ######### #
         #   #   # # #   # #       #   #   # #             #   #   #             #     # # # #     #     #         # #       # #
 ########### # ### # ##### # ######### # ### # ########### ### ######### ### ##### ##### # # ### # ########### ##### # ##### # #
   #   #   # # #   #   #   #   #     # # #   # #     #   #   # #         #   #   # #   # # #   # #           #       # # #   # #
#### # # # ### # ##### # ### ### # ### # # ### # ### # # ### # # # # ##### ##### # # # # # ### ####### ##### # # ##### # # ### #
     #   #     # #   # #   # #   # #   # #   # #   # # # #   #   # #     #   #   # # #   # # # #     # #   # # #   #     # #   #
 ####### ####### # # # ### # # ### # # ##### # ##### # # ######### ######### # ### # ##### # # # ### # # ### # ### # ##### # ###
 #       #     # # # #   # # #   # # # #   #         # #     #     #         # #   #   #     # # # #   #   # #   #   #     #   #
 ######### ### # # ### # # # ### # # ### # ########### ##### # ##### ######### # ##### ##### # # # ####### # # ####### ### ### #
     #     # # # #   # # # #   # # #   # #           # #     # #   # # #     # # #     #     #   #       # # # #   #   #     # #
#### # ##### # # ### ### # # # # # ### # ########### # # ####### # # # # ##### # # ### # ### ########### # # ### # ########### #
   # # #   # # #   #     #   # # # #   # #   #     #   #   #   # #   # # #     #   #   #   #           # # #     # #     #     #
## # # # # # # # # ####### ##### ### # # # # ### # ####### # # # ##### # # ######### ########### # ### # # ####### # ### # ### #
   #     #   # # # #     # #   # #   # # # #     # #     #   # # # #     #   #           #     # #   # # #       #   #   # #   #
 ### ####### # ### ##### # # # # # ##### # ####### ### ######### # # # ##### ############# ### ##### # # ####### ##### ### # ###
 #     #   # #   #       #   #   # # #   # #     #   #           #   # #   #         #     # #     # # # #   #   #   #     #   #
 ####### # ##### # ####### ####### # # ### # ### ### ######### ####### # ########### # ##### ##### ### # # # # # # # ######### #
         #       #               #   #     #   #               #                       #                   #   #   #           #
