################################################################################################################################
################################################################################################################################
 #     #   # #   #     #     #           #   #     #   #   #   #         #     #                   #                 #         #
 # ##### # # # # # ### # ### # ####### # # # # ### # # # # ### # ####### ##### # ### ########### ### ##### ########### ####### #
   #     # #   # # #   #   #   #     # #   # # # # # # # #   # #   #   #     #   #   #       #       #   #   #         # #   # #
 ### ##### ##### # # ######### # ### # ##### # # # # # # ### # ### # # ##### ### ##### ##### # # ##### # ##### ######### # ### #
   #     #   # # # #   #     # # #   # #   # # #   # # # #   # # #   # #   #   # #     #     # # #     #     #   #   #     #   #
 # ##### ### # # # ### # ### # # # ##### # # # # ### ### # ### # ##### # ##### # # ##### ####### # ######### ### ### # ### # ###
 #     # # # #   #   # # #   # # # #     # # # # #   #   #     #   #   #       # #   # # #     # #       # #   #     #   # #   #
 ####### # # # ##### # ### ### # ### ##### # ### # ### ######### # # ########### ### # # # ### # ####### # ### ####### # ##### #
       # #   #     # #   #       #   #     #   # #     # #       # #   #   #   #   # # #   #           #   #     #     #       #
###### # ####### # # ### ### ##### ### ##### # # # ##### # ####### ### # ### # ##### # # ########### ##### # ##### #############
     #         # # #   # # # #     # # #     #   # # #   # #     # #   # #   #     # #   #     #     #   # # #     # #         #
 ### ### ##### # # ##### # # # ##### # ##### ##### # # # # # ### # # ### # ####### # ##### ### # ### # # # # # ##### # ####### #
 #   #   #   #   # #     # # #   #   # #   #           # # #   # #   #   #   # #   # #     # # # #   # #   #   #     # # #   # #
 # ### ### # ##### # ##### # ### # ### # # ### ######### # ##### ##### ##### # # ##### ##### # ### ### ############# # # # # # #
 # #   #   #   # # #   #   #   #   # #   #   #         #   #         #     #   #     #   #   #     #   #             #   # # # #
 # ##### ##### # # ### # # ### ##### ####### ######### # ### ######### ### ### ##### ### # ####### # ### ########### ##### # # #
 #       #     #   #   # #             #     #       # #     #         # #     #   # # # # #       #   #   #     #       # #   #
 ######### ##### ### ### ############### ##### ##### # # ##### ######### ######### # # # # # ######### ### # ### ####### # #####
 #   #   #     #             #           #     #   #   #     # #   #               # #   # # #   #   #   # # # # #   #   # #   #
 # # # # ##### # ##### # ### # ############# ### ####### ### # # # ##### ##### ##### ##### # # ### # ### # # # # # # # ### # # #
 # #   #       #   #   #   # # #   #         # #     #     #   # #     # #   #     # #     #   #   # #   # #   # # #   #   # # #
 # ############# # # ####### # # ### ######### ##### # # # ##### ##### # # # ### ### ##### ### # ##### ### ##### ### ### ### # #
 #       #       # #       #   #     #     #       # # # #     # #     # # # #   #   #     #   #     # #     #   #   #   #   # #
 ####### # ####### ####### ############# # # ##### # # ##### # ### ##### # # ##### ### ### # ####### # ##### # ### ### ####### #
     # # # # #   #   #     #           # # # #   # # # #   # #     #     # #     # #   #   # #     # #   #   # # #   # #       #
#### # # # # # # ### ################# # # ### # # # # # # # ### ### ##### ##### # # ##### # # ### # ### # ### # ### # # ##### #
     #       # #   # #           #   #   #     # # #   # # #   #     #   #     #   # #   # #   #           #   #   # # # #   # #
 ##### ####### ### ### ######### ### ########### # ##### ##### ##### # # ##### ####### # # ### ########### # ### ### # ### # # #
   #   # #   #   #     #       #   #           # # #   #     # # #   # #   #   #   #   # #     #       #   #   #     #   # #   #
 # # ### # # ### ########### # ### ######### ### # # # ##### # # # # # ### # ### # # ### # # # # ##### # ##### # ####### # #####
 # #       #     #         # #   #     #   #         # #   #   #   # # #   # #   #   #   # # # # #     #     # # #   #   #     #
 # ####### ############### # ### ##### # # ##### ####### # ####### ### # ### # # ##### ### # ### ########### # # ### # ####### #
 # #   #   #     #       #   #     # # # #       #       # #   #   #   #   # # #     #     #   #   #   #   # # #               #
 # # # # # # # ### ##### ##### ### # # ######### # ####### # # # ### ####### # ##### # ####### ### # # # # ### # ##### ### #####
 #   # # #   #   #     # #   #   # # #   #     # #   #   #   # #   #       # # #     # #         # # # # #     # #   #   #     #
 ####### # ##### ####### # # ##### # ### # ### # ##### # ##### # # ####### # # # ####### ######### # # # ######### # # # #######
 #       # #       #     # #   #     #   #   # # #   # # #     # #       # # # #   #   # # #     # # # #           #   # #     #
 # ######### ### ### ######### # ##### ##### # # # # # # # ####### ##### # # # ### ### # # # ### # # # ############# ##### ### #
 # #     #   #   #   #   #     # #   #     # #   # #   #   #       #   # #   #   #     #   # # # #   # #       #     #     # # #
 # ##### # ####### ##### # ##### # # ##### ##### # ########### ##### # # ########### ####### # # ##### # ##### # ##### ##### # #
 #     # # #       #       #     # #     #     # #   #       #     # # #           #       #   # #   # # #     #     #   #   # #
 ##### # # # ############# # ##### ### ####### # ### # ##### ##### # ### # ####### ############# # # # # ######### ##### # # # #
 #   # # # #   #         #   #   # # #   #   # # #   # #   #     # #     #       #         #   # # # # #   #       #   # # # # #
## # # # # ### # # ##### # ### # # # ### ### # # # ### # # ##### # ######### # ########### # # # # # # ### # ####### ### # ### #
   #   #   #   # # #     # #   # #   # # #   # #       # #     #   #     #   #         #   # # # # # #   # #       # #     #   #
 ### ####### ##### # ##### # ### ### # # # ### ######### ##### ##### # # # ### ##### # # ### # # # ##### # # ##### # # ##### ###
 #   #       #     #       #   # #   #   #   #     #     #         # # #   #   # #   # #   # #   #       # # #   # # # #   # # #
 # ### ######### ######### # ### # ####### ####### # ############# # # ##### ### # ####### # ##### ####### # # # ### # # # # # #
 # # # #         #   #     # #   #         #     # # #       #   #   #   #       #       #   #                 #     # # #   # #
 # # # ######### # # # ### # # ##### ####### ##### # # ##### # # ### ### ############# ####### ### ##### # ########### # ##### #
 #   #   #       # # #   # # #     # #       #     # #     # # #   #   #   #   #     #   #     # # #     #   #         #       #
 ####### ### ##### # ##### # ####### # ####### ##### ##### # # ### ### ### # # # ### # # # # # # # # ####### # #################
       #   # #     #   #   # #   #   # #       #     #     # #   #   #   # # #     # # #   # # #   #       #             #     #
###### ### # # ####### # ### # ### ### # ####### # ### ##### ### ### # # # # ####### # ##### # ##### ##### ############# ##### #
     # #   # # #   #   #   # # #   #   # # #   # # #   # #   # # #   # # # #     #   #     # # #   #     #             #       #
#### # # ##### # # # ##### # # # ### ### # # # # # # ### # ### # # ##### # ##### # ######### # # # # ################# # #######
     # #   #   # # # #   #     #   #     #   # # # #     # # # # #       #    G  #     #     #   # #                 # # #     #
 ##### ### # ### # # ### # ####### ####### ### # # ####### # # # ####### ############# # ######### ################# # # # ### #
   #     # # #   #   #       #       #     #   # # #       # #   # #   #           #   #   #     # #       #         # #     # #
## # ##### # # ####### ##### # ####### # ####### # # ####### ##### # # ##### ##### # ##### ##### # # ##### # ######### ####### #
 # #       # # #     #     # # #       # #       # # #       #   #   #   #   #   # # #   #       # # #     # #   #   #   #     #
 # ######### # ##### # ### # # # ####### # ####### # ##### # # # # ####### ### ### # # # ######### # ####### # # # # # # #######
 #           #   #   # #   # # # # #   # # #       #     # # # #   #       # #     # # # #         # #     # # #   # # #       #
 ############### # ### # ### # # # # # # # # ### # ##### # # # ##### ####### ##### # # ### ### ##### # ### ### ##### ##### ### #
   #       #     # # # #   #   #   # #   # # #   #   #   # # # #     #   #         # #     #   #   #   # # #   # #   #   # #   #
 ### ##### # ##### # # ### # ####### ##### # # ####### ### # # # ### # # ##### ##### ##### # ### ####### # # ### # ### # ### # #
     #   # #   #         # #       #   #   # # #   #   # # # # # #   # #     #   #   #   # #   #   #   # # # #   #     #     # #
## ### # # ### # ####### # # ######### # ### # # # # ### # # # # ### # ##### ##### ##### # ### ### # ### # # # # ############# #
   #   #   # # # #     # # #         # # # # # # # # #     # # #   # #   # # #     #   #     # #   #   # #   # #               #
 ### ##### # # # # ### # # ########### # # # # ### # ### ##### ### # ### # # # ##### # ####### # ### # # ##### ##### ######### #
   #   #   # # #   #   # #     #     # # #   #     # #   #   # #   # #   # # # #   # #       # # #   # # #     #   #       #   #
###### # ### # ### # ####### # # ### # # ########### # ### # # # ### # ### # # # # # ####### # # # ##### # # # # # ####### #####
       #     #   # # # #   # #     # # #   #     #   #     # #   #   # #   #   # # #       #   # #         # #   #   #   # #   #
 ########### ### # # # # # # ####### # ### # ### # ### ########### # # # ####### # ####### ##### # ####### ######### # # # # # #
   #     #     #   #   # # #     #   # #   # # # # #   #           # # #   #     # #     #     # # #   #   #       #   # # # # #
 # # ##### ### # ####### # ##### # ### # ### # # # ### # # ######### # ### # ### # # ######### # ### # ##### ##### ##### # ### #
 # # #   #   #   #   #   # #     #     #       # #   # # #       #   # #     #   # #     #   # #     # #     #   # #     #     #
 # # # # ##### ### # # ### ####### ############# ### # ### ##### ### # # ############### # # # ####### # ##### # # # ### #######
 #   # # #   #   # # #   #       #       #       #   #   # #   # #   # # # #     #       # #   #         #     # #   # #       #
 ##### # # # # # # ##### ####### ####### # ##### # ##### # # ### # ### # # # ### # ####### ##### ######### ##### ##### ### ### #
 #   # #   # # #   #   #     # #     #   # #     #   #   #   #   # #   #   #   # # #     #   #   #   #     #   # #   #     # # #
 # # # ##### # ##### # ##### # ##### ##### # ####### # ####### ##### ##### ##### # # ### ### ##### # # ##### # # # # ####### # #
   # #   # # #   #   #       # #   #   #   #     #   # #       #     #     #   # # # # #   #       #   #     # # # # #   # #   #
 ####### # # ### # ########### # ##### # ######### ### # # ### # ##### ##### # # # # # ### ############# ####### # # # # # ### #
   #   #   #   # # #       #   #       #           # # # # #   #   #     #   #   #   # #   #           # #     # # #   # #     #
## # # ####### # # ##### # # # ##################### # ### # ##### # ##### ########### # ##### ### ### # # ### # # ##### # # ###
   # #   #     # #       # # #   #         #       # #     #     # #   #   #     #   # #       #   #   # #   # # # # #   # #   #
 ### ### # ##### ######### # ### ### ##### # ##### # ####### ### # ### # ####### # ### ####### # ### ### # ### # # # # ### ### #
   # # # #   #   #   #   #   # #     #   #   #   #     #     #   #   #         #               # #   #   # #   # #   # #   #   #
#### # # ### # ### # # # ##### ######### ####### ##### # ### # # ### ######### # ########### ### # ### ### # ### ##### # # # # #
     # #     # # # # # # #                         # #   #   # #   #   #   #     #     #   # #   # #     # #   #   # #   # # # #
 ##### ####### # # ### # ######### # ##### ####### # ##### # # # ##### # # # ##### ### # # # # ### ##### # ####### # ##### # # #
 #   #       #   #     #     #   # # #   #   #   #         # # #     # # #   #     # #   # # # #     #   #         #     # # # #
 # # ##### # ### ########### # # # # # # ### # ####### ####### ##### # ### ### ##### ##### ### ##### # ################# # # # #
   #       # #         #   #   #   #   #   # #         #     # #     #   # #             #   # #       #   #     #     #   # # #
############ ######### ### ####### ####### # ########### ### # ######### ### ####### ### ### # # ### ### # # ### # ### ##### # #
   #   #   #   #   #           #     #   # #   #         #   #         #   # # #   #   #   # # #   # #   # # #   #   # #     # #
 # # # # ##### # # ####### # # # ### # ### ### # ######### # ####### ##### # # # # ### ##### ####### # ##### ####### # # ##### #
 #   # #     #   #         # #   #   #     # #   #   #   # #       #     #     # #   # #     #   #   # #     #     # #   #   # #
 ##### ##### ######### ##### # ### # ####### ##### ### # # ####### ##### ####### ### ### ##### # # ### # ##### ### # ##### ### #
   #                   #     # #   #             # #   # #       #     #     #   # #   #   #   #   #   #     # # #   #   #     #
## ####### # ####### ### ##### # ### ##### ### ### # ### ####### ### # # ### # ### ### ### ### ### # ####### # # ####### ##### #
 #     #   #   #     # # # #   # # #     #   #   #   #   #   #   #   # #   # # #   # #   # #   #   # #     #   #       #     # #
 ##### ####### # ##### # # # # # # ##### # # ### ##### ### ### # ######### ### ### # ### # # ### ### # ######### ##### # ### # #
 #     #       #       # #   # # #       # # #       #     #   # #   #   #   #   #   # #   #   # # # #           #   #   # # # #
 # ##### ##### ######### ####### ##### ##### # # ### ##### # ##### # # ##### ### ### # ##### # # # # ##### # ##### # ##### # # #
 #   #   # #   #       #   #   #     # #   # # # #   #     #     # # #     # #   #     #   # # #   # #   # # #     #   #   #   #
 ### # ### # # # ### # ### # # ##### ### # ### ### ### ######### # ####### # # ####### # ### # ### # # # # # # ####### # # ### #
   # # #   # # # #   #   #   #     # #   #   #   #   #       #   #     # #   #       # #     # #   # # #   # # #   #S# # # #   #
## # # ### # # # # # ############# # # ##### # # ########### # ####### # ##### ##### # ####### # ### ##### # # # # # # # ### # #
 #   #   # # #   # # #       #   # #       # # #           # #       # # #   # #     #     #   #   #     # # # # # # # #     # #
 ### ### # # # ### # # ##### # # # ####### # # ########### # ####### # # # # ### ######### # ##### ##### ### # # # # # ####### #
   # #   #   # #   # #   #   # # #   #   # # #           #   #     #   # # #     #       #   # #   #   #     #   #   # #   #   #
 ### # ######### ### ##### ### # # ### # ### # ######### ##### ######### # ####### # ### ##### # ### ####### ######### # # # ###
     #         #   # #     #   #   #   #     # #       #       #   #     #   # #   #   #       #   #       #     #     # #   # #
#### ######### ### ### ##### # ##### ######### # ####### # # ### # # ### ### # # # ### ### ### ### ### ### # ##### ##### ##### #
     #   #   # # #   # #     # #   # # #       #   #     # #   # # #   #   # #   #   #   #   #     #   #     #     #           #
 ### ### # # # # ### # ##### ### # # # # ### # ### # # ### # # # # ### ##### # ######### ####### ### ### ##### ##### ### #######
 # #   # # # # #     #     # #   # # # # #   #   # # # # # # #   # #   #     # #       # #     #   #   # #     #     #   #     #
 # ### # # # # ########### # # ### # # # ####### # ### # # ####### # ### ####### ##### # # ### ### ### # # ####### ### # # ### #
   # #   # # #       #   #   #   #   #   #   # # # #   # #   #   #   # #     #   #   # # #   # #       # # #   #   #   # #   # #
 ### ####### ####### # # ####### ######### # # # # # ### # # # # # ### ##### # ### # # ### ### # ######### # ### ### # ####### #
       #   #   #     # #   #   #   #       # # # # # #   # #   # #     #   # # # # # #     #   # #   #     #   # # # #       # #
 # ##### # ### # ##### ### ### ### ######### # # # # # ######### # ####### # # # # # ####### ##### # # ####### # # # ####### # #
 #       #     #         #       #           #   #   #           #         #       #       #       #   #         #         #   #
################################################################################################################################
