################################################################################################################################
#       #   #     # #         #     #                       #                       #     #   #   #   # #   #       #           
# ### ### ### ### # # ####### # ### # # ### ############### # ##################### # ### # # # # # # # # # # # ### # ######### 
#   #     #   # # #     #   # #   #   #   #   # #   #   #   # #       #   # #   #   # # # # #   # # # # # # # #   # # #   #   # 
### ####### ### # # ##### # ##### ####### # # # # # ### # ### ####### ### # # # # ### # # # ##### ### # # ### ### ### ### ### # 
#   #     # #     # #     #     #   #   # # #   # # #   # #   #       #   # # #   # # # # #   #   #   #   #   # #     #   #   # 
# ##### # # # ##### # ####### ##### # # # ####### # # ### # # # ####### ### # ##### # # # ### # ### ### ### ### ####### ### ### 
# #     # # #   # # #   #   #   #   # # # #   #   # #     # # # #     # #   # #       # # #   # #   #   #   #       #   #   #   
# # ##### # ### # # ### # # ### # ### # ### # # ### ####### ### # ### # # ### # ####### # ##### # ### ### ### ####### ##### # # 
# # #       #   # # # # # #     #   # #     # #   #       #     #   # #   #   #         # #     # #   #   #           #     # # 
# # ######### ### # # # ########### # ####### ### ####### ########### # ### ##### ####### # ##### # ### ### ########### ##### # 
# # #   #     # #   # # #   #     # # #     #   #   #   #                 # #   #       # #           # # # #   #     # #   # # 
# # # # ### ### # ### # # # # ### # # ##### ####### # # # ### # ######### # # # # ##### # # ####### # # # # # # ##### # ### # ##
# # # #   # #     # # # # # #   # # #     #   #   # # # # #   #   #     # #   # # #     #   #   #   #         #       #     #   
# # # ### # # ##### # # # # ### ### ##### # ### # # # # ### ####### ### ####### # ####### ### # ######### ########### # ####### 
# #   #   # #         #   #     #       # #   # #   # #   #       # #   #       # #     # # # #     #   #           #   #       
# ##### ### ##### ############# # ####### ### # ##### ### ####### # ##### ####### # ### # # # ##### # # # ######### ##### ######
#       #   #   # #       # #   # # #     #   #     #   #         # #     #     # #   # # # # #   # # # # #       #     #       
######### ### # # # ##### # # ### # # ##### # ##### ### ########### # ##### ### # ### # # # # # # # ### # ####### ##### ####### 
#     #   #   #   #     #   #   #   #       #     #   #   #             # #   # #     # #   # # # #     # #     # #   #     #   
# ### # ### # ### ##### ####### ### ############# ### ##### ##### ##### # ##### # ##### ##### # # ####### # ### # # # ##### # ##
#   #   #   # #       # #         #     #       #           #   # #   # #             #       # # #       # #   # # # #   # # # 
### ####### ### ##### # # # ### # ##### # ### # # # ######### # ### # # # ##### ######### ##### # # # ### # # ### # ### # ### # 
#   #     # #   #   # #   # #   #   #   #   # # # #   #     # #     # #   #   # #   #   #   #   # # #   # # #     # #   # #   # 
# ##### # ### ### # # ##### # ##### # ##### # # # ##### ### # ####### ### # # ### # # # ### # ### ### # # # ####### # ##### ### 
#   #   #   # #   #         #     #   # #   # # # #     #   #     #     # # #     # # # #   # # #   # # # #   # #   # #     #   
### # ##### # # ### ### ############# # # ### # # # ##### ####### ##### # # ####### # # ##### # ### # # # ### # # ### # ##### # 
# #   #       # # # #   #           # #   #   #   #     #   #   #     # #   #     # # #         #   # # #     #     #   #   # # 
# ##### # # ### # # # ### ######### # ##### ##### ##### ### # # ##### # # ### ### # # ########### ### # ####### ########### # ##
#       # # #   # # # #   #     #   #     #   #   #   #   # # #     # # #     #   #   #   #       #   #       #             #   
##### ### # # ### # # # ####### # ####### ### # ### ##### # ####### # # # ####### ##### # ############# # # ### ##### ######### 
#     #   # #   # # # #       #   #   #   #   # #   #     #       # # #   #     # #     #   #S    #     # #     #     #         
# # ### ### ### # # # ####### ##### # # ### ### # ### ########### # # ### # ### ### ####### # ### # ##### ####### ### # ########
# # #   #   # # #   #       #   #   # #     #   # # # #         #   #   # #   #     #     #     # # #   #   #     #   #   #   # 
### # ### ### # ### ### # ##### # # # ####### ### # # ####### ######### # ### ########### ####### # # # ### # ##### ##### # # # 
#   #   #   # #   # #   # #   # # # #   #   #     # #       #         # # #   #         # #   #   #   # #   #     # #   #   # # 
# ##### ### # ### # # # ### # # ### ### # # # ##### ####### # ####### ### # ### ####### # # ### ####### # ### ### ### # ##### # 
#     # # #     # # # # #   # #     #   # # #       #       #   #   #     # #   #   #       #   #   #   # #     #     #       # 
### # # # ####### # # ### ########### ##### # # ##### ####### # # # ### ### # ##### # ####### ##### # ### ##### ######### ##### 
#   # # # #   #   # # #   #     #     #   # # #     # #   #   # # #   # #   # #     # #     #     # # #       #   #     #       
# ### # # ### # ##### # ### ### # ##### # # # ##### # ### # ##### ### ### ### # ##### # ### ##### # # ####### ### # ### ### ####
# #   # #   # # #   #     # # #   #     # #   #     #   #     #   # #     #   #       # # #     #   #   #   #   # #   #   #     
# ### # ### # # # # ####### # ####### ### ############# # ##### ### ########### ####### # ############# # # ### ##### ### ##### 
#   # #     # #   #     #   #         #       #       # # #   #   #   #       # #   #     #       #     # #   #       #   #   # 
### # ####### ######### # ######### ######### # ##### # # # # ### # # # ##### # # # # ##### ####### ##### ### # ####### ### # # 
#   #       # #         # #       #     #     # #   # #   # #     # # #     # #   # # #     #     # #   # # # #       # #   # # 
# ####### # # # ######### # ##### ##### # ##### # ### ### # ####### # ####### ##### # # ##### ### # ### # # # ######### ##### # 
# #     # #   #     #   #   # #   #     #       # #   #   #         #   #     #   #   #     # # #   #   # # # #         #     # 
# ### ### # ####### # # ##### # ######### ####### # ### # ### ########### ##### # ### ##### # # ##### ### # # # ######### ##### 
#   #     #       #   #       #         # #     #       # #   #     #     #     #   #     # # #     #   #   # #       # #   #   
### ####### # # # ########### ######### ### ### ######### # ### ### # ##### ### ### # ### # # ##### ### ##### ####### # ### ### 
# #   #   # # # #           # #       #   # # # #       # # #     #   #       # #   #   # #   #     # #   #   #       #   #   # 
# ### # # ### # ##### # ### # ####### ### # # # # ##### # # # ################# ### ### # ##### ### # ### # ### # ####### ### # 
#   # # #   # #     # #   # #       #   # # # # #   #   #     #   #           #   #     #         #         #   # #   #   # #   
# # # ##### # # ### ##### # ####### # ### # # # ### # ####### # # # ######### ### ############# # ### ##### # ### # # # # # ### 
# # #     # # #   #   # # # #     #   #   #   #     # #     #   # # #   #         #         #   #   # #   # # #   # # # #       
# # ##### # # # # ### # # # # # ####### ############# # ### # ### # # # ### ####### ####### # ##### # # # # # ##### # ######### 
# # #   # # # # #   # #   # # #       # #         #   # #   # #   #   #   # #       #     # # # #   # # # #   #   # #         # 
# # ### # # # # ##### ##### # ##### ### # ####### # ### # ### # ##### ### # # ######### # # # # # ##### # ##### # # ######### ##
# # #   #   # # #     #   #   #   #   #   # #   # #     #   # #     #   # # #     #     # # #   #   #   #   #   #     #     #   
# # # ####### ### ##### # # ### # ### ##### # ### ######### # ##### ### # ####### ####### # ##### ### ##### # ######### ### ### 
# #   #     #   # #   # # # #   #   #   #   # #   #       # #   #   #   #       # #       #     # #   #   #   #         # #     
### ### ### ### ### # ### # # ##### # # # # # # ### ##### # ### # ####### ####### # ##### ##### ### ### # ##### ######### ######
#   #   # #   #   # #     # #     # # #   #   #     #   # #     #   #   #   #     #     #   # # #   #   #   #   #     #   #     
# ### ### ### ### # ####### ##### # ################# # # # ####### # # ### # ##### ### ### # # # ### ####### ### ### # ### ### 
# # #     # # # #   #           # # #   #     # #     # # #   #   # # #   # #     #   #   #   #     # #       #     #       #   
# # ####### # # ##### ######### # ### # # ### # # ### ### # # # # ### ### ####### # ##### ### ####### # ####### ### ### ########
#   #   #     #       #         #   # #   #   #     #       # # #     # #     #   #     #   #     #   # #     # # #   # #       
### ### # ##### ### ############### # ##### ### ### ########### ####### ### ### ################# # ### ##### # # ### # # ##### 
# #     # #       # #   #         #   # #   #     # #   # #   #   #   # # #     #       #         #     #       #     # # #   # 
# ### ### ##### # # # # # ####### ##### # ### ### # # # # # # ### ### # # ####### ##### ### ############# ############# ### # # 
#     #   #   # # #   # # #     #     # #   # # # # # #   # #   #   #   #     # # #   #   #           #               #     #   
##### # ### # ### ##### # ##### ##### # ### # # # # # ##### ### ### # ##### # # # ### ### ### ##### # # ##### ####### ##########
#   # #   # #       #   #   #   #     #   # #   # # #   #   #   #   #       #   # #   # #   #   #   #   #   #       #           
# # # ### # ##### # # ##### # ### ####### # ### # # ### # ### ### ### ##### ##### # ### ### # # ######### # ##### ############# 
# # #   # #   #   # #       # #   #     # # #   # #     #   #     #   #   # #     # #         #           #   #   #     #   #   
# # ### # ### # # ########### # ### ### # # ### # ######### ########### # # # ### # # ########### ##### ##### # ### ### # # # # 
# #   # # #   # # #   #       #   #   # # #   # #     #     #           # # #   # # #     # #   # #   #   #   #   # #   # # # # 
# ### # # # ### # # # # # ####### ### # # ### # ##### # ##### ########### # ### ### ##### # # # ### # ##### ##### # # # # ### # 
#   # # #   #   # # # # # #   #   #   # # #   # # #   # #   #   # #       # # #     #   #   # #   # #   #   #   # # # # # #   # 
### # # ##### ##### # # # # # # ### ### # # ### # # ### ### # # # # ####### # ######### ### # ### # ### # ### ### # # ### # ####
#   # #     #   #   #   #   # #       #   # #     #   #   # # #   #   #         #           # #   #   #   # #     # #   # #     
# ##### # # # # # ############# ##### ##### # # ######### # ######### ######### # # ####### # # ##### ##### ##### # ### # # ### 
# #   # # #   #   #     #     # #   # #   # # # #         #         #   #   #     #   #   # # #   #   #   #     # # # #   # #   
# # # # # ### ##### ##### ### ### # ### # # # # # ################# ### # # ### ##### # # # # ### ##### # # ### # # # ##### # ##
# # #   # #       # #   # # #   # #   # #     # #   #   #       # #   #   #   # #     # # #   # #   # # # #   #   #     #   # # 
# # ### # ####### # # # # # ### # ### # # ##### ### # # # ##### # ### ####### ### # ### # ### # ### # # # ### ### ##### ##### # 
# # #   #   #     # # #   #   # # # # # #   # #   #   #   # #   #   #     # # #   # #   #   #     # #   #     #       #       # 
# # ### ### # ##### # ####### # # # # ### # # # # ######### # ### # ##### # # # ### # ##### ##### # ############# ### ######### 
#   #   #   #       # #     #   #   #   # # #   #   #         #   #       #   # #   # # #         #             #   #           
##### # # ### ####### ### # ########### # # ####### # ############# ####### ### ##### # # ######### ########### ####### # ##### 
#     # #   #       # #   #       # #     #       # #   #         #     #   #   #   #   # # #     #   #   #     #   #   #     # 
# # ####### # ####### # ######### # # ########### ##### ######### ##### # ####### # ##### # # ### ### # ### ##### # ##### ##### 
# # #   #   # #   #   #         # # #   #     #   #   #       #   #     #         # #       # #G#   # # #   #   # # #   #   #   
# # ### # ### # # # ####### ### # # ### # ### # ### ##### # ### ### ############### # ####### # ### # # # ### # # # # # # # # ##
# #     #   #   # #       #   # # #   # # #   #     #   # # #   #   #     #         # #       #   # #   #     #   #   # # # # # 
# ######### # ### ####### # ### # ### # # # ######### ### # # ### ### ### # ######### # ####### # # ### ############### # ### # 
# # #       # #         # #   # #   #   # #           #   #           # #   #           #     # # #   #   #     #     # #   # # 
# # # ####### # ### ##### ### # ### ### # ############# ##### ### ##### ##### ########### # # # # ### ### ### ### ### # ### # # 
#   #       # #   # #   #   # #   #   #     #         # #   #   #       #     #         # # # # #   #   #     #   #   # #   #   
########### ##### ### # ### ##### ### ##### # ######### ### ### # ####### ### # ####### # # # # ##### # ####### ### ### # # ####
#       #   #   # #   # #         # # #   #           #   # # # # #         # #   #     # # #   #   # # #     # #   #   # #     
# ##### # ### # # # ### # ######### # # # ### ####### ### # # # # # # # ### # ### # ####### ### # # ### # ### ### ### ### ### ##
#     # # #   # # #   # # #       #     #   # #     #   #   #   #   # #   # #     #   #     #   # #     #   # #   # # #     #   
# ### # ### ### # ### # ### ##### ######### # # ### ### ######### ### ##### ######### # ##### # # ######### # # ### # ##### ### 
#   # #     # # #   # # #   #   #   #       # #   #   #   #   #     #   #   #   #     # #     # #           # #   # #     #   # 
# ### ####### # ##### # # ### ##### # ####### ####### # # # # # # ##### # ### # ######### ##### ############# ### # ##### # # ##
#   # #       # #     #   #   #   # #   # #           # #   # # #     # #     #   #       #     #       #   #   # #       # #   
### # ### ##### # # ######### # ### ### # # # ######### ##### # # ### # ######### # ####### ##### ##### # ##### # ############# 
# # #   # #   # # # #   #   # # #   #   # # # #     #     #   # # #   # #   #     #   #     #     #       #     #   #         # 
# # ### # # # # # # # # # # # # # ##### # # # # ### # ##### ### ### # # # # ########### ######### # ##### # ####### ####### # # 
#   #   #   # #   # # # # #           # #   # # #   # #     # # #   # #   #       # #   #         # #   # #         #     # #   
##### ####### ##### # # ############# # ##### # ##### # ##### # # ### ########### # # ##### ####### # # # ########### ### # ####
#   #       #       # #   #     #             #   #   #       # # #   #     #     # #       #       # # #             #   #     
# # ####### # ####### ### # ### # ############### # ######### # # # ### # ### ##### ######### ####### # # ######### # # ### ### 
# #   #     # #       #   # #   #   #   #         # #       # # # #   # #   # #   # #   #     #       # # #         # #   #   # 
# ### ####### # ####### ##### ### # # # # ########### ##### ### # ##### ### # # # # # ### ### # ####### # # ######### ### ##### 
# #   #     # #   #     # #       #   # #             #   # #   #       #   # # # # # #   #   #   #   # # #         # # #       
# # ### ### # ##### ##### # ########################### # # # ### ####### ### ### # # # ### # ### ### # ####### ##### # ####### 
# #     # # # #     # #     # #           #   #   #     # #   #         #   #   # # #   #   # # #   # # #     #   #   #         
# ####### # ### ##### # ##### # ######### # # # # ####### ##### ##### ##### ### # # ##### ### # ### # # # ### # ### ######### # 
# #   #   # #   #     # #     # #     # #   # # # #     #         # # #     #   # #   #   #   # # #   # # #   # #   # #   #   # 
# # # ### # # ####### # ##### # ### # # ####### # # ### ######### # # # ##### ### # # ### ### # # ### # # # ### # ### # # # ### 
# # #   # #   #     #         #     # # #     # # # # #   #     # #   #     # #   # #   #   #   # #   # # #   # #   # # # # #   
# # ### # ##### ### ######### ####### # # ### # ### # ### # ### # ### ##### # # ####### ### # ### # ### # ### ##### # # ### # ##
# # # #   #     # #             #   # # #   #   #   #   # # # # # # #   #   # #   #     #   #     #   #   # #     # #   #   #   
# # # ### ##### # ############# ### # # ### ##### ##### # # # # # # ### # ### ### # ##### ### ####### ##### ####### # ### ##### 
#   #           #                                 #         #     #     #   #     #       #         #               #     #     
