################################################################################################################################
#         #   #       #   #         #       # #       #       #   #         #   #     #               #       #   #     #       
# ####### ### # ##### # # ####### # # ##### # # ####### ##### # # # ####### # # ### # ############### # # ### # # # ### # ##### 
#       #     # #   #   #   #   # #   # #   #         #   # #   # #   #   #   #   # #       #           #   #   # # #   # # #   
####### ####### # ######### # # # ##### # ##### ##### ### # ##### ### # # ####### # ####### ##### ########### ### # # ### # # ##
#     #   # #   #           # # # #   #   #     #   #   # #   # # #  S# #   #     # #     #     # #   #     # #   # # # #   # # 
# ### ### # # ################# # # # # ######### # ### # # # # # # ### ##### ##### # ### ##### ### # # ### # # ##### # ##### # 
# #   #     #     #   #     #   # # # # #         #   # #   #   #   # #       #     #   #     #   # # # #   # # #     # #   # # 
# # ##### ####### # ### ### # ### # # # # ########### # ####### ##### ############# ####### ##### # # # # ### # # ##### # # # # 
# #     # #     # #     #   # # # # # #   # #       # #   #     #   #         #   #       #     #   #   # # # # # #       # # # 
# ##### # # # ### # ##### ### # # # ####### # ####### ### # ##### # ### # ### # # ####### ##### ######### # # # # # ### ##### # 
# #   # #   #     #     #     #   # #         #     #   #   #     #     # #     #       # #   #     #   # #   #   #   #   #   # 
# # ### # ############# ########### # # ### ### ### ### # ### ### ####### ############# # ### ##### # # # # ####### ##### # ### 
# #   # #   #   # #     # #   #       #   # # # # #     # #   #   #     #     # #       # #   #     # #   #   #     #   #       
# # # # ### # # # # ##### # # # # ####### # # # # ####### # ### ### ### ##### # # ####### # ### ##### ####### # # ### # ########
# # #   # # # # #     #     # # #     #   #   # #     #   #   #   #   #     # # #   #     # #   #   # #     # # # #   #         
# # ##### # # # ##### # ##### # ### # ######### # # ### ##### ############# # # ### ##### # # ### ### # # ### # ### ########### 
# #   #     # #     # # #   # #   # #     #   # # #   # # #   # #       #     # #   #   # #   #   #   # #     #   #       #   # 
##### # ########### # # ### # # # ##### # # # # # ### # # # # # # ##### ####### # ### # # # ### # # ### ######### ####### ### # 
#                   # #   #   # #     # #   #   #   # # #   #   #   #       #         #   # #   # # #   #     #           #   # 
# ################# # ### ##### ##### # ########### # # ########### ####### ############### # ##### # ##### # # ######### # # ##
# #               #       #   # #   # # #           #   #   #     #       #   #   #   #   #     #   # #     #   #       #   #   
# # ############# ##### ### # # # # # # # ####### ####### # # ### ########### # # # # # # # ### # ### ########### ##### ####### 
# # #           #     #   # #   # #   #     #   #         # #   #   #       #   #   # # # #   # # #   #       #   #   #   #   # 
# # ########### ##### # # # ##### ########### # # ### ### # ### ### # ##### ######### ### # # ### # ### ##### # ##### ### # ### 
#   #     #       #   # #     #   #         # # #   #   # # #   #   #   # # #       #   # # # #   #   #     # # #     #   #     
# ### ### # ##### # ### ####### ### ####### # # ####### # # # ### ##### # # # ##### ### # # # # ##### ####### # # ##### ##### ##
#   #   # #   #   #   #       # #   #     # # #     #   # # # # #     # #   #     #   # #   #     #   #   #   # # #   # #   # # 
### ### # ### # # ### ####### ### ### ##### # ##### ##### # # # ### # # ### ### # ##### ### ##### # ### # # ### # # ### ### # # 
#   #   # #   # #   #   #   #     #   #   # # #   #   #   #   # #   # #   #   # # #     #   #   #       #   #   # #     #   #   
# ### ### # ### ### ### # # ####### ### # # # # # ### # ####### # # ##### ### # ### ##### ### # ##### # ##### ### # ##### ##### 
#     # # # # # # # # # # #   #   #   # # #   # #     # #       # # #   # #   #           #   # #   # #     #     # #   #   #   
# ##### # # # # # # # # ##### # ### # # ####### ####### # ##### # ### # ### ############# # ### # # # # ### ####### ### ### # ##
# #   # # #   #   #   #   #   # #   # #       #     #     #   # #     #   #       #   #   # # #   # # #   #       #         #   
### # # # ########### ### # ### # ### ####### ##### # ##### ### ######### ####### # # # ### # ##### # ####### ### # ####### ### 
#   # # #     #       # # #         #   #   #   #   #       #           # #     # # # # #   #   # # #       #   #   #     #     
# ### # ##### # ##### # # ######### # ### # ### # ### # ##### ##### # ### # ### # # # # # ### # # # ####### # # ##### ### # ####
# #   #   #   # #   #   # #       # #   # # #   # #   #     #     # #   #   # #   # # #       #   #     # # # #     # # # #   # 
# # ### # # ##### # # ### # ##### # ### # # # ### # ####### ##### # ### ##### ##### # # ### ########### # # # ####### # # ### # 
# # #   # #   #   #   #   #   #   #   # # #     # #     #     #   # #   #   #     # # #   # #       #   #   #   #     # #   #   
### # ### ### # ##### # ##### # ##### ### ####### ####### ##### ### # ### # ##### # # # # ### ##### # ########### ##### ### ####
#   # # #   #   #   # # #     # #   # #   #     #   #   # #     #   # # # #       # #   #     # #   #         #   #       #     
# ### # ### ##### ### ### ##### # # # # ### ### ### # # ### ##### # # # # ######### ### ##### # # ########### # ### # ######### 
#   # #       #       #   #     # #     # # # #     # # #   #     # # # #       # #   # #   #   #         #   #     # #   #   # 
### ### ####### ####### ############# ### # # ######### # ### ####### # ####### # ##### # # ############# # ##### ##### # # # # 
#   #   #       #     #   #         #   # #   #     #   # # #     #   #     #           # #         #   # #       #   # #   #   
# ### # # ####### ### # ### ####### ### # ##### # ### ### # # ### # ### ##### ########### ######### ### # # ####### # ##########
# #   #       #     # # #   #   #   # # #       # #   #   # # #   # #   #   # #           #       #   #   # #       #           
# ##### ##### # ##### # # ### # # ### # # ######### ### ### ### # # ### # # # # ########### ### ##### ##### # ################# 
#     # #   # # # #   # # #   # #   # # #   #     #   #   #     # #   #   #   # #             # #   # #     #   #   #   #       
##### ### # # # # # ### # ### # ### # # ### # ### ### ### ##### ##### # ####### # ####### ### # # # # ####### ### # # ### ######
# #   #   #       #     #     #   # # # #   # # # # #   # #   # #   # #       # #       #   # #   # #         #   #   #   #   # 
# # ### ### ##### ##### ######### # # # ### # # # # ### # ### # # # # # ##### # # ##### ### # ### # ########### ####### ### # # 
# #     #     #   #   #     #   # # #   #   # # # #   # # #   # # #   #     #       # # #   #   # #         # #         #   # # 
# # ##### # # ##### # ### ### ### # ### # # # # # ### # # # ### # ##### ########### # # # ##### # ##### ### # ############### # 
#   #     # # #   # #   #     #   #   # # # #   #     #   # #   # #     #       #   #   # #   # # #   #   #     #     #       # 
##### ##### # # # # ### ### ### ##### # ### ######### ##### # ### # ##### ##### # ####### # ### # # # ### ### # # # # # ####### 
#     #   # #   # #   #   # #   #   # #   #       #   #       #   #       #     #     #   #     # # # # #   # #   # #   #       
# ####### # ##### ### ### ### ### # # ### # ####### ### # ##### ######### # ######### # # ####### # # # ### ####### # ### ######
#   #   #   #   # #   # # #   #   # # # # # #     #     # #     #       # # #     #   # # #     #   #   #   #   #   #   #   #   
# # # # ##### # # # ### # # ### ### # # # # # ### ####### # ########### # # ##### # ##### # ##### ####### ### ### ### # ### ### 
# #   # #     # # # #   #   # # #     #   # # #   #     # #       #     # # #   # # #     #           #   # #     #   #   #   # 
# ##### ### ### # # # # ##### # ######### # # # ### ### # ####### # ##### ### # # # ### ######### ### # ### ####### # ####### # 
#     #   # #   #   # #     # #     #   #     #   #   #         #   # #       # # # #   #         # # # #           # #       # 
# ####### # # ########### # # ##### ### ##### ### ### ### # ### ##### # # # ### # # # ############# # # ### # ####### # ####### 
# #     # # #           # # #     #   #     # # #   #   # #   #       # # #   # # # #     #     #     #   # # #   #   # # #   # 
# # ### # # ########### # ####### ### ##### # # ##### # ##### # ### ### # ##### # # ##### # ### # ####### # # # # # ### # # ### 
# # #     #     # #     # #       # #       #   #   # # #   # #   #     # #   # # # #   # #   # # #       # # # # #     #   #   
# # ####### ### # # ##### # ####### ######### ### # ### # # # ### # ##### # # # # # # # # ##### ### ######### # # # ##### ### ##
# #   #   # #   #   #   # # #       #         #   #     # #   # # #     # # # # # # # #   #     #   #       # # # #         #   
##### ### # # ### ### # # # # ####### # ##### # ######### ##### # ####### ### # # # ####### ##### ### ##### ### # ####### # ### 
#     #   # #   #     #     # # #     # #   # # #   #     #     #   #   #     # # #       # #        G# #   #   #     #   #   # 
# ##### ### ############### # # # ##### # # # # # # # ### ##### ### # # ####### # ####### # ########### # ### ####### # ##### # 
# #     # #   #           #     #   #   # # # #   # #   # #   # #   # # #       #   #   # #     #       #   #   #   # # #   #   
# # ##### # # # ######### ### ##### # ### # ####### ### # # # # # ### # ######### ### # # ##### ##### ##### ### # # # ### # # ##
#   #       # # #       #   #     # #     #   #     # # # # # # #     #         #     # #     #     #   # #   # # # #   # # #   
############# # # ######### # ##### ######### # ##### # # # # # ############### ### ### ##### ##### ### # ### # # ##### ### ### 
#       #   # #   #   #     # #           #   # #   #   #   # # #           #   #   #   #   # #     # # #   # # #     # #   #   
# ##### # # ####### # # ##### # ########### ### # # ######### # # ########### ### ### # ### # # ##### # ### # # # ##### # ### ##
#   # # # #   # #   # # #   # # #   #     # #   # # #       # # # #     #     #     # #   # #   # #   #   # #   # #     # #     
### # # ##### # # ### # # # # # ### # ### # # # ### # ####### # # # ### # ######### # ### # ##### # ##### # ##### # ##### # ### 
#   # # #   # #   # #   # #   #   # # #   # # # #   # #       # # # #   # #         #   # #   # # #   # #     # # #       # #   
# ### # # # # # ### ######### ### # # # ### # ### ### # ####### # # ##### # # # ####### # ### # # ### # ##### # # ########### # 
#   #   # #   # #             #   # # # #   #     # #   #     #   #       # # #       # #         #         # # # #           # 
### # ### ##### # ############# ### # ### ######### ##### ### ### ######### ########### # ######### ####### # # # ####### ##### 
#   #   #   #   # #       #     #   #     #   #             #                 #         # #         #     # # # # #       #     
# ##### ### # ### # ##### # ##### # ####### # ### # # # ### ####### ######### # ### ##### # ######### ### # # # # # ####### # ##
#   #   #         # #   # # #     #     # # #   # # # #   #   #   #     #     #   # #     # #     # #   # # #   # # #       # # 
### ### # # ####### # ### # # ######### # # ### # # # ####### # # ####### ### ### # # ### # ### # # ### # ##### # # # ##### # # 
# #   #   # #   #   # #   #   #       # # # # # # # # #       # # #       #   #   # #   # #     #     # # #   # #   # #     #   
# ### ##### # # # ### # ####### ##### # # # # # ### # # ####### # # ####### ### ### ##### ### ####### # ### ### ##### # ########
#     #   # # # #     # #       #   # # # # # #   # # #     #   #   #         #   #   #       #   #   # #             #     #   
######### # # ######### ### # # # # # # # # # ### # # ##### # ####### ########### ##### ####### # # # # # ##### # # ####### ### 
# #     # # #           #   # # # # #     #   # # # # #   # # #   #     #       #     #   #   # # # #     #     # # #     # #   
# # ### # # ### ####### # # # ### # ##### ### # # # # # # # # # # # ##### ########### ### ### # # ######### ##### # # ### # # ##
# #   # # # #   #     #   # #   # #   #   #   # # # #   # # #   # # #   # #   #       # #     # #     #   #     # #   #   #   # 
# ### # # # ### # ### ######### # ### # # # ### # ####### # ##### ### # # # # # ####### ####### ##### # # ##### # ##### # ##### 
#     # # #     # # #         # # # # # # # #   #   #     #     #   # #   # # #       #   #   # #     # #       #     # #   #   
####### # ##### # # ######### # # # # ### # ### ### ####### # ##### # ##### ######### # # # ### ##### ############# # # ##### # 
#   #           #   #   #   #   # #   #   #       #     #   #     #   #   #     #     # #   #   #   #   #           # #       # 
# # ######### # ##### # # ####### # ### # ####### ##### # ####### ##### ####### # ##### ##### ### # ### # ##################### 
# #           #   # # # #   #     #     #   # #   #   # # # #   #               # #   #     #   # #   #   #                     
# ############# # # # # ### # ############# # # ### # ### # # # # # ####### ##### # # # ### ### # ### ### # ####################
# #   #   #   # # #   # #   #             #   # #   #     #   #   #   #   # #   # # # # # #   #   #   #   #       # #       #   
# ### # # # # # # ##### # ############### ### # ### ### ############### # ### # # # ### # ######### ### # ####### # # ##### # # 
#     # # # #   #       #   #     # #   #   #       #   #     #         # #   # # #       #       # # # # #   # # #   #       # 
######### # ##### ######### # ### # # # ##### ########### ### # ### ##### # ### # # ####### ####### # # ### # # # ##### ### ####
# #       #   #   #       # # # # # # #       #           #   #   # #   # # # #   #       # #       # # #   #   # #     # # #   
# # ######### # # # # ##### # # # # # ######### ########### ##### # # ### # # ##### ##### # # ####### # # ####### # ##### # # # 
# #           # # # #       # #   # #   # #     #       # #   #   # #   #   # #   # # #   # #       #   #   #     # #       # # 
# ############# ### ######### ##### ### # # ##### ##### # ### # ### ### ##### # # # # # # # ####### ####### # ### ### ####### # 
#       #         # #       # #   #   # # # #   # #   # #   #   #   #   #   #   #     # # # #     #   #     #   # #   #     # # 
# # ### # ##### # # # # # ### # # # # # # # # # # # # # ### ####### # ##### # ######### ### # # ##### # ######### # ### ### # # 
# #   # # # #   #   # # #       #   # #   # # # # # # #             # #     #   #     #   # # #     # #           #       # # # 
# ### # # # # # ##### # ############# ##### # # ### # ####### ####### # ##### # # ### ### # # ##### # ############# ##### # ### 
#   # #   #   #       #     #       # #   #   #     #       # #       #   #   # # # # #   # #   #   #                   # #   # 
### # ######### ### ####### # ##### # # # ################# ### ######### # ##### # # # ### ### ######### ### # ####### # ### # 
#   #       #   #   #       # #   # #   #       #         #     #     #   #   #   # # #   #   #   # #   # #   #   #   # #   # # 
# ######### # ### ########### # # ######### # # # ####### ####### ### # ### ### ### # ### ### ### # # # # # ### # # ### ### # # 
# #         # # #   #     #   # # #     #   # #   #   # #   # #   # # #     #   #   # #     # #   #   # # # #   # #     #   #   
# # ######### # ##### ### # ### # # ### # ### ####### # ### # # ### # ##### # ##### # # ##### # ####### # # ##### ### ##### ####
# #     #     # # #   # # # #   #   # #   #               # #   #   # #   #       # # #     # #         # #     #   # #   #   # 
# ##### # ### # # # ### # # # ####### ##### # ### ####### # ##### ### # # ####### # # ##### # ######### # ##### ### # # # ### # 
#   #   #   #     #   #   # # #       #     # #   #     # #         # # #   #       #     # # #     #   #     # #   # # #   #   
# ### ################# ### # # ### # ##### # ##### ### ######### ### ##### # ########### # # ### ### ####### # ##### # ### # ##
#   #             #   # # # # # # # #       # #     #   #       #     #   # #   #       # # #   #   # #     # #   #   # # # # # 
### ############# # # # # # # # # # ########### ##### ### # ########### # # # # # ##### # ##### # # # # ### # # # ##### # # # # 
#               #   #   #     #   #                 #     #             #     #   #     #         #   #   #   # #       #   #   
