################################################################################################################################
#               # #       #         #   #   #   #   # #         #       #       #     #       #             #       #   # #     
# ######### ### # # ##### ### ##### # ### # # # ### # # ####### # ### # # ##### ##### # ##### # ##### # ##### ##### # # # # ### 
#     #   #   # # # #   #   # #   # #     # # #     #   #   # # # # # #   #   #     # #     #       # # #   #     #   #   # #   
##### # # ### # # # # ##### # # ### # ##### # ########### # # # # # # ##### # ##### # ############# # ### # ### ##### ##### # ##
#   # # # # # #   # #       # #     # #   # #             # # # #   #   #   #   #   #     #   #     #     #     #   # #     # # 
# # # ### # # # ### ######### ####### # ### ############### # # # ####### ##### # ####### # # # ################# # ### ##### # 
# #   #   # # # #   #     #   #           #           #     # # # #     #   # # # #     #   #   #                 #     #   # # 
# ##### ### # ### ####### # ### ######### ############# ##### # ### ### ### # # # ### # ####### # ####################### ### # 
# #   # #   #     #             #     #   #       #     #   # #     # #   # # #   #   #     #   # #         #             #   # 
# # # # # # ####### # ######### # ### # ### ##### # ##### ### ####### ### # # ##### ####### # ### ### ##### # ##### ####### # # 
# # # #   #   #   # # #     # # # # # # #       # # #   #   # #         # # #   #   #     # # # # #   #   # #     # #   #   # # 
# # # ####### # # # # # ### # # # # # # # ####### # # # # # # # ######### # # # ##### ### # # # # # ### ### # ### # # # # ### # 
# # # #       # #   # # # # #   # #   #   #       # # #   #   # # #   #   # # # #   # #         # # #   #   # #   # # # #   # # 
# # # # ##### # ##### # # # # ### ####### # ####### ##### ##### # # # # ### # # # # ### ######### # # # # ### # ##### # ### ### 
# # # # #   #   #   # # # # #     # #   # #   #     #   # #     # # #   #     #   #   #   #       # # # # # # # #     #   #     
# # # ### # ##### # # # # # ### ### # # ##### # ##### # # # ##### # ####### ######### ### # ######### # # # # # # ####### ######
#   # #   #     # #   # # #   # #   # #     # #   #   # # #   #   # #     # #     #     # #   #       # # #   #   #   #         
##### # ####### ####### # ### # # ### ##### # ### ##### # ### # # # ### # ### ### ##### # ### # ####### # # ######### # ##### # 
# #   # #     #         #   # # # # #     # #   #   #   #   #   # #   # #   #   #     #     # # #     #     #   #   # # #   # # 
# # ### # ############### ### # # # ##### # ####### ### ### ##### ### # ### ### ##### ### ### # ### ##### # # # ### # # ### # # 
# #     #                 #   # # # #   # #       #   #   # #     #   #   #     #   # # # #   #   # #   # #   #       #   # # # 
# ####### ######### ##### # ### # # ### # ##### ##### ### # # ### # ############# # # # # # ##### # # # # ########### ### # # # 
#       #     #     #   # # #   # #     #     #       #   #   #   #         #   # #   # # # #   #   # # # #         #   # # # # 
# # ######### # ##### ### # # ### ##### ##### ######### ####### ########### # # # ##### # # ### # ### # ### ####### ### # # ### 
# # #         #     #     # #           #   # #       #         #   #   #   # # # #           #   #   #   # #     #   # # #   # 
# # # ############# ##### # ##### ####### # # # # ### # ######### # # # # ##### # ########### # ### ##### # ##### ### # # ### ##
# # # #           # #   # #     #       # #   # #   #   #   #     #   # # #     #     #   #         #     #   # #   # # #   #   
# # # # ######### ### # # ##### # ##### # ##### ### # ### # # ######### # # ######### # # # ### ##### ####### # # ### # ### ### 
# # # # #   #   #     # #   # # #     #   #   # #   # #   # #   #     #   #       #   # # #   #   #   #     #     #   #   #     
### # # # # # ######### ### # # ##### ##### # # # ### # ### ### # ### ##### ### ### ##### # # # # # ### # ##### ### ### # ######
#   # # # #   #   #   #   #   #   # #   # # # # # #   # # #   # # # #     # # #   # #       # # # #     #     # #   #   #       
# ### # # ### # # # # ### ####### # ### # # # # # # ### # # ### # # ##### # # ### # # # ### # # # ######### # # # ######### # # 
# #   #   # # # #   #   #       # #     #   #   # #   # # #   # #   # #   # #   #   # #   # # # #         # # # # #     #   # # 
# # ####### # # ####### ##### ### # ##### ####### ##### # ### # ##### # ### ### ##### ### # # # ######### # ### # ##### # ### # 
# #     #     #   #   #     #     #   #   #     #       #   #   #         #           #   # # # #   #   # # #   #     # # #   # 
# ##### # ####### # ####### # ####### # ##### ########### # ##### ####### # ### ##### ####### ### # # # ### # ##### # # # ##### 
# #     # #     # # #       #     #   #   #   #   #       #     # #   # # #   # #   #       # #   #   #   #   # #   # # #     # 
# # ##### # ### # # # ######### # # ##### # ### # ##### ####### ### # # # # # ### # ####### ### ##### ### ##### # ##### # ### # 
#     #   #   # # #   #         #   #     #   # #   #   #   # #   # # # # # #   # #     #   #   #   # #   #   # #   #   # #   # 
##### # ##### # # ##### # ####### ### ##### # ##### # ### # # ### # # # # # ### # ##### ##### ### # ### ### # # ### # ### # ####
#   # #     # # # #     #       #   # #   # #   #   #   # # #     # # # # #   #     #   #     # # # #   #   # #   #   #   #     
# # # ### ### # # ############# # # # # ### ### # ##### # # # ##### # # # # # ####### ### ##### # # # ##### # ### ##### ####### 
# # #     #   #   #       #     # #   # #   #   # #   #   # # #   # # #   # # #     # #   #   # # #   #     #           #   #   
# # # ##### ####### ####### ##### ##### # ### ### # ####### # # ### # ### # # # ### ### ### # # # ####### # ##### # ### ### # ##
# # #     # # #   #         #             # # #   #     #   # # #   #   # # # #   # #   #   #   # #   #   # #     #   #     #   
# # ### ### # # ############# # ##### ##### # # ### ### ##### # # ##### # # ##### # # ### ##### # # ### ### # ####### ######### 
# # #   #   #       #         #     # #     #   #   # #       #   #   # # #   # # #   #   # #   # #   #   # #       #       #   
# # # ### ######### # ##### ####### # ##### ##### ### ############# # # # ### # # ##### ### # ### ### # # # ####### ####### # ##
# # #       #   # #   # #   #       #       #     # #       #     # #           #   # #     #   #   # # # #     #     #     # # 
### # ####### # # ##### # ### ####### ####### ##### ####### # ### ##### ####### ### # ####### ##### # ### ####### ##### ##### # 
#     #       # #         #   #       #     # #           #   # # #   # #     # # # #     #   #     #     #     # #     #   # # 
# ##### ####### # # ####### ##### # ### # ### # ####### ####### # # # # # ### # # # ##### # ### ########### ### # # ##### # # # 
#     # #     # # #   #     # #   # #   #     # #     # #       # # # #   #   #   #   #   #   # #           # #   # #     # #   
# ### # # ##### # ##### ##### # # # # ######### ##### # # ####### ### # ############# # # ### # # ########### ### # # ##### ####
#   #   # #   # #   #   #   #   # #   #           #   #   #   # #   #   #           # # #     # #   #     # #   # # # #   # #   
### ##### # # # # ### ### # ##### ####### ####### # # ##### # # ### ### # ####### ### ####### # # # # ### # # # # # # ### # # # 
#   #       # # # #   #   # #     #     #   #   #   # #     #           # #     #     #     # # # # #   # #   # # # #     # # # 
# ### ####### # # # ### ### ### # # ### ##### # ##### ### ############# # # ########### ### # # # # ### # ##### # # ####### ### 
#   #       # # # # #   # #     #   # # #   # #     #     #   #       #   #   #       # # # # # # #   # #   # #   #       #     
### ##### ### # ### ##### ##### ##### # # # # ##### ####### # # ##### # ### # # ### # # # # # # ##### # ### # ### ##### # ##### 
#         #   #   #   # #       #     # # # # #   #     #   #   #   # #     #     # #   #   # #     # # #   #     #     #   #   
# ######### ##### ### # ### # # # ### # ### # # ####### # ####### # # # ### ####### # ####### ##### ### # ##### # # ######### ##
# #     #   #     #   #     # #   #   #   #   # #     #   # #     #   #   #   #     #             #     # #     # # #       #   
# ##### ##### ##### ######### ##### ##### ##### # ### ##### # ######### # ##### ####### # ####### ####### ####### # # ##### ### 
#   #   #   # # #   #     #   #   # #       #     #   #       #         #     # #     # # # #   # #     #       # #   #   #   # 
### # ### # # # # ### # # # ### # # # ####### ##### # # ####### ### ##### ### # ##### # # # # # # # ########### # ##### # ### # 
#   #     #   #   #   # #   #   #   # #       #   # # # # #       #     #   # #     #   # #   # # # #     # #   #       #   #   
# ################# ### ####### ### # # ######### # # # # # ######### # ### # # ### ##### ##### # # # ### # # ### ##### ### ####
# #   #   #   #   #   #       # #   #   #   #     # # # #   #   #   # # # # # #   #   #     #   # # #   # # # #     #   #       
# # # # # ### # ##### ####### # ### ##### # ##### # ### # ### # # # # # # # # ####### # ##### ### # ### # # # ##### # ### ######
#   # # # #   #             # #   #   # # #   #   #     #   # #   # # # #   # #       #         #   #   # # #     # #   #       
##### # # # ######### ####### ### # # # # ### # ######### ### ##### ### ##### # ##################### ### # # ### ##### ####### 
#     # # #     #   #     #   #   # # #   #   #   #       #   #   #   # #     #   #         #   #   # #   # #   #   # #     #   
##### # # ##### # # # ### # ### ### # ##### ### # # ### # # ### ##### # # ####### ######### # # # # # # ### ####### # ##### # ##
#   # # #     # # #     # # #   #   #     # #   #   #   # # # #       # # #     #   #   #   # #   # # # # #         # #     # # 
# # # # ##### # # ##### # # ##### ##### ### # ####### ##### # ######### # ##### ### # # # ### ##### # # # ########### # ##### # 
# #   #     # #   #   # # #   #   #   # #   # #       #     # #         #   #   #   # #     #     #   # #       #     #   #     
# ### ##### # ##### # # # ### # # # # # # ### ######### ##### # ########### # ### ### ################# # ##### # ####### ### ##
#   # # #   # #     # # #   # # # # # #     # #     #   #     #           # #   #   #   # #             # #     #         #   # 
##### # # ### # ##### ##### # # ### # ### # # # ### # ### ############### # ### # # ### # # ############# ################# ### 
# #     # # # # #   # #   # # # #   #   # #   # # #   #                 # #     # #     # #   #     #   #     #               # 
# # ##### # # # # # # # # ### ### ##### # ##### # ##### ####### ####### # ####### ####### ### # ##### # ##### ### # ### ##### # 
#   # #   # #   # # #   #   # #   #   # #         #   # #     # #       #   #   #         # # # #     #           #   # #     # 
# ### # ### ####### ####### # # ##### # ##### ##### # # # ### # ####### ### # # # ####### # # # # ##### ############# ### ##### 
#   # # #                 # # # #   # # #   # #     # # # # # # #         #   # #   #   #   # #   #     #     #     #   #       
### # # # ############### # ### # # # # # # ### ##### # # # # ### ####### ##### ### # # ##### ##### ##### ### # ### ### ########
#   # # # #   #       #   #     # #   #   #     #   # # # #   #   #       #     #   # #     # #   #     #   #   # # #           
# ### # ### # ### ##### ######### ### ############# # ### ##### ### ####### ######### ##### # # # ######### ##### # # ### ######
#     #   # #   # #   # #     # #   # #             #   #     # #   #   #   #       #   # #   # #   #   #   #     # # # #       
# ####### # ### # # # # # ### # ### # ############# ### ##### # # ### # # ### ##### ### # ##### ### # # # ### ### # # # ####### 
#     #   # #   #   #   #   #   # # # #     #     # # #       # #   # #   #   #       # #     #   # # #   #   #   #   #         
# ### # ##### ### ##### ### ##### # # # ### # ### # # ############# # ### # ### ### ### # ####### ### ##### ### # ############# 
# #   #     # #   #   #   # #     # # #   # # # # #         #       #   # #   #   # #   #   #   # #   #       # #               
# ######### # ### # # ##### # ### # # ### # # # # ######### # ######### ##### ### ### ##### # ### # ### # ##### ############### 
#           # #   # #       #   # # #   # #   # #       #   #   #     #       #   #   #         #   #   # #     #     #         
# ########### # ### ####### # ### # ### # ##### ####### # # ### # # # ######### ### ########### ####### ### ##### ### # ##### ##
#           #   #   #     #   #   #   #   #           # # #       # # #   #   #   #           #         #   #     #   #   # #   
# ######### ### # ### ### ### # ##### ##### ### # ### # ##### # ### # # # # ##### ########### # ##### # # ### # ### ##### # ### 
#   #     # #   # #   # #   # #     #   #   #   #   # # #   # # #   # # # #   # #   #   #     #     # # # #   #   #     #   # # 
### # ##### ### # # ### ### # ##### ### # ######### # # # # # # # ### # ##### # ### # # # ######### # ### ### ### ##### ### # # 
#   # #   #   # # #     #   #     # # # #   #     # # #   #   # #   #   #   # #   # # #   #         #   #   # #   #   #   #   # 
# ### # # ### # # ##### # ####### # # # ### # ### # # ######### ####### # ### ### # # ##### ####### ### ### ### ### ##### # ### 
# #   # #     # # #   # # #   #   #   #   #   #   # #       #     #         #     #   # #   #         #   #   #   #       # #   
# ### # ####### # # ### # ### ########### # ####### ##### # ### # # ####### ##### ##### # ##### # ####### ### ### ####### ### ##
#     #   #         #   # #   #           # #     # #     #     # #   #   #           #   #     #     # # #   #   #     #   #   
##### ### # ####### # ### # ### ########### # ### ### ########### ### # # ########### ### ########### # # # ### # # ### ### ### 
#   # # # # #     #     #     #   #     #   # # #   # #           # # # # #   #         # #         #   # # #   # #   #   #   # 
# # # # # ### ### ### ########### ##### # # # # ### # # # ##### # # # # ### # # ##### # # # ####### ##### # ### ##### ### ### # 
# #   # #       # #   #       # #     #   # # # # #   # #     # #   # #   # # #     # #   # #   #         #   #   # # #   #   # 
# ##### ####### # # # # ##### # # ### ### ### # # ########### # ##### ### # # ##### # ##### ### ### ######### ### # # ####### # 
#       #     # # # # # #   #   #   # #   #   #               # #     # #   #       #     #   #     #       #   #   #   #   #   
####### # ### # # ### # ### ####### # ##### ######### ######### # ##### ##################### ##### # ######### ####### # # ####
# #   # #   # # #   # #           # # #     #       #     #     #       #   #   #     #       #   # #       # #       #   #     
# # # # ### # ##### # ########### # # # ### # ##### ##### # ### ########### ### # ### # ####### # # ####### # ##### # ######### 
#   #   # # # #   # #       #     # # #   # # #     #   # #  G#       #   #   # #   # # #       # #       #   #     #   #     # 
##### ### # # # # # # ####### ####### # # ### # ####### # ### ######### # ### # ##### # # ####### ### # ##### # ##### ### ### # 
#   # # #   # # #   #       # #       # # #   # #       #   # #       # #     #   #   #   #     # #   # #     #     #   # #   # 
# # # # ##### # ########### # ##### ### # # ### # ######### # # ##### # ######### # ####### ##### ##### # ######### # # # # ### 
# #         #   #     #     # #     #   # # # # #           #   #   # # #         # #     #   #   #   # #         # # # # # # # 
# # ##### # ##### ### # ##### # ######### # # # ########### ##### # # # # ######### # ### # # # # # # # ####### ### # # # # # # 
# # #   # #     #   # #     #   #         # # #   #               # #   #     #         #   # # # # # #     #   #   # #   #   # 
# ### # # ######### # # ### ##### ### ##### # ### # ############### ######### # # ############# ### # # ##### ### ############# 
# #   # # #     #   # # #     #   #   #   #   #   #     #     #           #   # #             #   # # # # #   # #   #         # 
# # ### ### ### ##### # # ### # # # ### # ##### ######### ### # ####### # # ### ############# ### # # # # # ### ### # ####### # 
#   # #   # # #      S# #   #   # # #   #   #   #         #   #       # #             #     #   #   # #   #   #   #   # #     # 
# ### ### # # ######### ### ##### ### ##### # ### # ####### ######### # ############### ### # ####### ####### # ####### # ##### 
#       #   #             #     #         #   #   #       #           #                 #   #       #                   #       
