################################################################################################################################
################################################################################################################################
#   #       #     #     #       #   #   # #     #     # #     #           #   #   #         #       #                   #       
# # ##### ### # # # ### # ##### # ### # # # ##### ### # # ### # ####### ### # # # # ######### ##### # ################# # ##### 
# # #   # #   # # # # #     #   #   # # #     #     #   #   #   #     #     # # # #           #   #   #             #   # #   # 
# # # # # # ### ### # ####### ##### # # ### ### ########### ##### # ######### # # ############# ####### # ######### # ##### # # 
# # # #   #   #   # # #   #   #   #   #   # #   # #               #     #   #   #   #                   # #   # #   # #     # # 
# # # ##### ##### # # # # # ##### ####### # # ### # ######### # ##### # # ######### ### ##### ##### ##### # # # # ### ####### # 
# # #       #   # # # # # # #   #     #   #             #   # # #     # #   #     #   #   # # # #   #   # # # #     #       #   
### # ####### # # # # ### # ### # ### # ######### ####### # # ### ### ##### # # ##### # # # # # # # # # ### # ##### ####### ### 
#   # #       #   # # #   #     # #   #   #     # #   #   # #   # #   #   # # # #     # #   #   # # # #     # #   #     #       
# ### # ########### # # # ####### # ##### # ### # # # # ### ### # ##### # # # ### ##### ######### # # ####### # # ##### # ######
#   # #     #     # #   #         #   # # # #   # # # #   # # # #   #   # # #   # #   # #   #   # # #       # # #       #   #   
### # ##### # ### # ################# # # # ##### # # ##### # # ### # ### # # # # # # # ### # # # ########### ######### ### # # 
#     #     #   #   #       #           # #   #     # #     # #   #     #   # # #   # # #   # # #       #   #     #   #   # # # 
# # ########### ##### ##### # ### ####### ### # ####### ##### ### ####### ### ####### # # ### # ######### # ##### # # ### # # ##
# # #           #       #   # #   #       # #   #       #       # #     # #   #   #   # #     #       #   #       # #           
### # ################# # ##### ### ####### ### # ############# # # ### # # ### # # ### ########### ### ########### # ######### 
#   #         #       # # #   #   # #       #   #     #       # #   # # # #   # # # #       #   #   #   #         # #   #     # 
# ########### ####### # # # # ### # # ### # # ####### ### ### # ##### # # ### # # # # ####### # # ### ### ####### ##### # ### # 
#                   #   # # # #   # #   # #       # # #   #   # #   #   #     # #   #       # #   #   # #   #   #     # #   # # 
##### # ########### ##### ### # ### ### # ####### # # # ### ### # # ##### ##### ####### ### # ##### ### ### # # ##### ##### # # 
#   # # #     #         # #         #   # #     # # #   #   #   # # #       #   #     #   #   #     #   # #   #     # #   # #   
# # # ### ### # ####### # # ##### ### ### # ### # # ##### ### ### # # ####### # # ### ### ##### ##### ### ### ##### # # # ##### 
# # #   #   # # #   #           #       # #   # #   #   # # #     # #     #   # # # #   #     #   #   #     # #   # #   #   # # 
# # ### ##### # # # # ######### # ##### # ### # ##### # # # ####### ##### # ##### # ### ######### # ##### ### # # ######### # # 
# # #   #     # # # # #   #     #   #   # # # #       #   # #   # #       #       #   #           #     # #   # #     #     # # 
# # ##### ####### # # # # # ####### ##### # # ############# # # # ####### ########### ################# # # ### ##### # ##### # 
# # #     #       # #   # # #   #   #   #   #     #     #     #     #           #   #   #             #   # # #     #   #     # 
# # # ##### ####### # ### # # # # ### # ######### ### # # # ####### # ##### ### ### # ### ########### ### # # ##### ######### # 
# # #       #     #   #   # # # #     # #       #     # # # #   #   #     #   # #   #   # #   #     #   #   #     #   #   #   # 
# # ######### ##### ######### # ### ### # ### ######### # ### # ######### # # # # ### # # # # # ### ### ### # ### ### # # # # # 
# #   #   #   #     #         #   # # #     #     #     # #   # #     #   # # # #   # # #   # #   #   #   #   # # #   # # # #   
##### # ### ### ##### ########### # # ######### # # ##### # ### # ##### ### # # ### # ####### # ######### ##### # ##### # ##### 
#     #   #   # #   # #     #   # # #   #       # # #   # #   # #       #   # #     # #     # #   #     #   #           # #     
# ####### ### # # # # ##### # # # # ### # ####### # # # # ### ########### ### ####### # ### # # # # ### ### ############# # ### 
#   #   #         #           # # #     # #   #   #   # #       #   #   # #     #       #   # # # #   #   # #   #   # #   #   # 
### # # ######### ### ########### ####### # # # ####### # ##### # # # # # ##### # ####### ### # # ### ### # # # # # # # ####### 
# #   #         #   #       #   # #     #   # # #     # # #   #   # # # # #   # #     # #       #   # # # #   # # # #   #       
# ############# # # ######### # # # ### # ### ### # ### ### # ### ### # # # # # ##### # ############# # # # ### ### # ### ##### 
# #   #         # # #   #     # #   # # #   # #   #   #     #   #   # # #   # #     # #   # #       # # # # #   #   #   # #     
# # # # ######### ### # # ##### # ### # ##### # ##### ######### ### # ####### # # # # # # # # ##### # # # # # ### ##### # # ### 
# # # # #         #   #   #   # #     #     #   #   #   #     # #   #         # # # #   # # # #   # # # # # #   #     #   #   # 
# ### # # ##### # # ####### # # ##### ##### ##### # ### # ### # # # ########### # ####### # # ### # # # # # ### ##### ### ##### 
#     # # #   # # #     # # #   #     #     #   # #   #   #   # # #   #   #     #         #   #   #   # # # #   #   #   # #   # 
### ### # ### # ####### # # ##### # ### ####### # ######### # # ### ### # # ### ############### ####### # ### ### ##### ### # # 
#   #   #   # #     #   # # #     # #   #       # #   #   # # #   #     # # #                           # #   # #     #     # # 
# ### ##### # ### # # ### # # # ##### ####### # # # # # # # ##### ####### # # ######### ##### ### # ##### # ### # # ######### # 
#   #   #     #   # # # #   # #     # #     # # # # #   # #     #   #   #   #         # #   #   # # #   #   #     #   #     # # 
### ### ##### ####### # # ######### # ### # # # # # ##### ##### ### # # ############# ### # ### # # # # ##### ####### # # ### # 
#   # #     # #       # # #       # #   # #   #     #   #     #     # #           # #     #   # # #   #       #     # # #   #   
# ### ##### # # ####### # # ####### ### # ########### # ##### ####### ########### # ######### ### # ########### ##### # ### ### 
#       #     #       #   #         #   #   #     #   #           #   #   #     # # #   #     #   #   #       # #   #   #   #   
# ##### # ### ####### # ####### ##### ##### # ### ####### ####### # ### # # ### # # # # # ##### ### # ####### # # # ##### ### ##
# #   #   #   #     # # #       #     #   # #   #   #   # #   #   #   # #   #   # # # # # #   #   # #     #   # # #   #   #   # 
# # # ##### # ##### # # ####### # ##### # ##### ### # # ### # # # ### ####### ### # ### # # ##### # ### ### ### # ### # ### ### 
# # #       # #   # # #       # #   #   #     #   # # #     # # # # #   #     # #   #   # #       # # #   # #   # #     #   #   
# # ######### # # # # ####### ##### # ####### ### # # ####### # # # ### ##### # ##### ### ######### # ### # # # # ####### ##### 
# # #       #   #   #   #   #   #   #     #   #   #   #     # # #   # #     # #         #   #         # #   # # #         # #   
### # ##### ####### ### ### ### # ####### ##### ########### # # ### # ##### # # ####### ### # # ####### ####### ########### # ##
#   #     #       #   #     # # #     # #       #     #   # #   # #   # #             #   # # # #                 #         #   
# ##### ########### # ####### # # ### # ######### ##### # # ##### ### # # ##### ######### # # ### ### # # # ### ### # ######### 
#       #   #       #       #   # #   #               # #   #             #   # #       # # #       # # # #   # #   #           
######### # # ############# # ### # ####### # # ##### # ##### ######### ### # ### ##### ### ######### # # ### ### ##############
#         # # #               #   #   # #   # # #   # #       #   #   # #   #   # #         #   #     # #   #     #       #   # 
# ######### ### ########### ######### # # # # ### # # ### ##### # # # # # ##### # ########### # ####### ### ### ### ### # # # # 
# #     # #     #   #     # #     #   # # # #   # #   #   #   # # # # #     #   #         #   #   #       #   #       # #   #   
# # ### # ### ### # ##### # # ### ##### # # ### # ### ### # # # # ### ##### ############# # ##### ### ### ### ####### # ####### 
# # # # #     #   #   #         #     #   # #   #   #     # #   #   #   # # #     #     #       # #   #     #     #   # #     # 
# # # # ### # # ##### ######### ##### ####### ########### # ####### ### # # # ### # ### ######### # ### # # ##### ##### # ### ##
# # # #     # # #     #   #   #     #   #     #   #   #   #     # # #   #     # #   #     #       # # # # # #   #   #   #   #   
# # # ####### # ####### # # # ##### ### # ### # ### # ######### # # # ######### # ######### ####### # # # # # # ### ####### ### 
# # #   #   # #       # #   #   #   # # # #   # #   # #           # # #   #       #         #       #   # #   #   #   #       # 
# # # ### ### ####### # ####### # ### # # ##### # ### # ########### # # # # ##### # ######### # ### ########### # ### # ####### 
# # #       #     #   #     #   # #   # #       # # #   #   #     # #   # # #   # # #         # # #         #   #   # # #       
# # ####### # ### # ######### ### # # # # ####### # ##### # # ### # ##### ### # # # # ######### # ######### # ### # # # # ##### 
# # #     #   #   #     #   #   #   # # # #       #       # # # #   #   #   # #   # #   #     #   #   #   # #   # # #   #   #   
# # # ### ##### # ##### # # ### ##### # ### ############### # # ####### ### ### ### ### # ### # ##### # # # # # ### ####### ### 
# # #   # #     #     #   # #       # # #   #       #   #   # #       #   #   #   # #   # # # #   #   # #   # #   #   #   #   # 
# ##### # # ####### # ##### # ##### # # # ### ##### ### # ### # ### # # ##### # # # ##### # # ### # ### ##### ### # # # ##### ##
#   #   # # #       #     # # #   #   #     # #         # #   #   # #   #     # # #     #   #   #   # # #     #   # # #   # #   
### # ### # ############### # # # ######### ### ##### ### # ####### ### # ##### ####### ####### # ### # # ##### ### # ### # ### 
#   # # # # #       #       # # #     #   # #   #   # #   #   #     #   # #           #         # #   # #     # #   #   #   #   
# ### # # ### ##### # ####### # ##### # # # # ### # ### ##### # ##### ### # ##################### # # # ####### # # ##### ### ##
# #   #   #   #   # # # #   # # # #   # # #     # #   #       #     # #   #   #         #     #     # #   #   # # #   #   #   # 
# # ####### ### ### # # # # # # # # ### # ####### ### ############# # # ##### # ##### # # ### # # ####### # # # ##### # ### ### 
# #         #     # # #   # # #   # # # # #   #   # #   #           #     #   # #     # # # # # #   #   # # #   #     #   #     
# ########### ### # # ##### # ##### # # # # # # ### ### ### # ### ####### # ### ######### # # ####### # # # ##### ####### ######
#   #           # # #     #       # # # #   #   # #   # #   # #   #     #   #   #   #   #   # #       #   #   #   #     #   #   
# # ### ####### ### ##### ##### # # # # ######### ### # # ### # ### ### ### # ### # # # ### ### ############# # # # # ##### ### 
# # #   #     # #   #   #     # # #   #     #       #   # #   # # # #   #   #     # # #   #     #       #   # # #   #     #     
# # # ### ### # # ### # ##### ### ### ##### # ##### ##### # ### # # ### ### ####### # ############### ### # # ####### # ####### 
# #   #   #   # # #   #     # #   #   #   # #     #       #   #   #   #   #         # #             #     # # #     # # #     # 
# ##### ### ### # ######### # # ### ### # # # ### ### ####### ####### ### # ######### # ### ##### # ##### ### # ### # # # ### # 
#       #   #   # #         # #     #   #   #   # #   #     #   #     # # # #         #   #   #   #     #   # # #   # #   # #   
# ####### ##### # # ######### # ##### ########### ##### ### ### # ##### # # # ########### ##### ####### # # # ### ### ##### ####
#       # #   # # # #   #   #         #   #     #   #   # #   # # #     # # #       #   #   #   #   #   # # # #   #         #   
# ####### # # ### # # # # # # ######### # # ### ### # ### ### ### ### ### # ####### # # # # # ### # # ### # # # ### ### ##### # 
#       #   # #   #   #   #   #   #     # # #       #   #   #     #   #   #       #   # # # # #   #   #   # # # #   #   #     # 
####### ##### # ############# # # ####### # # ######### # ######### ### ### # ### ##### # # # # ####### ### # # ### # ### ##### 
#         #   # #             # #     # #   #   #       # #   #       #     # # # #   #   # # # #     #   # #   #   #   #   #   
# ######### ### # ########### # ##### # ##### # # ####### # # # # ### ##### # # # ### ##### # # # ### ### ####### # ### ### # # 
# #         #   #   #   #   # #     # # #     # #   #     # #   # #         # #     #       # #   # #   #     #   #   # #   # # 
# # ##### ### ####### # # # # ### ### # ####### ### # ##### ##### # # ##### # ##### # ##### # ##### ### ### # # ##### # # ### ##
# # #     #   #       # # #       #   #     #     # # #     #   # # #     # #   #     #     # #             #   #   # #     #   
### # # ### ### ####### # ### ##### ####### # # ### # # ##### # ### ##### # ### ####### ##### ############# ##### # # ######### 
#   # #   #   # # #   # #   #     #     #   # # #   #   #     #       #   #   #   # #   #     #         #   #     # #   #       
# ### ### ### # # # # # # # ##### ##### # ### ### ### ### ############# ##### ### # # ### # ### ####### ##### ##### ### # ##### 
#   #   #   #   #   # # # #     # #   # #   #   # #   #   #     #     #     #   # #   #   # #   #   #         #   #   # # #     
### ### # # ######### # ####### # # ### ### ### # # ### ### ### # ### ##### ##### # ### ##### ### # ############# ### ### # ####
# # #   # # #       # #       # # #     # #   # # #   # #   # # #   # #   # #   # # #   #   # #   #     #     #     #     #     
# # # ### # # ##### # ####### # # ####### ### # # ### # ##### # ### # ### # # # # # # ##### # # ####### # # # # ### ####### ### 
#   # #   # #     # # # #   #   #     #   # #   #   # #         #   #   #   # #   # #     # # # #     # # # # #   #       #   # 
##### # ######### # # # # # ######### ### # ### ### # ########### ##### ##### ##### ##### # # # # ##### # # # ### ####### ### # 
# #   #   #     # # # #   # #   #     #   #   #   # #     #   #   #   # #   # #         #   #         # # # #   #   # #       # 
# # # ### # # ### # # # ##### # # ##### ### # # # # # ##### # # ### # # # # # ##### ################# # ### ### ### # # ####### 
# # # # # # #     #   #     # # #     #   # # # # # # #     #   #   #     #   #   # #   #     #   #   # #   #     # #   #       
# # # # # # ########### ### # # ##### ### # # # # # # # ######### ############# # ### # # # ### # ##### # ####### # ### # ##### 
#   # # #   #     #       #   #     #   #   #   # # # #     #   # #     #     # #   # # # # #   #       #       #   #   # #     
### # # ##### ##### ##### # ####### ### ######### # ####### # # # # ### # ### # ### # # # ### ################# ##### ### # ### 
# # #   #     #         # #   #   #   # #         #       # # #   # # #   #   # # # # # #   #S    #   #     # # # #     # # #   
# # ##### # ### ######### # ### # ##### ####### # ####### # # ##### # ##### # # # # ### ### ##### ### ### # # # # # ##### # # ##
# #       #     #   #     #   # #     #     # # #       # # #   #  G#     # # # # #   #         #   #   # # #   #   #     # #   
# ##### # ####### # # ####### # ##### ##### # # ##### ### # ##### ### ##### ### # ### ####### ##### ### ### ### ##### ##### ### 
# #   # #   #     # # # #     #     # #   # # # #     #   #   #   #   #     #   # # #   #   # #       # #   #   #   #   # # #   
# # # # ### # ####### # # ### ##### ### # # # # # ##### ##### # ##### # ##### ### # ### # # # # ####### # ####### # ### # # # ##
#   #   #   #         #   #       #     #   #   #     #     #         #               #   #   #         #         #     #   #   
################################################################################################################################
