################################
################################
       #   #   #     #   #   # #
 ##### # # # # # ### # ### # # #
 #     # # # #   #   #     #   #
 ######### # ##### ####### #####
     #   # # #   #       # #   #
#### # # # # # # ####### # # # #
   # # #   #   #       # #   # #
 # # # ### ############# # ### #
 # # #   #   #     #     #   # #
 ### ##### # # ##### ####### # #
 #   #   # # #     # #   # # # #
 # ### # # # ##### # # # # # ###
 # #   #   #   #   #  S# # #   #
 # # ######### # ####### # ### #
     #         #   #   #       #
###### ########### # ##### #####
     # #   #               #   #
 ### # # # # # # ####### ### # #
 # # #   #   # #   #     #   # #
 # # ####### ####### ### # ### #
 #  G#     # #     #   # # #   #
 ##### ### # # ### ##### # # ###
     #   #   # #           # # #
#### ####### # ######### ### # #
     #     # #         #   # # #
 ##### ### ######### # ##### # #
 #   #   #   #     # # #     # #
 # # ### ### # ### ### # ##### #
   #     #     #       #       #
################################
