################################
#     #     # #     #   #G      
# ### # ### # # ### ### ### ####
# #     #   # #   # #   #   #   
# ####### ### ### # # ### ### # 
#   #   #   #   # # #   # #   # 
### ### ### # ### # ### # # ### 
#   #     #   #   # #   # #   # 
##### ####### # ### # ### ### ##
#   #         # # #   #     #   
# # # ######### # ##### ### ### 
# #   #       # #     #   #   # 
# ##### ### ### # ##### # ##### 
#   #   #   #   #       #       
### # ### ### ### ##############
# # #S# # # #     #             
# # # # # # # ### # # ####### ##
# #   #         #   #     # #   
# ####### # ### ##### ### # ### 
#       # # #   #   # #   # #   
# ##### # # # ### # # # ### # # 
# #   #   # #   # # # #   #   # 
### # ##### ### ### ### # # ####
#   #   #     #   #   # # # #   
# ##### # # # ### ### ### ### # 
# #   #   # # #     #   # #   # 
# # # ##### # # ####### # # ####
#   #   #   # #   #   # # #     
####### ### ##### # # # # ##### 
# #   #   #     # # #   # #   # 
# # # ### ### # # # ##### # # # 
#   #     #   # #   #       #   
