################################
################################
#     #           #         #   
# ### # ######### # ##### # ### 
#   #   #     #   # #   # # #   
# # ##### ##### ### # # # # # # 
# #       #   #     # # # #   # 
########### # ####### # ####### 
#    S#     #         #   #   # 
# ### # ################# # # # 
# #     #       #         # # # 
# # # ### ##### # ##### ### # # 
# # # #   #   # # #   #     # # 
# # # # ### ### # # # # ##### # 
# # # #     #   #   # # #   # # 
# ### ####### ##### # # # # ### 
#   #   #   # #   # # #   #     
# # ### # # # # ### # ### ######
# #   # # # # #     #   #       
# ### # # ### ##### ### # ##### 
# #   #   #   #       # #   #   
### # ##### ### ### # # # ### ##
#   # #     #   #   # # #   #   
# ##### ##### ### ### # ### ### 
# #   # #     #   #   #   # #   
# ### # ####### ######### # # ##
#     # #     # #         # # # 
# ##### # ### ### ######### # # 
#   #   #   #   #        G# # # 
### # ##### ### ######### # # # 
#   #       #             # #   
################################
