################################
################################
               #       #       #
 ############# # ##### # ##### #
   #   #       #   #   #   #   #
## # ### ######### # ##### # ###
   #     #       # #       #   #
 # ##### # ##### ####### ##### #
 # #   #   #   #       #   #   #
 ### # ##### ######### ### #####
 #S  #   #   #       #   #     #
 # ##### # ### # ####### ##### #
 #     # #     #   #   #   #   #
 ##### # ##### ### # # ### # # #
       #     #   # # #   #   # #
############ # # # ##### ##### #
       #     # # #           # #
 ####### ##### # ### ######### #
 #       #     #   #     #     #
 # # ##### ####### ####### #####
 # # #   # # #     #    G#     #
 ### ### # # # ##### ### ##### #
 #   #   #   #     # # #   #   #
 # ### # ### ####### # # ### ###
 #   # #   #     #   # #   # # #
 # # ##### ##### # ### ### # # #
 # #     #     # # #     # #   #
 ####### ##### # # # ### # ### #
       #     #   # #   # #     #
###### ##### # ### ### # #######
             #         #       #
################################
