################################
################################
#               #   #       #   
### ####### ##### # ### ### # # 
#   #     # #     #     #   # # 
# ### ### # # ########### ### # 
#   #   #   # #         # #   # 
### ### ### # ######### # ### ##
#     #   # #           #   #   
# ######### ############### # # 
# #S                  #       # 
# # ######### ####### # ####### 
# # # #     # #     # #   #   # 
# # # # # # # # ### # ### # # ##
# # #   # #   # # #       # #   
# # ##### # ### # # ##### # ### 
# #     # # #   # # #  G  #   # 
# ##### # ### ### # # ### ##### 
#   #   #   # #   # # #   #     
# # # ##### # # ##### # ### ####
# # #   #   #   #   # # #       
# ##### ### ##### # # # ####### 
#     #   #   #   #   #     #   
### ##### ### # ########### # # 
#   #   #   # #       #   #   # 
# ### ##### ######### ### ##### 
#   #   # #   # #   #   # #     
### ### # ### # # # ### # ##### 
#   #   # #   # # #   # # #   # 
# ### ### # ### # ##### # # # # 
#         #     #       #   #   
################################
