################################
################################
     # #   #       #     #     #
 ### # # # # # ### # ### ##### #
 #   #   #   #   # # # # #     #
 ########### ### ### # # # #####
       #   # #   #   #   #   # #
###### # # # ##### ######### # #
   # # # # #       #       #   #
 # # # ### # ####### ##### ### #
 # # # #   #         #   #   # #
 # # # # ##### ##### # # ### # #
 # #   #     # #   #   #   #   #
 # ### ##### # # # ##### # #####
 #   # #   # # # # #   # #   #S#
 ### # # # # # # # # # # # # # #
 # # # # # # #   # # # # # #   #
 # # # # ### ### # ### # # ### #
   #       #   # #   #   #   # #
#### # ### ### # ### ####### # #
 #   #   #    G#   #   #   # # #
 # ##### ### ##### ### ### # # #
 # #   #   # #       #   #   # #
 # ### ### # # ##### ### #######
 #     #   # # #   #   # #     #
 ####### ### # # # ##### # ### #
   #     #     # # #   # #   # #
## ### # ####### # # # # ### # #
 #   # #       # # # # #     # #
 ### ######### # ### # ####### #
               #     #         #
################################
