################################
################################
     #     #       #   #       #
 ### # ### # ##### ### # ##### #
 #  G# #   #     # #   #   #   #
## ### # ####### # # ####### ###
   #   # #     # #   #       # #
 ### ### # ##### ##### ####### #
 #   # # # #     #   # # #   # #
 # ### # # # ##### # # # # # # #
 #     #   # #     # # #   #   #
 # ######### # ##### # # #######
   #   #     #   #   # # #   # #
 ### # # ####### # ### # # # # #
 #   #   #     # #   # #   #   #
 # ####### ### # ##### ##### ###
 #   #   #   # #     #     #   #
 ### ### ### ####### ##### ### #
   #   #   #     #   #   #   # #
 # ### ### ##### # ### ##### # #
 #   #       #   # #   #   #   #
 ### ##### ### ### # ### ##### #
   # #     #   #   #   # #     #
## ### ##### ### ##### # # # # #
           #   #       #   # # #
 ####### ##### ####### ##### # #
   #   # #   #               # #
#### # # # ########### ####### #
     #   #S  #         #     # #
 ####### ### # # ####### ### # #
       #       #       #   #   #
################################
