################################
################################
     #                   #     #
 ### # ########### ##### # ### #
 #   #     #     #     # #   # #
 ######### # ### ##### # ### # #
         #   #   #   # #   # # #
######## # # # ### # # ##### # #
       #   # # #   # #       # #
#### # ##### # ### # ####### # #
   # #       #   # #   #   # #S#
 # # # ### ##### ##### # # # # #
 #   #   #     #   #   # # # # #
######## ######### ### # # ### #
       #   #     #   # # #     #
 ##### # # # ### ### # # ##### #
   # #   # # #       #   #   # #
## # ##### # ############# # # #
 # #       # #     #       #   #
 # # # ##### # ### # ### ##### #
 # # #   #   # #   #   #   #   #
 # ##### # ### # ### # ### ### #
 # #     #   # #   # #   #   # #
 # # ####### # ### # ### ### # #
 # # #   # #   #   #   #   # # #
 # # # # # # ### ########### # #
 # # # #   # #   #        G  # #
 # # # ####### ### ########### #
 # # # #     # #   #   #   #   #
 # # # ### # # # ##### # # ### #
   # #     #   #       # #     #
################################
