################################
#     #     #     #     #       
##### # ##### ### # ### ### ### 
#     #   #   #   #   #   #   # 
# ####### # ### ######### # # ##
#     #   # #   #   #   # # #   
# ### # ### # ### # # # # # ### 
#   # # #   #   # #   #       # 
# # ### # ##### # ########### # 
# #     #   # # #   # #   #   # 
# ######### # # ### # # # ######
# #       # # #   #     #   #   
# # ##### # # ### ### ##### # # 
# # #     # #   #   #     #   # 
# # # ##### # ##### # ### ##### 
#   #   #   # #     #   # #   # 
####### # ### # ####### ### # ##
#   #   # #       #   #     #   
# # # ### # ### # ### ### ##### 
# # #   # #   # #   #   # #   # 
# # ### # ### # # # ### # # ### 
# #   #   #   # # #     # # #   
# ### ######### # ####### # # ##
#   #           #  G    # #   # 
### ############# ##### # ##### 
# # #             # #   #  S  # 
# # # ########### # # # ##### # 
# # #   #           # #     # # 
# # ### # ########### ####### # 
# #   # # #         #   #   #   
# ### # ### ####### ### # # ### 
#     #     #         #   #     
