################################
################################
#       #     #     #     #     
# ### # # # ### ### # ### ##### 
# #   #   # #   # #   # # #   # 
# # ######### ### ##### # # # # 
# #   #       #   #   # #   # # 
# ##### ####### # # # # ##### # 
# #   #   #    G# # # #   #   # 
# # # ### ####### ### ### # ### 
#   #   #     # #     #   # # # 
# ##### ##### # ##### # ### # # 
#   # # #   # #   #   # #   #   
### # # ### # # ### ### # ### ##
# # # # #   # #     # # #   #   
# # # # # ### # ##### # ### ### 
# # #   #   # #     # # #   #S  
# # ####### # ##### # # # ##### 
#   #     # #     #   #   #   # 
# ####### # ##### ### ####### # 
#       #       #     #       # 
####### ##### # ##### # ####### 
#             #             #   
# ######### ##### ##### # ### # 
#     #   # #   #     # # #   # 
##### # # ### # # ### # ### ### 
#     # #     # #   # #   # #   
####### ####### ### # ### # # # 
#     # #     # #   # # #   # # 
# ### # # ### # # ### # ##### # 
#   #   #   #     #   #       # 
################################
