#                               
# # ### # ####### # ##### ##### 
# # #   #       # # #   # #   # 
# # # # ####### # # ### # # # # 
# # # # #     # # #     #   # # 
# # # # # # # # ############# # 
# # # # # # # #   #           # 
# # # ### # ##### # ##### ##### 
# # #   # # #     # #     #     
# # ### # # # ##### # ##### ### 
# #   #   # #   # # # #       # 
### # ##### ### # # # ######### 
#   # #   #   # #   #   #       
# ### # ##### # ####### # ######
#   # #   #   #       # #     # 
### # ### # ######### # ### # # 
#   # #   # #   #     #   # # # 
# ### # ### # # # ####### # # # 
#   # # #   # #   #       # #   
### ### # # # ### ######### ####
# #   #   # #   # #   # #       
# ### ######### # # # # # # ### 
#         #    G# # # #   #   # 
### ####### ##### # # ####### # 
#   #       #     # # #   #   # 
# ### ############# # # # # ####
# # # #   #      S# #   # #     
# # # # # # ##### ####### ##### 
# # # # # #     #         #     
# # # # # ##### ########### ####
#   #   #       #               
################################
