################################
################################
                 #             #
 ##### # ### ### # # ######### #
 # #   #   # #   # # #     #   #
 # # ##### # ##### # # ### ### #
   # # #   # #   # # #   #   # #
#### # # ### # # # # # ##### # #
     #   #     # # # # #     # #
 ######### # ### # # # # ##### #
 #     # # #   #   #   # # #   #
 # ### # # # ########### # # # #
   #   #   #           # # # # #
#### ########### # ### # # # # #
     #   #     # # #   # #   # #
 ##### # # ### # ### ### ##### #
 #   # # #   #   #S  #   #     #
 ### # # ### ##### ### ##### # #
   # # #   # #     #   # #   # #
## # # ### # ####### ### # ### #
   # # # #   #   #   #   #   # #
 ### # # ##### # # ### ### # # #
   # #   #     # #   # #   # # #
## # # ### ##### # # # # ### ###
 #   # #   #     # # # #   #   #
 ##### # ### ##### # # ####### #
       # #   # #   # #       # #
 # ##### ##### # # # ####### # #
 #     #     #   # # #   #   # #
 ##### ##### ####### # # # ### #
     #     #        G# #       #
################################
