################################
                 #         #   #
 ################# # ### # # # #
 #       # #       # #   # # # #
 # # ### # # # ##### ##### # # #
 # # #   #   #     #     #   # #
 ### # ####### # # ##### ##### #
     # #       # # #   #   #   #
###### # ####### ### # ### #####
     # # #         # #   # #   #
 ### # # # ####### # # # # # # #
 # #   # # #     # # # # #   # #
 # ##### # # ### # # # ####### #
       # # # #   # # #   #     #
###### # # # ##### # ### # #####
   #   # # #   #     #   #     #
 ### ### # ### ####### # ##### #
     #   #   #         #   #   #
 ##### ##### ############### ###
       #   #         #     # #G#
######## ########### # ### # # #
       # #           #   # # # #
 ##### # # ######### ### ### # #
     # #   #       #   #     # #
#### # ##### ####### # ####### #
     # #   #       # #         #
 ##### ### ####### # ##### # ###
   # #   #       #S# #   # #   #
## # ### # ##### # # # # ##### #
 # #     #     # #   # #   #   #
 # # ######### # ### # ### # # #
   #           #     #   #   # #
