################################
#               #   #           
# ######### ##### # # ##########
# #  G    #       # # #         
# # ##### ######### # ##### ### 
# #     #         # #       #   
# ##### ######### # ######### ##
#     #   #     # #     #   #   
######### ### ### # # # # # ### 
#       #   #     # # #   # #   
# ##### ### # ##### # ##### # ##
#   # #     #   #   #   #   #   
# # # ####### # # # ### ### ### 
# # #         #   #   #   # #   
# # ### ##### ####### ### # # ##
# # #   #     #     # #S  # #   
# # # ### ### # ### # ######### 
# # #   #   # #   # # #       # 
# # ### ### # ### ### # ### ### 
# # # # #   #   #   # # # #     
# # # # # ### # ### # # # ######
# # #   #   # #   # # # # #     
# # ####### # ### # # # # ### ##
# #   #   # #   # # # # #       
##### # ### ### # # # # ##### # 
#     #     #   #   # #     # # 
# ########### ####### ##### # ##
#   #   #       #   # #   # #   
# # ### ####### # # # # # # ### 
# #   #     #   # # # # #   # # 
# ### ##### # ##### # # ##### # 
#   #       #       #           
