################################
#           #           #     # 
######### # # ########### ### # 
#         # #   #       #   # # 
# ######### ### # ##### ### # # 
#   #   #     #   #   # #   #   
### # # ### # ####### # # ######
# # # #     #               #   
# # # ######### ########### # # 
# # # #       # #     #   #   # 
# # # # ##### ### ### # # ##### 
# # #   #   #     # # # #     # 
# # ##### # ####### # # ##### # 
#   #     #   #   #   #   #   # 
### # ######### # ######### ### 
#     #         #   #       #   
# # ### ########### # ####### ##
# #   # #     #   # #     #   # 
####### ##### # # # ##### # ### 
#       #       # #       #   # 
# ####### ### ############### # 
#   #   #   #     #           # 
### ### # # # ### # ########### 
# #  G# # # #   #S              
# ### # # # # ################# 
#   # # # # # #           #     
# # # # # # ### ######### # ####
# #   #   #     #     #   # #   
# ####### ####### ### ##### # # 
# #   #   #     #   #   # #   # 
# # # # # # ### ####### # ##### 
#   #   #     #         #       
