################################
           #             #     #
 ######### # ########### # ### #
 #   #     # #   #       #   # #
 # # ####### # ### ########### #
 # # #     #   #   # #       # #
 # # # ### ##### ### # # # # # #
   # # # #     # #     # # # # #
#### # # ##### # # ##### # # # #
   # # #     #S    # #   # #   #
 # # # ##### ##### # # #########
 #     #     #   # #   #   #   #
 ### ### ### # # # ##### # # # #
   #       # # # #       #   # #
## # ##### ### # ############# #
 # # #   # #   #     # #   #   #
 # # # # ### ####### # # # # # #
 # # # #       #   # # # #   # #
 # # # ######### # # # # ##### #
 # # #   #     # # # #   #   # #
 # # ### # ### # # # ##### # # #
 # #   # # #   # #   #   # # # #
 # ##### # ##### ##### # # # # #
 #       #     # #     #   #   #
 ############# # ### ######### #
     #       #G# #   # #   #   #
 ### ##### # # # # ### # # # ###
   #       # #   #   #   # #   #
## # ####### ####### ##### # # #
 # # #       #     #   #   # # #
 # # # ##### ### # ### # ##### #
   # #     #     #     #       #
