################################
# #     #   #   #   #   #     # 
# # ### # ### # # ### ### ### # 
#   #         # #           #   
##### ######### ### ####### ####
#     #   #   #   # #   #   #   
####### # # # ### # # # # ### # 
#    S# # # #     # # # #   # # 
# ### # # # ######### # ### # ##
# # #   # # #         # #   #   
# # ##### # # ######### # # ### 
# # # #   #   #     #   #G#   # 
# # # # ####### ##### ##### ### 
#   # # #   #   #     #   # #   
##### # # ### ### ##### # # # ##
#     # # #   #   #     #   #   
# ### # # # ### ### ### ####### 
# # #   #   #   #     #       # 
# # ####### # ### ### # ####### 
#   #     # # #   #   #     #   
### ##### # # # ############# ##
# #   #         #     #     # # 
# ### # ####### # ### # ### # # 
#   # # #     #   #   # #   #   
# # # ### ### # ####### # ##### 
# # #     # # # #       #     # 
# # ####### # # # ####### ### # 
# #           #   #     #   #   
# ############# ### ### # # ####
#       #     #     #   # #     
# ####### ### # ##### ### ### # 
#           #   #     #   #   # 
