################################
     #     #       #           #
 ### ### # # ##### # ####### # #
   #   # # #     # # #     # # #
## ### ### ##### ### # ### # # #
 # # # #       # #   # #     # #
 # # # # ##### # # ### #########
 # #   #     #       # #   #   #
 # ### ############# # # ### # #
 #   #     #       # #   #   # #
 ### ##### # ##### # ##### ### #
   # #     # #     # #   # #   #
 # ### ##### ####### # # ### ###
 #     #   # #   # #   #   #   #
 ####### # # # # # # ##### ### #
   #     # #   # #   #  S#     #
## # ##### ##### # ### # #######
 #   #     #           #       #
 ##### ##### ##### ########### #
   #   #     #   #   #   #   # #
 # # ### ### # # ##### # # # ###
 # # #     #   #     # # # #   #
 # # # # ######### # # # # ### #
 # # # #     #   # #   #   #   #
## # # ##### # # ########### ###
       #   #   # #     #   #   #
 ####### # ##### # ### # # # # #
         # #   #  G# # # # # # #
 ######### # # ##### # # # # # #
     #   #   # #   #   # # # # #
#### # ####### # ####### # ### #
     #         #         #     #
