################################
################################
     #         #   #   #     # #
 ### # ####### # # # # ### # # #
 # #S G#   #   # #   #     # # #
 # ####### # ############### # #
 #         #     #   #   # #   #
 ##### ### ##### # # # # # ### #
     # #       #   # # # #   # #
#### # # ##### ##### # # # ### #
     # #   #   #   # # # #   # #
 ########### # # # # ### # # # #
 #       #   #   #         #   #
 ####### # ####### # ##### #####
   # #   # #       #     #     #
## # # ##### ########### # ### #
   # # #     #     #   # #   # #
 ### # # ##### ### # # # ### # #
   #   #     #   #   #   #   # #
## # ### ### ### ######### #####
 # # #     #   # #       #     #
 # # ####### ### # ##### ##### #
 # #       # #   #     #   #   #
 # ####### ### ####### ##### # #
   #     #     #     #   #   # #
#### ### ####### ### ### # ### #
     # #   #   #   #   # # # # #
 # # # # # # # ### ##### # # # #
 # #   # #   # #   #     # # # #
 # ##### ##### # # # ##### # # #
 #     #     #   #         #   #
################################
