################################
################################
                     #   #     #
 ### ############# # # # # ### #
   #   #     #     # # #   # # #
 ##### # ### # ##### ####### # #
 #   # # # # #     #   #   #   #
## # # # # # ##### ### # # ### #
   # #   # # #     # # # # #   #
 ### # ### # # ##### # # # # # #
S# # #     # #   #   #G  # # # #
 # # ##### # ### ### ##### # # #
 #   #   # #   # #       # # # #
 # ### # ####### # ##### # # # #
 #     # #       # #   # # # # #
 ####### # ####### # # ### ### #
 # #   #   #     #   # #   #   #
 # # # ##### ### # ### # ### ###
   # #         # # # #   #     #
#### ### ##### ### # ##### ### #
     #   #     #   #       #   #
 ##### ### ##### ### # # #######
 #   #   # #   # #   # # # #   #
 # ##### ### # # # ### # # # # #
 # #   #     #   # #   #   # # #
 # # # ########### # ####### # #
 # # #     #   #   #   #   # # #
 # # # ### # # # # ### # # # ###
 #   #   #   # # #   #   # #   #
 ##### # ####### ### # ### ### #
       #         #   #   #     #
################################
