################################
################################
#   #     #                   # 
### # ### # ############### # # 
#   # #   #     # #       # #   
# ### # ####### # # # ##### ####
#     # #     # #   # #   # #   
####### # ### # ### ### # ### # 
#         #   #   #   # #     # 
# ##### ##### ### ### # ####### 
#   #   #     # #   # # #   #   
##### ### ### # ### # # # # ####
#   #   #   #         # # #     
# # ####### ##### ### # ##### # 
# #   #   # #   # #   #       # 
# ### # # ### # ### # ######### 
# #     #     #  S  # #       # 
# ################### ### ### # 
# #         # #           # #   
# # ####### # # ########### ### 
# # #     # #   #   #       #   
# # # ### # # ### # ####### # # 
#   #   #   # #   # #     # # # 
# ##### ##### # ### # # ### # # 
# #     #     # # # # #     # # 
# # ##### ### # # # # ####### # 
# #   #   #   # # # #   #     # 
# ### ##### ### # # ### ##### # 
# # # #   #  G# # # # #   #   # 
# # # # # ##### # # # ### ##### 
#   #   #       #   #           
################################
