################################
################################
# #S        #   #   #     #     
# # ##### ### # ### # ### ##### 
# #     #     #     #   #     # 
# ##### ######### ########### # 
#         # #   # # #         # 
# ####### # # # # # # ######### 
# #     #   # # #   #   #     # 
# # ### ### # # ####### # # ### 
# #   #   # # # #       # #  G  
##### ### # # ### ####### ######
#     # #         #     #   #   
# ##### ##### # ### ### # # # # 
#   #         #     # #   #   # 
### # ##### # ####### ######### 
# # # #     #       #         # 
# # # # ##### ##### # ### # ### 
#   # # #   # #   #   #   # #   
##### ### # # # # ##### ##### ##
#       # # # # #   #   #     # 
# ##### ### # # ### # ### ### # 
#   # #     # # #   #   # #   # 
# # # ####### ### ##### # ##### 
# #   #     # #   #     #       
# ##### ##### # ### ### ########
#     # #   # # # # #           
# # # # # # # # # # # ######### 
# # #   # # # # # # #     #   # 
# ####### # # # # # ##### # ### 
#         # #   #   #     #     
################################
