################################
   #               #           #
## ##### ########### ######### #
   #   # #       #   #     #   #
 ### # # # ##### # ####### # ###
 #   # # # #   # # #     # # # #
 # ### # # ### # # # ### # # # #
   # # #   #     #   # # #  G# #
#### # ##### ### ##### # # ### #
   #   #   # #     # #   # # # #
 # # ### # # # ### # ##### # # #
 # # #   # # # # #     # # #   #
 # # # ### ### # ##### # # # ###
 # #   # # #   #           # # #
## ##### # # ### ####### ### # #
   #     # # #       #       # #
 ### # ### # # ####### # ### # #
 #   # #   # #   #   # #   #   #
 # ### # ### # # # # ### # ### #
 # #   # #   # # # #     #   # #
 # # # # # ##### # ####### # # #
   # # #   #     #       # # # #
#### # ##### ### ####### # # ###
   # #       #   #   # # # #   #
 # # ######### ##### # # # ### #
 #   #             #   # # #   #
 ######### ####### ### # ### ###
 #   #   # #     #     #   #   #
 # # # # # # ### ### ##### #####
   #   # # # # #   # #   #     #
######## # # # ### ### # ##### #
         # #   #    S  #       #
