################################
################################
#       #         #   #         
####### # ####### # # # # ##### 
#   #   # # #     # #   #   # # 
# # # # # # # ##### ####### # # 
# # # # # # # #   #     #   #   
### ### # # # # # ##### # ##### 
#   #   # #   # #   #   # #     
# ### # # ### # ### # ### # ### 
# #   # #   #   #   #   # # #   
# # ### ### ##### ####### # ### 
# #   #   # #   #       # #   # 
# ### ### # ### ####### ##### # 
# #   #   #     # #   #     # # 
# ##### ######### # # ##### # # 
# #   #       # #   # #   #   # 
# # # ### ### # # ### # ####### 
# # #   # #   # # #   #   #   # 
# # ### # ##### # ####### # ### 
#   #   #   #             # #   
##### ##### ##### ##### ### # ##
# #   #     #     #         # # 
# # ### ##### ##### ### ##### # 
# #   #     #   #   #   #     # 
# ### ##### ##### ### ### ##### 
#   #     # #     #S# #   #     
# # ##### # # ##### # # ### ####
# # #   # #   #  G#   # # # #   
# # # # # ##### # # ### # # ### 
# #   #         #               
################################
