################################
################################
#   #       #         #  S#   # 
# # # ### # # ### ### # ### # # 
# # # #   # # # #   #   #   #   
# ### # ##### # ### ##### ######
#   # #   #   #   #     #   #   
# # # ##### ### ####### ### # ##
# # # #   # #   #     #         
# ### # # # # ### ############# 
# #   # #   #       #         # 
# # ### ########### # ####### # 
#     #   #       # #     #   # 
# ### ### ### ### # ##### ##### 
#   #   #     #   #     #   #   
# # ########### ### ####### ####
# # #     #         #     #     
# # # # # # ######### ######### 
# #   # # # #         # #   #   
# ##### ### # ######### # # # ##
#   # #     #   #       # #   # 
### # ######### ### ### # ##### 
#   #   #     #   # #   #   #   
# ### # # ### ### # # ##### # # 
# # # #   #   #   # #       # # 
# # # ######### ### # ####### # 
# #         #   #   #     #  G# 
# ######### # ####### ### # ### 
#         # #   #   #   #     # 
######### # ### # # ### ####### 
#                 #     #       
################################
