################################
 #   #           #         #   #
 # # ########### # ### ### # # #
   # #       #   #   #   # # # #
 ##### ##### # ######### # # # #
       #   # # #     #   # # # #
######## # # # ### # ##### ### #
       # #   #   # #     #   # #
 ##### # ####### ####### ### # #
 #     #       #   #     #   # #
 ############# ### # ##### ### #
 #       #   #             #   #
 # ##### # # # ########### # # #
   #     # # # #     #   #   # #
#### ##### ### # ### # # #######
   #     # #   # # #   #       #
 # ##### # # ### # ########### #
 #         #   # # #     #  G# #
########## # ### # ### ### # # #
     #   #     # #     #   # # #
 ### # # ### # # ##### # ### ###
 #S#   #   # #         #   #   #
 # ####### # ############# ### #
 #       #   #   #   #     #   #
 ####### ### # # # # # #########
 #       #   # #   #   #       #
 # ####### ### ############# # #
 # #   #     # #     #       # #
 # # # ### ### # ### # ####### #
 # # #     #   # # #   #   #   #
 # # ##### # ### # ##### ### ###
   #     #       #             #
