################################
################################
#     #     #           #   #   
### # # ### # ##### ##### # ### 
#   #   #   #   #   #   # #   # 
# ####### ##### ##### # ##### # 
# #     #     #   #   #     # # 
# # ### ##### ### # ####### # # 
# #   # #     #   # #   # #   # 
##### # # ### # ### # # # ##### 
#     #   #   # #   # # #     # 
# ######### ### # ### # ##### # 
# #       # #   # # # #       #S
# # ##### # # ### # # ######### 
# # #   # #   #   # # #         
### # # # ### # ### # # ########
#   # #     # # #               
# ######### # # ####### ####### 
# #   #   #           #   #     
# ### # # ########### # # ######
#     # #       #   #   #   #   
# ##### ####### # ### ##### # # 
#   #   #             #   #   # 
# ### # ##### # ### ### # ##### 
# #   # #   # #G  #   # #     # 
### ##### # # ### ##### ##### ##
#   # #   # #   #       #   #   
# # # # ### ######### ### # ### 
# # # # #   #   #   # #   #   # 
# ### # ##### # # # ### ##### # 
#     #       #   #     #       
################################
