################################
################################
         #       #     # #     #
 ######### ##### # ### # # ### #
 #   #   # #     #  S#   # # # #
 ### # # ### ########### # # # #
   # # #     #           #   # #
## # # ####### # ####### ### # #
 #   #     #   # #           # #
 ### ##### ##### # # ####### # #
       #   #     # # #       # #
###### # ### ##### # # ####### #
     # # #   #   # # #       # #
 ### # # # ### ### # ######### #
 #   # #   #   #   #   #   #   #
 ##### ##### ### # ##### # # ###
 #   #     # #   #   #   #   # #
 # # ##### # # ### # # ####### #
   #       # # #   # #       # #
########## # # # ### ####### # #
   #     # # # # #       #G  # #
 # # ##### # # ### # # ### # # #
 # #     # # # #   # #   # # # #
 # ##### # # # # ####### # ### #
 #   # #       # #     # # #   #
 ### # ### # ##### ### ### # ###
   # #     # #   # #   #   #   #
#### ### ### # # # # ### ##### #
     #   #   # #   #     #     #
 ######### # # ########### #####
           # #                 #
################################
