################################
################################
                 #   #     #   #
 ############### # # # ##### # #
G# #           # # # #       # #
 # # ######### # # # ######### #
 #   #       #   # # #     #   #
 # ### ##### ####### # ### # ###
 # #   #       #     # #   #   #
 # ### # # # ### ####### ##### #
 #     # # # #   #     #     # #
 ####### # ### ####### ### # # #
     #   #   #       #   # # # #
 ### # ##### ####### ### # ### #
   # # #   #   #   #   # # #   #
## # # ### ### # # ### # # # ###
 # # #     # # # #   # # # # # #
 # # ### ### # ##### # # # # # #
 # #   #     #   #   # #     # #
 # ### # # ##### # ### ### ### #
   #   # #     #   # #   #     #
## # ######### ##### ### ##### #
   # #       #         # #   # #
#### # ##### # # ####### # # # #
     #   #     #       # # #   #
 ####### ############# # ##### #
 #       #S  #         #       #
 ##### ### # ### ##### ####### #
     # #   #   # #   #   #   # #
 ### ### ##### ### # ##### # # #
   #         #     #       #   #
################################
