################################
         # #   #   #         # #
 ####### # # # # # ######### # #
 #   #   # # #   #     #     # #
 ### # ### # ######### # ##### #
   # # #   #       #   # #   # #
## # # # ######### # ### # # # #
 # #   #     # #   #     # #   #
 # ######### # # ######### #####
 #             #   #           #
 ####### ######### # ######### #
     #   #       # #   #   #   #
 ##### ### ### ### ### # # # ###
       #   # #     #   # # #   #
 ####### ### ####### ### # ### #
 #       # #         #   #   # #
 # ####### # ### # # # ##### # #
 #   # #     # # # #     #   # #
 ### # # ##### # # ### # # #####
   # #         # #   # # #     #
## # ### ##### # ### # # ##### #
   #   #   #   # #   # #   #   #
 # ### # # ### # ########### # #
 #     # #   # #      S  #   # #
## # ### ### # ##### ### # #####
G  #     # # # #   # #   #     #
 ######### # ### # # # ####### #
 #         # #   # # #   #   # #
 # ######### # ### ##### ### # #
 #   #       # # #   # # #   # #
 ### # ####### # ### # # # ### #
     #         #     #   #     #
