################################
             # #       #   #   #
 ########### # # ##### # # # ###
 #   #       # # #       # #   #
 # # # ####### # ######### ### #
 # # # #     # # #       #   # #
## # # # ### # # # ##### # ### #
   # # # #   #   #     # #     #
 ### # # # ##### ##### # # #####
 #   # # #       #     # #     #
 # ### # ######### ##### ##### #
 #     # #   #     #     #   # #
 ######### # # ##### ##### ### #
 #         #   #   #  G  #     #
 # ### # ####### ####### ### ###
 #   # # #       #     #   #   #
 ##### # # ##### # ####### # # #
 #     # # #               # # #
 # ##### ### ############# # # #
 #     #   #     #       #   # #
 ######### ### ### ##### ##### #
 #       #   # #   # #   #     #
 # ##### ### # # ### # ####### #
 #   # # #   # #     #   #     #
 # # # # # ##### ####### # #####
 # # #   #    S  #   #   #   # #
 ### # ########### # # ##### # #
 #   #   #       # # #     #   #
 # ##### # ##### # # ##### #####
 # #   # # #     # # #   #     #
 # # # # # # ##### # # # ##### #
   # #     #       #   #       #
