################################
#     #       #     #           
# ### # ##### # ### # ##### ### 
#   #   #     # #   #     # #   
### ########### # ### ### # ####
#   #       #   #   #   # # #   
# ### ##### ### ### ### # ### # 
# #   #   #S  # #   #   #     # 
# # ### # ### # ##### ##########
#   #   # #   #   #       #     
##### ### # ##### # ##### # ### 
#     # # # #     #     #   #   
# ##### # # # ######### ##### # 
# #       # # #         #   # # 
# # ####### # # ########### # ##
# #       # # #     # #     #   
# ##### ### # ##### # # ####### 
#     # #   #         #         
####### # ### ################# 
#     # #                 #     
# ### # # ######### ##### ##### 
#   #   # #       #     #     # 
### ##### # ##### # # ####### # 
# #  G  #   #   # # # #       # 
# ##### # ### # # # # # ####### 
# #   # #   # # # # # #   #   # 
# # # # ### # ### # ##### # # # 
# # # #     # #   #     # # # # 
# # # ##### # # ####### # ### # 
# # # #   # # #   #     # #   # 
# ### # ### # ### # ##### # ### 
#           #     #     #   #   
