################################
   #             #   #   #S    #
 # ##### ##### # # # # # ##### #
 #   #   #     # # # # #       #
 ### # ### # ### # # # #########
 #   # #   # #   # # #       # #
 ####### ##### # # ######### # #
 #     #   #   #         # # # #
 # ### ### # ### ##### # # # # #
   # # #   # #   #     #   #   #
#### # # ### # # # ####### ### #
   #   #   # # # #   #   #   # #
 ### ####### # ##### # # ### # #
   #   #     # #   # # #     # #
## ### # ### ### # # # ##### # #
   # # # #   #   # # # #   # # #
 # # # # # # # ### ### # # # # #
 #   #   # # # # #   # # #   # #
 ### ##### # # # ### # # ##### #
   #       # # #   #   #       #
## ######### # # # ### #########
   #         # # #             #
 ##### ### ### # ############# #
     # #   #   # #     #     # #
#### # # ### ### # ### # ### ###
     # #   # # # # #   #   #   #
 ##### ##### # # # # ##### ### #
   #   #     #   # #G    # # # #
## ##### ######### ##### # # # #
 #   #   #   #   # #   #   #   #
 ### # ### # # # # # ###########
     #     #   #               #
