################################
################################
 #   #                   #     #
 # # # # ### ######### # ##### #
 # #   #   #       #   #   #   #
 # ### ### ### ### ####### # ###
S  #     #   #   #   #     # # #
#### # # ### ### ### ### ### # #
     # #   #   #   #   #     # #
 ##### ### ### # # ### ##### # #
   #     # #   # #   #     #   #
 # # ##### # ### ### ##### #####
 # #   #   #   # # # #     #   #
## ### # ##### # # # # ##### # #
   #   #     # # #   #     # # #
 ### # ##### # # ######### ### #
   # # # #   # #         #     #
## # # # # # # ##### # # #######
   # # # # # # #     # # #   # #
 ### # # # ### ####### # # # # #
 #   #   #   #  G  #   #   # # #
 # ######### ##### ### ##### # #
 # #       #   # #   #     #   #
 # ####### ### # ### ### # #####
 #         # # # # #   # # #   #
 ########### # # # ### # # # # #
 #           #   # #   # #   # #
 # # ### ######### # ######### #
   #   # #   #   # # #     # # #
 ##### ### # # # # # ##### # # #
     #     #   #   #       #   #
################################
