################################
################################
   #         #   #   #     #   #
 # # ##### ### ### # # ##### # #
 # #     #   #     # #       # #
 # # ####### ####### # ####### #
 # #   #   #         #G#   #   #
 # # # # # ### ######### # # ###
 # # # # #   # #   #     # # # #
 # # # # ### # # # ####### # # #
 # # # #   # # # #       # #   #
## # ####### # # ##### # # ### #
  S#       # # # #     # # #   #
 ### ### # # # # # ####### # ###
 #   #   #   #   #         #   #
 ##### # # ####### ########### #
 #     # # #     #           # #
 # ##### ### ### ### # # ### # #
 # #   #     # # #   # #   # # #
 # # ######### # # ####### # # #
 # #         #   # #   #   # # #
 # ### ### # ##### # # # ### # #
 # #   #   # #   # # #   #   # #
 # # ### ### # ### # ##### # # #
   # # #   # #     # #     # # #
#### # ##### ####### # # ### # #
 #   # #       #     # # # # # #
 # # # # ##### # ### # # # # # #
   #   # #   # # #   # # # # # #
## ##### # # # ### ### # # # # #
       #   # #     #   #   #   #
################################
