################################
################################
#     #   #       #       #     
# ### # # # ##### ##### # # # # 
# # # # #   #   #   #   #S# # # 
# # # # ##### # ### # ### # # # 
# # # # #     #   # # # # # # # 
# # # # # ####### # # # # ### # 
# #     # #       #   #       # 
# ##### # ### ############# ### 
#   #   #   #     #     #G  #   
### # ##### ##### # ### ##### # 
#   # #   # #     # # #       # 
####### # # ##### # # ######### 
#     # # # #   #   #     #   # 
# ### # # # # # ####### # # ### 
# # #   # # # #       # #   #   
# # ##### # # ####### # ##### ##
# #     # # # #   #   #         
# ##### # ### ### # ### ####### 
# #     #   #   # #   #     # # 
# # ### ### ### # ### # ### # # 
#   # #   # #   #     # #   #   
##### ### ### ### ##### # ######
#   # # #   # # # #     #       
# ### # ### # # # ### ######### 
#     #   # # #   #   #       # 
# ##### ### # ### # # # ##### # 
# #     #   #   # # # # #   # # 
# ### # # ##### # # # # # # # # 
#     #         #   #   # #   # 
################################
