################################
################################
           #     #         #   #
 ######### # # # # # ### # # # #
   #     # # # # # # #   #   # #
 # # ### ### # ### # ######### #
 #   # #     # #   # #     #   #
 ##### ####### # ### # ### # ###
             # # #   # #   #   #
 # ##### # ### # # ### # ##### #
 # #   # # #   # #G    #   #   #
 ### # ### # ### ######### #####
   # # #   #     # #     #     #
## # # # ######### # # # ##### #
   # # #           # # #   #   #
 ### # ####### # # # # ### # ###
 #   # #     # # #   #   # # # #
 # ### # ### ### ####### # # # #
 # #   #   #    S#   #   # #   #
 # # ### # ######### # # #######
   #   # #   #   #   # # #     #
 ##### ##### # # # ### ### # # #
     #     #   # #   #     # # #
 ### ##### ##### ### # ##### # #
   #     #   # # #   # #   # # #
############ # # # ### # # # # #
     #       #   #   # # #   # #
 ### # ############# # # ##### #
 # # # # #   #   #   # # # #   #
 # # # # # ### # # ##### # # # #
   #   #       #         #   # #
################################
