################################
################################
#                 #   #         
# ######### # ### # # # ########
# #       #S# #   # # # #       
# # ##### ### # ### # # # ##### 
# #     #   # # #   # #   #   # 
# ######### # # ### # # ### # ##
#   #   #   # #   # # # #   #   
# ### # # ### ### # # # # ##### 
# #   # #     #     # # #     # 
# # ### ############# # ##### # 
# # # #       #         #   # # 
### # ####### # # ##### ### # ##
#   # # #   # # # #   #   # #   
# ### # # # # ### # # ### # ### 
# #   #   # #   # # #   #   #   
# # ### ### ### # # ### ##### ##
# #   # #         #   #     #   
# ### # # ##### ##### ##### ### 
# #   # # #     #     #     #   
# # ##### # ### # ##### ##### ##
#   #   # # # # #   # #     # # 
##### # # # # # ### # ##### # # 
#     # # #   #     #     # # # 
# ##### # ############### # # # 
# #     #       #       # # # # 
# # ######### # # ##### # # # # 
# #           # #     # # #  G# 
# ##################### # ##### 
#                               
################################
