################################
################################
   # #   #     #           #   #
 # # # # # ### # ######### # # #
 #   # #   #   # # #     #   # #
 ##### ### ##### # # ### ##### #
 #     # # #     # #   #   # # #
 # ##### # # ##### ### ### # # #
S  #   #   # # #   #   # #   # #
#### # # ### # # ### ### ##### #
   # #   #   #   #   # #   #   #
 ### ##### ### ### ### # # # ###
   #     # #     #   # # # #   #
## ##### # ### ##### # # ##### #
 #           #     # # # #G  # #
 ### ####### # ### # # # # ### #
     #   # # # #   # # # #     #
###### # # # # ##### # # #######
       # #           # #   #   #
 ####### # ### ####### ### # # #
 #       #   #   #         # # #
## ####### # ### # # ####### # #
   #   # # #   #   # #       # #
 ##### # # ### ####### ####### #
     # # # #   #       #       #
 ### # # # # ### ####### #######
   #     # #     # #     #     #
 # ##### # ####### # ##### #####
 #   #   #   #   #   #   #     #
 ### ####### # ####### # ##### #
   #                   #       #
################################
