################################
#       # #         #     #     
# # ### # # # ### # ##### # ### 
# #   # #   #   # #       # # # 
##### # ####### # ######### # # 
#     # #G  #   #         #   # 
# ##### # # # ######### ### ### 
# #       # #         #     #   
# # ####### ######### ####### ##
# # # #   #     #     #     #   
# # # # # ##### # ##### # # ### 
# # # # # #     #     # # # # # 
# # # # # # ######### # # # # # 
# #   # # # #   #   #   # #   # 
# ##### # # # # # # ##### ##### 
# #   # # #   #   #     # #     
# # # # # ############# # # ### 
# # #   #   #     # #   # # #   
# # ####### ##### # # ### # # ##
#   # #   #     #   #   # # # # 
##### # ####### # ##### # # # # 
#   # # #   #   #     # # # # # 
### # # # # # ### ### # ### # # 
#   #   # # #   #   #   #   #   
# ### ### ##### ### ##### ### ##
#       #       # #   #   # #   
##### ########### ### # ### ### 
#     #             # # #   #   
# ##### ############# # ### # # 
#   # #       #   #   #   # # # 
### # ####### ### # ##### # # # 
#S                        #   # 
