################################
#       #                       
# ##### # # # ####### ##### ### 
#     #   # # #   #   #     #   
##### ##### # # # ##### ### ####
#     #     #   #   #   #   #   
# ##### # ######### ######### # 
# #   # # #       # #G S    # # 
# # ### # # ##### # # ##### # # 
# # #   # #   # # #   #     # # 
# # # ### ### # # ##### ##### # 
#   # #     #   #     #       # 
# ### ####### ##### # ######### 
#   #         #   # #       #   
# ############# # # # ### # # ##
# #     #       #   #   # # #   
# # ### # ############# # ##### 
# # # # # #             #   # # 
# # # # # ######### ### ### # # 
# # #   # #       #   #   #   # 
### # ### # ##### ### ######### 
#   # #         #   #     # #   
# ### ######### ### ##### # # ##
# #   #   #       #     #   #   
# # ### # ############# # ##### 
# #   # #   #       #   # #     
# ### # ### # ##### ####### ####
#   #   # # # #   # #     #     
### ##### # # # # # # ### ##### 
#   #         # # #   #       # 
# ############# # ########### # 
#               #           #   
