################################
           #         #   #   # #
 # ##### # ##### ##### # ### # #
 #   #   #     # #     #     # #
#### # ####### # # ########### #
   # # #         # #         # #
 # # # ### ####### # # ##### # #
 #   #  G#     #   # #   # # # #
 ### ### ##### # ####### # # # #
   #   # #     #         # # # #
## ##### ##### ########### # # #
 # #   # #   #             # # #
 # # # ### # # # ########### # #
 # # #   # # # # #         # # #
 # # ### # # # ### ##### # # # #
   #   #   # # #   #   # #     #
## ### ##### # # ### # ### #####
     # # #   #   #   #   # #   #
 # # # # # ##### # ##### # # # #
 # # #   # #   # #   #   # # # #
 # # ##### # # # ### ####### # #
 # # #  S#   # #   #         # #
## # # ####### # # ########### #
   #   #       # # #         # #
 # ##### ####### # # ######### #
 # #     #       # #           #
 # # ####### ##### ######### ###
 # # #   #   #         #   #   #
 ### # # # ### # ### # # # ### #
 #   # #   #   # #   # # #     #
 # ### ##### ### # ### # ##### #
 #     #     #   #   #   #     #
