################################
################################
#   #   #         #   #         
# ### # # ####### # # # ########
# #   # #       #   # #    S    
# # ################# # ####### 
# #       #           # #       
# ##### ### ########### ########
#       #   #         #     #   
# ####### ### ####### ##### # # 
# #       #   #         # #   # 
# # ########### ####### # ##### 
# #           #   #   # #     # 
# ########### # # # # # # ### # 
#     #       # #   # #   # # # 
##### # ######### ### ##### # # 
# #   #         # #   #   #   # 
# # ########### ### ### # # ### 
#       # #     #   #   # # #   
##### # # # ##### # # ### # # ##
#     # # #   # # # #   #   #   
# ##### # ### # # ####### ##### 
# #   # #   # #   #     #     # 
# # ### ### # ##### ### # ### # 
#   #       # #   # #   #G  #   
##### ####### # # # # ##### ####
#     #     #   #   # #   # #   
# ##### ### ######### ### # # ##
# #   #   # #   #     #   # #   
# # # ### ### ### ##### ### ### 
#   #                           
################################
