################################
#     #      G#                 
# ### # ####### ##### ######### 
# # # # #       # #   #       # 
# # # # # ####### # ### ##### # 
# #     # #   #   #       #   # 
### ##### # # # # ####### # ### 
#     #   # # # # #     # # #   
# ##### ##### ### # ### # # # # 
#   #   # #       #   # # # # # 
# # # ### # ######### # ### ### 
# #         #   #     #   #   # 
# ########### # # ####### # # ##
# #   #       # #     # # # #   
# # # # # ##### ##### # # ### # 
# # #   # #   # #   # # #   # # 
# # ##### # ### # # # # ### ### 
# # #     #   #   # # #   #     
# # # # ##### ##### # # ########
# # # #   #   #   #   #       # 
# # ####### ### # ##### ##### # 
# #         #   #     # #     # 
# ########### ####### # # ##### 
# #     # #   #     #   #       
# ### # # # ### ####### ########
#   # # #   #     #   # #   #   
### # # # ### ##### # # ### # # 
# # #S#       #     # #     # # 
# # ### ##### # ##### ####### # 
# # #   #   # # #   #     #   # 
# # # ### # ### ### ##### # ### 
#         #             #   #   
