################################
################################
#   #               # #     #   
# # ### ##### # # # # # ### # # 
# # #   #     # # # # #S  # # # 
# ### # # ### ### # # ### ### # 
#     # # #   #   #     # #   # 
######### ##### ### # # # # ####
#         #   # #   # #         
# ####### # # # ##### ######### 
#   # #   # # #   #   #       # 
### # # # # ##### # ### ##### # 
#   #   # #       #   #   #     
# ##### ################# ##### 
# #   # #           #     #   # 
# ### # # ######### # ##### # # 
#     # #   #   # # #     # #   
########### # # # # ##### # ### 
#       #   # #   # #   # # #   
# ##### # ### # ### # ### # # ##
# #   # # #   # #   #     # #   
# # ### # # # # # ######### ### 
# #   #   # # # #           # # 
# ### ##### # # ############# # 
#   #   #   # #   #  G  #   # # 
### ### # ### ### # ### # # # # 
#   #     #   #     #     # #   
# ######### ############### ### 
#         #   #     #     #   # 
######### # # # ### # ### # # # 
#         # #   #   #   #   #   
################################
