################################
 #         #   #         #   # #
 # ####### ### # ### # # # # # #
 # #       #   # #   # #   #   #
 # ### ##### ### # # # ####### #
 #   #     #     # # #   #   # #
 ### ##### ####### ##### ### # #
   #     #   #     #   #   #   #
 ####### ### # ### # ##### # ###
 #   #   #   #   # #       #   #
 # # ##### ##### ############# #
 # #       #     #   #   #     #
 # ############### # # # ### ###
 #                 #   #   #   #
 ######################### ### #
 # #  S      # #       #   #   #
 # # ####### # # ##### ### # ###
   # #     #   #     #   # # # #
## # # ### ####### ##### # # # #
   # # #   #       #     # #   #
 ### # # ### ####### ##### ### #
     # # #   #   # #   # # #   #
 ##### # # ### ### ### # # # ###
   # # # #   #   #     # # #   #
## # # ##### ### ####### # # # #
   # #   #G#         #   # # # #
 ### ### # ##### ##### # # # # #
 #                     #   # # #
 ##### ##### ### ########### # #
   #   #     #   #     # #   # #
## ##### ##### ####### # # ### #
         #                 #   #
