################################
 #         #       #     #     #
 # ####### # # ### ### # ##### #
   #   #   # #   #     #   #   #
#### ### ### ### ######### ### #
     #   #     #         #     #
 ##### ##### ################# #
 #   # #   # #     #     #     #
 ### # # # # # ### # ### # #####
 #   # # # #   #   #   # #     #
 # ### # # ########### # ##### #
 #   #   #  S    #     # #   # #
 # ############# # ##### # # # #
         #       # #     # #   #
 ######### ####### # ##### ### #
 #       #      G  #         # #
 # ##### ########### ### ### # #
   #   #   #   #   #   # # # # #
 ### ### # # # # # ### # # # # #
 # # #   #   #   #   # # # # # #
 # # # ########### ### # # # # #
 # #   #         # #   #   # # #
 # ##### ####### ### ##### # # #
       #     # # #   #   # # # #
 ########### # # # ### # ### # #
 #       #   # # # #   #     # #
 # ##### # ### # # # ###########
 #   #   #     #   #       #   #
 ### ############### ##### # # #
 # #               #   #   # # #
 # ##### # ### ### ### # ##### #
         #   #   #     #       #
