################################
#     #           #   #   #     
# ### # ####### # # ### # # ### 
#   # # #       # #     # #   # 
### # # ################# ### # 
#   # #   #     #   #   #     # 
# ### ### # ### # # # ######### 
# #   # # # # #   #   #     #   
# ##### # # # ######### ### # ##
#       # #   #         # #     
##### ### ### ####### ### ### # 
#     #   # # #       #       #S
# ##### ### # # ####### ### ### 
#   #   #   #   #       #   #   
### # ##### ##### ####### # # ##
#   #     #   #     #   # # #   
# # ##### # # # # # # ### # ### 
# # #   #   #   # # #     # #   
# # # # ######### # ####### # ##
# # #G#           #     #   # # 
# # ####### ##### ##### ##### # 
# #         #   #     #   #   # 
# ######### # # ######### # ### 
# #   #     # #   #       # #   
# ### # # # # ### # ####### # # 
# #   # # # # # # # #       # # 
# # ### # ### # # ### ######### 
# #   # #   #   #     #   #   # 
# ### ##### ############# # # # 
#   #   #                 # #   
### ### # # ############### ####
#   #     #                     
