################################
                         #     #
############ # ######### ##### #
             # #   #   # #   # #
 ##### ##### # # # # ### # # # #
 #   # #   # #   # # #   # #   #
 # # ### # ####### # # ####### #
   #     # #       #   #   #   #
########## # ####### ### # # ###
 #         # # #     #   # #   #
 # ######### # # ######### ### #
   #         #   # #     # #   #
## # ######### ### # ### # # ###
   #   #       #       # # #G# #
 ##### ##### ### # ##### # # # #
     #     # #   # #   #       #
########## # # ##### # #########
  S#       # # #     #         #
 # # ####### # # ############# #
 #   #       #     #   #     # #
 ##### ####### ##### # # ### ###
     # #   #   #     # # # #   #
#### # # # ### # ##### # # ### #
   # #   #   #   # #   #   #   #
 # # ####### # ### # ##### # # #
 # # # #   # #   # # #     # # #
## # # # # # ### # # # ##### ###
   #   # # # #   # #       #   #
 ####### ### # ### ########### #
 #   #       # # #             #
 # ### # ##### # ###############
       #                       #
