################################
 #     #     #       #       # #
 # ### ### # # ####### ##### # #
 #   #     # #         #   # # #
 ### ####### ######### # # # # #
   # #   #   # #       # # #   #
## # ### # ### # # ##### # ### #
   #     # #     # #   # #   # #
 ######### ### ##### # # ### # #
         #   # #   # # # #     #
###### # ### # # # # # # ##### #
       #   # # # #   #   #   # #
 # ####### # # # ######### # # #
 # #     # # # #     #   # #   #
 ### ### # # ######### # ##### #
 #     # # # #      G  #     # #
 # ##### # # # ############# # #
 # #     #   # #           #   #
 # # ####### ### ######### ### #
 # #       # #   #     #     # #
## ####### # # ### ### ##### # #
   #   # # # # #   # #   #   # #
 ### # # # # ### ### ### # ### #
   # # # #S#     #     # # #   #
## # # # # ####### ##### # ### #
 # # #   # #   #     #   #   # #
 # # ### ### # ### ### ##### # #
 #   # #     #   #     #       #
 ##### ######### # ##### ##### #
       #     #   # #   #     # #
 ##### # # ### ### ### # ### # #
     #   #               #   # #
