################################
################################
#         #         #   #       
##### # # # ####### # # # # ####
#     # #   #   #   # #   #     
# ##### ####### # ### ######### 
# #     #       #   #     #     
# ### # # # ####### ##### # ####
#   # # # # #     #       #     
# # ### # # # ### ############# 
#S# #   # # #   # #   #     #   
### # ### # ### # ### # ##### ##
#   #     #     # #   #     # # 
# # ############# # ####### # # 
# # #         #   # #     #   # 
# ### ####### # ### # # ####### 
#   #     #   #   # # # #     # 
### ##### # ##### # # ### ### # 
# # #   # #     #   #   # #   # 
# # # # # ##### # ### # # # ### 
# # # # #   # # #     #   #     
# # # # ### # # # ##############
# #G  #     #   #       #       
# ############### # ### # ##### 
# #   #           # #   #     # 
# # ### ##### ##### ######### # 
#   #   #     #             # # 
# ### ### ################# # # 
#   #   #           #       # # 
### ### ########### ######### # 
#                 #           # 
################################
