################################
       #   #             #     #
 ##### # # # ########### # ### #
   #   # # #   #     # # #   # #
 # # ### # ### # ### # # ### # #
 # # #   #   #   # # # #   # # #
 # # # ##### ##### # # ### # ###
 # #   #   #       #   #   #   #
 # ##### # ####### ### ####### #
 # #     #           #   #   # #
 # # # ######### # # ### # ### #
 # # #   #       # #   # #     #
## ##### ####### # ### # ##### #
   #   #     #   #   # #   #   #
 ### # ##### # ##### # ### # # #
 #   # #     # #   # #G# # # # #
 ### ### ##### # ### # # # ### #
   # #   #     #     #       # #
## # # ### ################# # #
   #   #       #     #   #     #
 ### ######### ##### # # ##### #
   # #     #   #     # #       #
 # ### ### # ### ##### ####### #
 #     #   #     #   # #   #   #
################ # # # # # # ###
   #     #     # # #   # # #   #
 # # ### # ### ### ##### # # # #
 # #   # #   #     #     # # # #
 ##### # ### ####### ##### # # #
     # #   #       # # #  S# # #
#### # ### ####### # # # ##### #
       #           #   #       #
