################################
#   #   #   #   #       #   #   
# ### # # # # # ### ##### # # # 
#     #   # # #   # #   # # # # 
########### # ### # # # ### # # 
#       #   #   # # # #     # # 
# ##### # ####### # # ######### 
# #   #   #     #   #   #       
# # # ##### ### # ##### # # # ##
# # #     # # # # #   #   # #   
# ##### # # # # # # # ##### ### 
#       #   # # # # # #     # # 
############# # # # ### # ### # 
#   #     #   # #       #   # # 
# # # ### # # # ##### ##### # # 
# #   #   # # #   # # #     #   
# ##### # # # ### # # # ####### 
# #     # # #   # #   #       # 
# # ##### # ##### ### ####### # 
# # #     #     #   #   # #  S# 
# # ##### ##### ### # # # # ### 
# #     # #   # #  G# #   # #   
# ##### ### # # # ### ##### # ##
# #   #   # # # #   #     # #   
# ### ### # ### ### # ### # ####
#   #     #   # #   #   # #     
### ######### # # ####### ##### 
#   #   #     # #   #   #   #   
# ### # # ##### ### # # ##### # 
#   # # # #   #   #   #   #   # 
### # ### # # ### ####### # ### 
#           #               #   
