################################
#             # #               
### # ####### # # ### ##### ####
#   #     #   # # # # #   #     
# ######### ### # # # # # ##### 
#   #     #   # #   # # # #   # 
##### ### ### # # ### # ### # # 
#     # #   # # # #   # #   #   
# ##### ### # # # # ### # ##### 
#   # # #   #     # #   # #     
### # # # ### ### # # ### # # ##
#   # #   #     # # #     # #   
# ### ##### ### ### ############
#             #   # #           
# ### # ##### ### ### ######### 
#   # #   #     #   #         # 
### # ### ####### # ######### # 
#   # #G  #     # #         # # 
# ### ##### ### ### ####### ### 
#   #     # #S#   #   #   # #   
### # ### # # ### ### # # # # ##
#   #   #     #   # # # # # # # 
# ############# ### # # # # # # 
#           #   #     # #   # # 
########### # ####### # ##### # 
#     #   # # # #   # #       # 
# ### # # # # # # # # ######### 
# # # # #   # # # # #   #       
# # # # ##### # # # # # # ##### 
#   # # #     #   # # # #   #   
### ### # ######### # # ### # ##
#       #           # #     #   
