################################
################################
       #         #       #     #
 ##### ### ##### ### ##### # # #
     #     #   #           # # #
 ########### # ############# ###
   #         # #     #     #   #
 ### ### ##### # ### # ### ### #
   #   # #   #  G# #   # #   # #
## ### ### ####### ##### ### # #
   # #   #   #   #     #   # # #
 # # ### ### # ####### # ### # #
 # # # # #   #   #     #   #   #
 # # # # # ### # # ####### #####
 # # # #   #   # #S#     # #   #
 ### # ##### # # # # ##### # # #
     # #     # #       #   # # #
 ##### # ##### ######### ##### #
     #   #   # #     #   # #   #
## # # ##### # # ### # ### # ###
 # #   #     #     # #   #     #
 # # ####### ####### ### ### ###
   #         #   #     #   #   #
######## ##### # # ####### # # #
 #     # #     # #       # # # #
 # ### # # ##### ####### # # # #
 # #   # #     #       #   # # #
 # ### # ### ### # ### ##### ###
 #   # #     #   #   #         #
 ### # ####### ##### ##### ### #
     #         #     #     #   #
################################
