################################
################################
                 #   #         #
 ######### ##### # ### ### # # #
   #   #   # #   # #   #   # # #
## # ### ### # ### # ### ### # #
   # #   #     #       # #   # #
 ### # ### ##### ####### # ### #
     # # #       #       # #   #
###### # ##### ########### ### #
       #   #   #   #       #   #
 ######### # ### # ######### ###
   #     # #   # #   #       # #
 # # ##### # ### ### ####### # #
 # # #         #   # #     #   #
## # # ##### # ### # # ### ### #
   #   #   # #   # # # # #   # #
 ####### # # ##### ### # ### ###
 #     # #    G    #       #   #
## ### ##### ####### ######### #
   # # #     #     #   #       #
 ### # # ### # ### ### # #######
 #       #   # # #     #     # #
 # ####### # # # ########### # #
 #   #   # # #     #   #   # # #
 ##### # # # # ##### # # # # # #
 #  S  # # # # #     #   #   # #
 # ##### ### # # ############# #
 #     #     # # #   #   #   # #
 ##### ####### # # # # # # # # #
     #         #   #   #   #   #
################################
