################################
################################
   #   # #   #     #     #     #
 # # # # # # ##### ##### # ### #
 # # #   # #     #   #   #   # #
 # # ##### ### ##### # ##### ###
 #     #   # #     # #     #   #
#### ### ### ##### # ##### ### #
   # #   #   #   #   #   #   # #
 # # # ### ### # ##### ##### # #
 #   #   # #   #     #     # # #
 # ##### # # ####### ##### # # #
 # #     #   #         #   # # #
 # # ######### ####### # ### # #
 #     #   #   #   #     # #   #
 ### # # # ##### # ##### # ### #
   # #  G#     # #     # # #   #
 # # ######### ####### # # # ###
 # #         #     #   # # # # #
 # ######### ##### # ### # # # #
 #     # #   #   #   # #   # # #
 ##### # # ##### ##### ### # # #
 #   #   #       #   #   # # # #
 ### ############### # ### # # #
     #         #         # #   #
 ##### ####### # ####### # ### #
   #   #     # #   #   #   #   #
## # ### ### # ### # # ##### ###
   #S#   #   #   #   # #   #   #
 ##### ### ##### # ##### # ### #
         #               #     #
################################
