################################
# #   #         #   #         # 
# # # # ####### # ### ####### # 
#   #     #     #     #   #   # 
######### ############# # # ### 
#     #             #   # # #   
# ### ############# # ##### ### 
# # #   #       #   #     #     
# # ### ##### ### ####### ##### 
# # # # #   #                 # 
# # # # # # ################# # 
#   # #   #   #       #     # # 
##### ####### # ##### # ### # # 
#       #  G  # #   # # #   # # 
# ####### ##### # # # ### ### # 
#     #   #     # # #           
##### # ### # ### ##### ##### ##
#   # #   # #   # #   #     #   
# # # ### ##### # # # ##### # # 
# # #   #     # # # # # #   # # 
# # ### ##### # # # # # # ### # 
# #   #     #   # # #   # #   # 
# ### ##### ##### # ##### # # ##
#   #   #     # # #     # # #   
# # ### # ### # # ##### # ##### 
# #S#     # # #   #   #   #   # 
### ####### # ### # ####### # # 
#   #   #   #     #         #   
# ### # # ####### # # ##### ####
# #   #   #     #   #     # #   
# # ####### ####### ##### ### # 
#   #                   #     # 
