################################
################################
   #               #   #   #   #
 ### # # ######### ### # # # # #
     # # # #   #   #   # # # # #
 ##### # # # # # ### ### # ### #
 #     # # # # #     #   #   # #
## ### # # # # ### ### ##### # #
   #   # #   #    G#   #   # # #
 ### ### ##### ##### ### # # # #
   #  S#     #     #   # # # # #
 # ######### ##### ### # # # # #
 #         #     #   #   # #   #
 ####### # ##### ######### #####
       # #     #         #     #
 ### # # # ########### ####### #
 #   # # # #         #   #   # #
## ### # # # ####### ### # # # #
   #   # # #       # # # # #   #
 ### ### # ####### # # # # #####
 #     # # #       #   # # #   #
 ####### # # ########### # ### #
 #       #   # #       #   #   #
## ####### ### # ##### ##### ###
   #     #     # #     #     # #
 ####### # # ### # ##### ##### #
 #   #   # #     #       #   # #
 # # # ### # ############# ### #
   # #     #       #       #   #
#### ####### ### # # ##### # ###
     #       #   #       #     #
################################
