################################
#       #       #     #     #   
# ####### ##### # ##### ### # # 
# #       #     #       #     # 
# # ####### ########### ####### 
#   #                   #     # 
##### ######### ####### # ### # 
#     #   #   # #     # #   #   
# # # ### # # # # ### # ####### 
# # # #   # # # # # # # #  G  # 
# # ### ### # # # # # ### ### # 
# #     #   # # # # #   # # #   
# ####### ### ### # ### # # ### 
# #   # #   #     # #   # # #   
# # # # ### ####### # ### # # ##
#   #     #     # #   #   # #   
############### # # ### ### ### 
#             # # #   # # #   # 
# ########### # # ### # # # # # 
# #       # #   # # # # # # #   
# # ##### # ##### # # # # # ####
# #     # # #   #   #   # #     
# ####### # # # # ####### ##### 
#     #   # # # # #   #       # 
# # # # ### # # # # ### # ##### 
# # # #   # # # # #     #       
# # # ### # # # # ##### ########
# # #   #S#   #                 
### ##### ####### ### ##### ####
#   #   # #   #   #   #     #   
# ### # # # # # # # ### ##### # 
#     #   # #   # #   #       # 
