#                               
# ######### ########### ####### 
# #   #   # #   #     #     #   
### # # # ### # # ### ##### # ##
#   #   #   # #   #         #   
# ######### # ################# 
# #         #   #   #   # #   # 
# # ##### ##### # # # # # # # # 
# # #   #   #   # #   #   # #   
# ### # ### # ### ######### ### 
#     #   # # #   #   #   #   # 
# ####### # # # ### ### # ### ##
# # #     #   # #   #   #   #   
# # # ####### # ### # ######### 
#   # #     #G# #   #     #     
# ### # ### ### # ####### # ####
#   #   # # #   # #     #   #   
### ##### # # ### # ### ####### 
#         #   #     #       #   
# ##### ####### ############# ##
# #   # #       #     #     #   
# # # # # ### # # ### # ### ### 
#   # #   #   # # # #   # # #   
##### # ######### # ##### # # ##
#     # #   #     #       # # # 
# ### ### # # ########### # # # 
#   # #   # #   #       # #S  # 
# # # # ### ### # ##### # ##### 
# # # #   #   #   # #   # #   # 
# # ##### ### ##### # ### # ### 
# #         #                   
################################
