################################
#               #         #S    
# ### ######### # ####### # # ##
# #   #       # #   #     # #   
### ### ##### # ### # ##### ### 
#   #   #   #   # # # #       # 
# ### ### # ##### # ### ####### 
#   #     # #   #       #       
########### # # ### ############
#       #   # #     #           
# ##### # ######### # ######### 
#   #   # #         #   #   #   
### # # # # ########### # ### # 
#   # #   #     #   #   # #   # 
# ### ##### ### # # # ### # ####
#   #       # # # #   #G  # #   
### # # ##### # # ####### # # # 
#   # #       #   #     # # # # 
# ### # ##### ######### # # ### 
# #   #   #   #       # # #     
# ######### ### ### ### # ######
#   #     #     #   #   # #     
# # # ### # ##### # # ### # ### 
# # # #   # #     # #   #   #   
### # # ### # ##### ### # ### ##
#   # #   # # #     #   #   #   
# ####### ### ####### ##### ### 
#   #     #   #       #   # # # 
### # ##### # # ####### # # # # 
#   #   #   # # #       #   # # 
# ##### # ##### # ### # ##### # 
#       #         #   #     #   
