################################
#               # #   # #   #   
############### # # # # # # # # 
#     #   #       # #   # #   # 
# ### # ### ##### # ##### ##### 
#   # #     #   #   #     #     
### # ### ### # ### # ##########
# # #   # #   #   #             
# # ### ### ##### ####### ##### 
# # #   #   #   # #     # #   # 
# # # ### ### # # # ### # # # # 
# # #   # #   # # # #   #S  # # 
# # ##### # # ### # # ####### ##
# #       # #   #   # #         
# ######### ### ##### ######### 
# #     # # #   # #   #       # 
# # ### # # # ### # ### ##### # 
# #   #   # # #     # # #   # # 
# ### ### # # # # ### # # # # # 
#     #   # # # #     # # #     
####### # # ### ##### # ####### 
#     # # #   #     # # #     # 
# ### ### ### # ### # # # ### # 
# # #   # #   # #   # #   #   # 
# # ### # # ### # ### ##### ### 
#   #     #   #G# #   #     # # 
##### ####### # ### ### ##### # 
#   # #       #   #   #       # 
# # # # ######### ### ######### 
# #   #         #   # #       # 
# ### ######### ### # # ##### # 
#   #               #       #   
