################################
################################
   #   #   #  G#     #     #   #
 # # ### # # ### ### ##### # # #
 # #     # #     # #   #   # # #
 # ####### ####### ### # ##### #
 # #     # #       #   #       #
 # # ### # # # ##### ### ##### #
 # #   #   # # #   #   #     # #
 # ### ####### # # ### # ### ###
 # #   #     # # #   # # # #   #
 # # ####### # # ##### # # ### #
 # # #         # #           # #
 ### # ######### # ########### #
   # #     #     #     #     # #
## # ##### # ######### # ### # #
 #      S    #     #   #   # # #
 # ######### # ### # ##### # ###
   #   #     #   # # # #   #   #
## # # # ### ### # # # # ##### #
 # # #   #       # #   #     # #
 # # ##### # ### ##### ##### # #
   #     # # #   #   #       # #
#### ### # ### # # ####### ### #
   #   # #   # # #         #   #
 # ### # ### # # ### # ##### ###
 # #   #   # # #     #     #   #
 # ######### # ##### ######### #
 # #   #   # # #   # #         #
 # # # # # # # ### # # #########
 #   #   #   #     # #         #
################################
