################################
################################
   # #           #   #       # #
 # # # ######### ### # ##### # #
 # # # #     #   #   # #   #   #
 # # # # ### # ### ### # # # ###
 #   #   # # #     #     # #   #
 ######### # ######### ### #####
 #           #   #   #   #     #
 # ########### # ### ### ##### #
   #   #     # #     #G#   # # #
 ### # # ### # ####### ### # # #
 #   # #   # # # #           # #
 # ### ### # # # # ########### #
   # # #   # # #   #       #   #
#### # ##### # # ### ##### # # #
 #   #   #   #     #     #   # #
 # # ### # ### ######### ##### #
   # #   # #   #   #     #     #
#### # ### # ### # ####### # ###
         # #     #       # # # #
 ####### # # ########### # # # #
 #S      #           #   # #   #
 # ### ### ######### # #########
 #   #   #   #     # # #       #
#### ### # # # ### # ### ##### #
   #   #   # # #   #   #   #   #
 ##### ##### # # ### # ### # ###
 #     #   #   #   # # #   # # #
 # ##### # ####### # # # ### # #
   #     #         # #     #   #
################################
