################################
#     #       #G    #         # 
# # # ####### # ##### ####### # 
# # #     #   # #   # #     #   
### ##### # ### # # # # ########
#   # #S  # #   # #   #         
# ### # ### # ### ######### ### 
# #     #   # # #   #       #   
# ### ##### # # ### # ####### ##
#   # #   # #   # # #     # # # 
### # # # # ### # # ### # # # # 
#   # # # #       #   # # # #   
# ### # # # ##### ### ### # ### 
# #     # # #     # #     # #   
# ####### # # ### # ####### # ##
# #     #   #   # #   #   # #   
# # ### # ##### # # # # # # ### 
# # #   # #   # #   # # #     # 
# # # ##### # # # ##### ####### 
# # # #   # # # #       #       
# # # # # # # ### ####### ######
# # #   # # #   #     # #   #   
# # ##### # ### ##### # ### # # 
# #   #   # # # #   #     # # # 
# ### # ### # # # ### ### # ### 
#   # # #   #   #     #   #     
# # # # # ##### ####### # # ####
# #   # # #   # #       # #     
####### # # # # # ####### ##### 
#   #   #   # # # #     #       
# # ######### # # # ########### 
# #           #   #             
