################################
       #           #   #       #
 # ### ### ####### # # # ##### #
 # # #     #   #     # #     # #
 # # # ####### # ##### ##### # #
 #   # #     #   #   #   #   # #
 ####### ### ##### # ### # ### #
 #   #   # #     # #     # #   #
 ### # ### ##### # ####### # ###
 #   #G#   #   #   #       # # #
 # ### # ### ####### ####### # #
 # #   #   # #       #     # # #
 # # ##### # # ####### ### # # #
 # #  S    # #     #     # # # #
 # ######### ##### # ### ### # #
   #     #         #   #   #   #
 ### ### ####### ##### ### #####
     # # #     #     #   #     #
## # # # # ### # ### ### ##### #
   # #   # #   #   #     #   # #
 ### ####### ### # ##### # # # #
 #   #       #   # #   # # # # #
 ### # # # ### ### # # # # ### #
   #   # #     # # # # #   #   #
 # ### # ####### # # # ##### ###
 #   # #       #   # #       # #
#### # ####### ##### ######### #
   # #       # #   #           #
 ### ####### # # # #############
 #   #       # # # #   #       #
 # ### ##### # # # # # # ##### #
   #   #     #   #   #   #     #
