################################
################################
#     #         #   #     #     
# # ### ####### ### # ### # ### 
# #  S  #     #     #   # #   # 
# ####### ### ####### # ##### # 
#   #     # # #       #     # # 
### # ##### # # # # ######### # 
#   #     # #   # #   #       # 
# ####### # ##### ### # ####### 
#     #   #     # #   #   #   # 
##### # ####### # ####### # # # 
#   # #   #   #   #       # #   
# # # ### ### ##### ####### ####
# #   #       #    G# #   # #   
# ##### ##### # ##### # ### # ##
#   #   #   # # #   #   #   #   
### # ### # # # # ### ### ##### 
# # # #   #   # #     #   #   # 
# # ### ### ### # ##### ##### # 
#   #   # #     #     #       # 
# ### ### # ##### ### ######### 
#     # #         # # #         
####### ### ####### # # ### # # 
#     #           #   # #   # # 
# ### ####### ### ##### # ##### 
#   #       #   #       #     # 
### ####### ### # ########### # 
# #     #   #   #     #     # # 
# ##### ##### ####### # ##### # 
#             #       #       # 
################################
