################################
G#   #         #   #   #     # #
 # # # ######### # # ### ### # #
   # #     # #   #   #  S# #   #
#### ##### # # ####### ### ### #
   #     # # #         #     # #
 # ##### # # ########### ##### #
 #       # #       #   #     # #
###### ### # ##### # # ##### # #
     # # # #     # # #     # # #
 ### # # # ##### # # # ##### # #
 #   #   #     # # # # #     # #
 # ##### ##### # # ### # ##### #
 #       #   #   #     #   #   #
 ####### # # ######### ### # ###
 #       # #       #           #
 # ####### # ##### # # ####### #
 #         #     # # # #       #
 ############### # # ### ##### #
       # #     # #   #   #   # #
 ##### # # ##### # ### ##### ###
   #   # #     # # #   #   #   #
## # ### ##### # # # # # # ### #
   #     #     # # # # # #   # #
 ######### ##### # # ### ### # #
 #   #     #     # #   # # #   #
 # # # ##### ##### ### # # #####
   # #   #   #       #   #     #
 ### ### ### # ### ########### #
   # # # #   #   #           # #
## # # # # ##### ####### ##### #
   #   #   #           #       #
