################################
#       #       #     #   #   # 
# ##### # # # ### ### # # ### # 
# #     # # # #   #   # #   #   
# # ##### # ### ####### ### ### 
# #     # #   # #   #     #   # 
# ####### ### # # # ######### # 
#   #     #   # # # #       #   
### # ######### # # # ##### ### 
#   # #   #     # # # #   # # # 
# ### ### # ##### # ### # # # # 
#   #     #   #   #     # # # # 
### ##### ### # # ####### # # # 
#       #   #   # #   #   #     
# ### # ### ##### # # # ### ####
# # # #           # #   #       
# # # ### ### ### # ### # ##### 
#   # #   #   #   #   #   #   # 
##### # # # ######### # ### # # 
#     # #S#   #       #   # # # 
# ##### ####### ######### # # # 
# #   # #   #   #       # # #   
# # # # # ### ### ##### ### ### 
# # # #   #   #G    # # #   #   
# # ####### ####### # # # ### # 
#   #       #       # #   #   # 
##### ####### ####### ##### ### 
#   #   #   # #         #   #   
# # ### # ### # ##### # ##### ##
# #   # # #   # # #   # #   #   
# ### # # # ### # # ### # # ### 
#   #   #   #     #   #   #     
