################################
 #       #     # #           # #
 # ##### # ### # # # ####### # #
   #   # # #   #   # #   # #   #
#### # # # ######### # # # ### #
     # # #         #   # # # # #
###### # ######### ##### # # # #
       # #               #   # #
 ##### # # # ############# ### #
 #   # # # # #       #   # #   #
 ### # # ### # ##### # # # # ###
   #         # #   #   # #     #
## # # ####### # # ##### ##### #
 # # # #       # #       #     #
 # ### # ####### ######### ### #
   #   #S#   #   #    G  #   # #
#### ### # ### ### ##### ### ###
     #   #   #     #   #   #   #
 ##### ##### ####### # ### ### #
     #     #         #   # #   #
#### ##### # ########### # # ###
   #     # # #           # #   #
 ##### # # # ######### ### ### #
 #   # # # # #       #         #
 # # # # # ### ##### ###########
 # #   # #     #     #       # #
 # ##### ####### ### # ##### # #
   #     #     #   # # #   # # #
#### ### ##### ### ### # ### # #
   #   #     # # #     #   # # #
 # ### # # ### # ####### # # # #
 #     # #               # #   #
