################################
################################
#         #     #         #     
######### # ##### ####### # ### 
#     #   #       # #       #   
# ### # ########### # ##########
# # #         #   # #     #     
# # ########### # # ##### # ### 
# #   #         # #     # #   # 
# ### # ########### # # # ### # 
#   # # #           # #     # # 
### # # # ### ####### ### # # # 
# # # # # #   #  G    #   #   # 
# # # # # # # # ############### 
# #   #   # # # #   #         # 
# ### ##### # # # # # ### ##### 
#   #       # #   # # #   #S  # 
# ##### ### ####### # ##### # # 
#     # #   #     #   #     # # 
##### # # ### ### ##### ##### # 
#   #   # # #   #       #   #   
# ##### # # ### ######### # ####
# #     #   # #   #     # #     
# # ### ##### ### ##### # ######
#   #           #   #   #   #   
##### ### # ### ### # ##### # # 
#   #   # # #     #   #   #   # 
# # ### # # ########### # ##### 
# #   # # #         #   #       
# ##### # ######### # ##########
#       #         #             
################################
