################################
################################
           #   #         #     #
 # ####### # # ### ##### # ### #
 # #   #   # #   # # #   #   # #
 # # # # ####### # # # ##### ###
 # # # #       # #   # #   #   #
 # ### ####### # ##### # # ### #
 #   #   #   # #   #   # #     #
 ### # # # # # ### # ### #######
   # # #   #   #   #   #   #   #
## # ######### # ##### ### ### #
   #   #     # #       # # #   #
 ##### # ### # ####### # # # # #
   # # # #   # #   #   # #   # #
## # # # # ### # # # ### ##### #
   # #   #   # # #         #   #
 ### ######### # # ####### # ###
     #       #   # #   #   # # #
 ##### ##### ##### # # ##### # #
   #   #   # #       #       # #
## # ##### # # ##### ######### #
   #   #   # #   #   #  S      #
 ##### # ### ### # ### ##### ###
     # # # #   # # #   #   #   #
#### # # # ### # # # ##### ### #
 #   #   #   #   #   #   #   #G#
 # # ####### ########### # ### #
   #       # #   #     #   #   #
######## # # ### # ### ### # ###
         #           #     #   #
################################
