################################
#   #   #           #   #   #   
# # # ### ######### ### # # # # 
# # # #   #       #   # # #   # 
# # # # ######### ### # # ######
# # # #     #   #   # # # #     
# # # ##### # ##### # # # ### # 
# # #       #     # #         # 
# # ############# # ##### ##### 
# # #     #     #         #   # 
# ### ### # # # ### ### # # # # 
#     # # # # # #   #   # # #   
####### # ### # ##### ##### ### 
#       #   # # #     #   # # # 
# ######### # # # ##### # # # # 
# #   #   # # #   #   # #   # # 
# # # # ### # ##### # # ##### # 
# # #   #   #   #   # # #S  # # 
# # ##### ####### ### # ### # # 
# # #   #         # #   #   # # 
# # ### ########### ##### ### # 
# #     #             #       # 
# ##### # # ### # ### # # ##### 
#   #   # #   # #   #   # #     
# ### ##### # ##### ##### # ####
# #G  #   # # #   # # #   # #   
# # ### # ### # # # # # ### # # 
# # #   #     # # #   # #   # # 
# # # ######### # ##### # ### # 
#   #   #     # # #       #   # 
# ##### # ### # # # ### ### ### 
#       #   #   #   #       #   
