                               #
 # ### ### ######### ######### #
 #   #   #    S#   #       #   #
 ### ### ####### # ### ### # ###
 #   # #       # # # #   # #   #
 # ### ####### # # # ### ##### #
 # #   #     # # # #     #     #
 # ### # ### # ### ##### # ### #
 #   #   #   #     #   # # #   #
 ### ##### ######### # ### #####
   #     #         # #     #   #
#### ### ######### # ##### # # #
   # #   #   #       # #   # # #
 # ### ### # ### ##### # ### # #
 #  G#   # #     #   #   #   # #
 ### ### # ####### # ##### ### #
 # #   # #     #   #       #   #
 # ### # ##### # ########### ###
 #     # # #   #           #   #
 ### ### # # # ############### #
   #   # #   #   #       #     #
## ### # ####### # ##### # #####
   #     #       #   # # # #   #
 ### ########### ### # # # # # #
 #   #       #   # # # #   # # #
 ##### ##### # # # # # ####### #
       #   # # #   #   #   #   #
 ####### # # ######### # ### ###
         # #           # #   # #
 ####################### # ### #
                               #
################################
