################################
   #             #   #     #   #
 # ##### # ##### # # ##### # ###
 #   #   #   # # # #     # #   #
 ### # ##### # # # ##### # ### #
 #   #   #   # #   #     #     #
 # ### # # ### ##### ######### #
 # #   # # # #   # # #         #
## # ### # # ### # # # #########
   # #   # #       # #     #   #
 ##### ### # ####### ### ### # #
     #   # #     #   #   #   # #
#### ##### ##### # ### # # #####
   #     #   #   #     # #     #
 # ##### ### # # ### ### ##### #
 #   # #     # # #   #     #   #
 ### # ####### # ### # ### ### #
 #   #   #S    #     # # #G  # #
 # ### # ### ######### # ### # #
 #     #     #     #   #       #
 ### ######### ### # # #########
 #   #   #     #   # # #       #
 ##### # # ######### # # ##### #
 #     #     #       # # # #   #
 # ########### ##### ### # # ###
   #     #     #     #   # # # #
 ### ### # ########### ### # # #
   # # # #       #   # #   #   #
 # # # # ####### # # # # ##### #
 # #   #       # # #   #   #   #
 # ########### # ####### ### ###
 #             #               #
