################################
 #     #                 #     #
 # ##### ####### ####### # #####
     #   #   # #   #   # #     #
#### # ### # # ### # # # ##### #
   #       #   #   # # #     # #
 # ### ####### # ### # ##### # #
 #   # #   # # # #   #     # # #
 ### ### # # # ### ####### # # #
   # #   # #     #       # # # #
## ### ### ##### ######### # # #
   #   # #    S# #     #   # # #
 ### ### ##### # ##### # ### # #
 #   # #     # #   #   # #   # #
 # ### # ### # ### # ### # # # #
   #   # # #   #   #   # # #   #
#### # # # ##### ##### # ### ###
     # #G#   #         #   #   #
 ##### # # # # ########### # # #
     # #   #   #       #   # # #
 ### # ####### # ##### # ### # #
 #   #       # # #   #   #   # #
 # ######### # # # # ###########
 #     #   #   # # #     #     #
 ##### # ##### # ####### # ### #
   # #   #   # #     #   # # # #
 # # ##### # # ##### # # # # # #
 # #   #   # #         # #   # #
 # ### # ### ##### ##### ##### #
 #   # # #       # #     #   # #
 # ### # ####### ### ### # # # #
 #     #       #     #     #   #
