################################
################################
   #         #           #   # #
## # ####### # ######### ### # #
   # #     # #   #   # #     # #
 ### # ### # ### # # # ####### #
 #   # # # #     #S#         # #
 ##### # # ### ####### ##### # #
       # #   #         #   #   #
######## ### ########### ##### #
   #   #   #     #       #   # #
## # ### # ##### # ####### # # #
   #     #   # # #       # #   #
 ### ##### # # # ### ##### #####
     #     #   #   #       #   #
#### # ####### ### # ####### # #
   # # #     #   #       #   # #
 # # # # ####### # ####### ### #
 # # # # #     # # #   #   # # #
 # # # # # ### # # # # # ### # #
 #   #   #   #     # #   #   # #
 # ############### # ##### ### #
 # #       #     # # #   #   # #
 # # ####### ### # # # # # ### #
 # # #       # # # #   # # #G  #
 ### # ####### # # ##### # # ###
 #   # #         #     #   #   #
 # ### # ##### ####### ### ### #
 # #   # #   #     #     # # # #
 # # ##### # ##### # ##### # # #
   #       # #             #   #
################################
