################################
################################
#   #       #           #       
# # ### ### # ######### # ######
# #   # #   #     #     #   #   
# ### ### # ##### # ####### # # 
#   #     #   # # #   #   # # # 
# # ####### # # # ### ### # # # 
# #   #   # #   # #   #   # # # 
##### # # # ##### # ### ### # # 
#   # # # #     # #   # #   # # 
# # # # # ##### # ### # # ### ##
# #   # #     # #   #   # #G#   
# ##### ##### # ### ##### # ### 
# #     #   # #   #           # 
# # ####### # ### ##### ####### 
# #     #   #   #     # #       
####### # ##### # ##### # ######
#  S    # #   #   #     #   #   
# ####### # ### ### ####### # # 
# #   #       # #   #     # # # 
# ### ####### # # ### ### # # # 
#   #               # # #   # # 
# # ######### # ### # # ####### 
# #   #       #   # #   #   #   
# ### ########### # ### # # # ##
#   #   #         #     # # #   
####### # ############### ##### 
#     # # #   #   #   #   #   # 
# ### # # # # # # # # # # # # # 
#   #   #   #   #   #   #   #   
################################
