################################
################################
# #     #         #         #   
# # ##### ##### ### # ####### # 
#   #   #     #     #   #   # # 
# ### # ##### ######### # # # # 
#     #   #   #       # # #   # 
# ##### ### ### ##### # # ##### 
# #   #   #   #     # # # # #   
# # # ### # ######### # # # # ##
#   #   #   #       #   # # # # 
####### ##### ##### ##### # # # 
#         # # #     #   # #   # 
# ####### # # # ##### # # ##### 
# #     #   # #       # # # #   
# # ### ##### ######### # # # ##
# # #   #   #   #       # # # # 
# # ##### # ### # ####### # # # 
# #       #   # # #       # #   
# ########### # # # ####### ### 
#    S      #   #   #     #   # 
####### # # ##### ####### # # # 
#   #   # #     # #   # # # # # 
# # # ### ##### # ### # # # ### 
# # #   # #   #   #   #         
# # ### # ### ### # ### ########
# # # # #   # #   #   # #       
# # # # ### # # ##### # # ##### 
# #   # #   #   #  G  # # # #   
# ##### # ####### ##### # # # # 
#       #                 #   # 
################################
