################################
#   #   #         #       #     
# # # ### ######### ##### # ### 
# # # #   #   #     #   # # #   
# # # # ### # # ##### ### # ### 
# #   #     #   # #       # #   
# # ############# # ######### # 
# # #   #     #   #         # # 
# # # # ### ### ##### ##### # # 
# # # #   #   #   #   #   #   # 
# # # ### ### ### # ### # ##### 
# # #   # #     #   #   #       
# # ### ### ### ### # ######### 
# #   #     #       #     #   # 
##### ##### # ############# # # 
#   #       # #     #     # # # 
# # # # ### # ##### # ### # # # 
# #   #   # #       #   #   # # 
# ######### ########### ##### # 
#     #         #       #   #   
####### ### ### # ##### # ##### 
#       # # #   #  S#   #     # 
# ####### # # ##### # # ##### # 
# #         # #   # # # #   # # 
# # ######### # ### # # # # # # 
# # #     #   #   # # #   # # # 
# ### ### # ##### # # ####### # 
# #   #   #       # # #     # # 
# # ### ########### ### ### # # 
# # #   #     #  G#   #   # # # 
# # # ### ### # # ### ### # # # 
#   #       #   #   #     #   # 
