################################
################################
   #           #   #       #   #
 # ##### ##### # # # ##### # # #
 # #   # #     # #   #   # # # #
 ### # # # ### # ####### # # # #
     #   #   # # #     # #   # #
###### ####### # ##### # ##### #
 #   # #       # #   #       # #
 # ### # ##### # # # ####### # #
 # #   # #     #   # #     # # #
 # # ### # ### ##### # # ### # #
     #   #   #     # # # #   # #
 ##### ####### # ### # # # ### #
 #   #   #   # # #   # # #   # #
## # ### # # # # # ### ### ### #
   # #   # #   # #         #   #
 ### ##### # ####### ##### # ###
 #   #   # # #       #   # #   #
 # ### # # # # ####### # ##### #
 #   # #   # #   #   # #   #   #
 ### # ##### ### ### # ### #####
 #   #S#                 #     #
## ### # ##### ######### ##### #
   #   # #G    #   #   # #     #
 ### # ### ### # # # # ### ### #
 #   #   # #   # #   #     # # #
 # # ### # # ### ########### # #
 # #   # # #   #   #       # # #
 ####### # ####### # ##### # # #
         #       #   #     #   #
################################
