################################
      G#     #         #       #
###### ### # ######### # ##### #
   #   #   #     #     # #   # #
 # # ### ####### # ### # # # # #
 #   #         # #   # # # # # #
 ############# # ##### # # # # #
 #         #   #     # # # # # #
 ######### # ####### # # # ### #
 #   #   # # #     #   # #   # #
 # # # ### # # ####### # ### # #
 # # # #     # #           #   #
 # # # # ##### # # ####### #####
 # # #   #   #   # #       #   #
 # # ##### # ##### # ### ### # #
 # #   #   # #   # #   # #   # #
 # ### # ##### # ####### # #####
 # # # # #     #   #   #       #
 # # # # # ####### # # ####### #
   # # #   # #     # #         #
#### # ##### # ##### ######### #
     #   # #   #   #       #   #
 ### ### # # ##### # ##### # ###
 # #     #   # #   # #   #S#   #
 # ####### ### # ##### # ##### #
   #   #   #   # #     #       #
## # ### ### ### # ########### #
   #   # #     # # #   #   #   #
 ##### # ##### # # ### # ### ###
       #     #   #     # #   # #
 # ######### # ######### # ### #
 #                             #
