################################
################################
 #   #         #     #       # #
 # # ######### # ### # ##### # #
   #   #     # #   #   #   #   #
 ##### # ### # ### ####### #####
 #     #   #   #               #
 # ####### ### ### ########### #
 #     #   # # #   #       #   #
 ####### ### # # ### ##### # ###
 #   #   #   #   #   #     # # #
 # # # ### ##### # ######### # #
   #   # # #   # #     #   #   #
######## # # # # ##### # ##### #
       #   # #   #     #     # #
 ##### # ### ##### ####### # # #
 #   # #     #     #       #   #
 # # ####### # ############### #
   #       # # #   #   #     # #
###### ### # # # # # # # ### # #
     #   # # # # #   #   # #   #
 ### ### # # # ########### ### #
   #   # #   # #       #       #
## ### # ### # # ##### # #######
   #S#   #   #   #     #       #
 ### ### ######### ##### ##### #
G#       #     #   #     #   # #
 ######### ### # ####### # # # #
 #   #   #   # #       # # # # #
 # # # # ### # ####### ### # # #
   #   #     #       #     #   #
################################
