################################
################################
       #   #   #           #   #
 ####### # # # # # ### # # # # #
 # #     # # #   # #   # #   # #
 # # ####### ##### ####### ### #
 # #     #   #   # #     # #   #
 # ##### # ### # # # ### # # # #
           #   # #   #   # # # #
######## ### ##### ### ### # ###
       #     #S  #   #   # #   #
 ##### ### ### # ####### # ### #
 #       # #   #   #     #   # #
 # ##### # # ##### # ####### # #
 # #   # #   #     # #   # # # #
 ### ### # ### ##### ### # # # #
     #   # #   #   #     #   # #
###### ##### ### # ######### # #
     #     # #   #           # #
 ### ##### # # # # ### ####### #
 #   #   #   # # # # #       # #
 # ### # ##### # # # ######### #
 #   # #   #   # #   # #G    # #
 ### ##### ### # ##### # ### # #
   #     # #   #       # #   # #
## ##### # # ### ####### ##### #
   #   #   # #   #     #   #   #
 ### # ##### # ### ### ### ### #
 #   #   #   #   # #   # #     #
 # ##### # ### # ### ### #######
   #       #   #               #
################################
