################################
################################
#       #     #       #         
# ##### # ### # ##### # ####### 
#   #   #   # # #   #   #     # 
### ######### # # ####### # ### 
#   #   #     # #   #   # # #   
# ### # # ##### # # # # ### # ##
#   # #   #     # # # #   # #   
### # ####### ### # # ### # ### 
#   #S      # # # # # #       # 
# # ####### # # # # ### ####### 
# #   #   # #     #     #       
##### # ### ### ######### ######
#             # #   #   #   #   
# ########### # # # # # ### ### 
#     #     # # # # # #   #   # 
# ##### ### # # # # # ### # # # 
#   #   #       # # # #  G# # # 
### # ####### ### # # # ##### # 
#   #     #   #   #   #     # # 
# ####### # ### ########### # # 
#   #   # #     #     #   # # # 
# # # ### # ####### ### # # # # 
# # #   # #         #   #   # # 
# # ### # ##### ##### ####### # 
# #     #     # #   # #   #   # 
# ########### ### # ### # ### # 
# #     #   #   # #     #   # # 
# # # ### # ### ########### # # 
#   #     #   #             #   
################################
