################################
################################
#             #     #       #   
# # ##### ##### ### # ##### # # 
# #     # #     #S# # # #   # # 
# ##### ### ##### # # # # ### # 
#     #   #       #   # # #   # 
##### ### ############# # # ### 
# #     #       #         # # # 
# # ####### ##### ######### # # 
# # #     #       #     #   #   
# # # ### ####### ##### # # ####
#   # # #       #   #   # #     
# ### # ####### # # # ### ##### 
# #   #       # # #   #   #   # 
# # ### ####### # ####### # ### 
#   #     #   # # #     # #   # 
# ### ##### # # # ##### # ### # 
#   # #   # #   #       # # #   
### # # # ####### ####### # ####
#     # #       #       #     # 
# ##### ####### ### # ####### # 
# #   # #     #   # #         # 
# # # # # ### ### # ########### 
# # # # # #   # # # #   #   #   
# # # # ### # # # # # # ### # ##
#  G# # #   #   # #   # #   # # 
# ### # # ##### # ##### # ### # 
# # #   # #     #   #   # #   # 
# # ##### ######### # ### # ### 
#         #         #           
################################
