################################
################################
#   #   #   #   #     #     #   
# ### ### # # # # ### # ### # # 
#   #   # # # # #   # #   #   # 
### ### # # ### ##### # ####### 
#     #   #   #   #   # #     # 
##### ####### # ### ##### ### # 
#   #       # #   #     # #   # 
# # # # ### # ### ##### ### ### 
# #   #   # #   # #   # #   #   
# ####### # ### # # # # # ### # 
#     #   #   #     #   #   # # 
####### # ### # ##### ##### # # 
#       # #   # #   # #     # # 
# ### ##### # # # # # # ##### ##
# # # #     #   # # #   #   #   
# # # # ##### # # # ### # # # # 
# #   #   #   #   #   # # #   # 
# ####### ### ####### # # ##### 
#       #   #   #  S  #   # #   
# ### ##### ##### ### ##### # ##
#   #     # #   # #   #   # #   
# # ####### # # # # ### # # ### 
# #   #G    # # # #   # # #     
# ### # ####### # ##### # ######
#   # #       # # #     #       
### ######### # # # ########### 
#   #   #   # # # #       #     
# ### # # # # # # ######### ####
#     #   # #   #               
################################
