################################
#     #   #   #             #   
##### # # ### # ### ### ##### # 
#       #   # # # # #   #     # 
# ##### ### # # # # # ### ##### 
# #   #   #   # #   #   # #   # 
# # # ### ##### ####### ### # # 
#   #   # #   # #     #   # # # 
# ##### ### # # # ### # # # # # 
#   # #   # # # # #   # #   # # 
### # ### # # # # # ######### # 
#   #   # # # # # # #     #   # 
# ### # # # # # # ### ### # ### 
#     # #   #   #   # #   #     
####### ########### # # ########
#     # #       # #   # #       
##### # # ### # # ##### # ##### 
#     #S# #   #       #   # #   
# ### # ### ### ##### ##### # ##
# #   # #   #   #     #   #   # 
# # ### # ##### # ### ### # ### 
# #   # # #     #   #       #   
##### # # # ####### ####### # ##
#G        #   #   #     #       
# ##### ####### ####### # ######
# #     #     # #       #       
# ##### # ### # # ############# 
#   #   # #   #   #             
### # ### # ####### ########### 
# # # #   #   #   # # #   #     
# # # # ####### # # # # ### ### 
#   # #         #   #       #   
