################################
   #   #               #       #
 # # # # ############# # # ### #
 #   # # #       #     # # # # #
 ##### # # ####### ##### # # # #
 #   #   #     #   #     # #   #
 # ########### # ### ##### #####
 # #     #     # #       #     #
 # # # # # ##### # # ### ##### #
 #   # #   #   # # #   #   # # #
 ##### # ### # # # ### ### # # #
  S  # # #   #   # #   #   # # #
#### # # # ######### ### ### # #
  G#   # #         # #   # #   #
 ####### ######### ### ### ### #
       #   #     # #   #       #
###### ### # # # ### ######### #
   #     # # # #     # #       #
## # ##### # # ####### # ##### #
   # # #   # #   #   #   #   # #
 ### # # ### ### # ####### # # #
 #     # #   #   #   #     # # #
 # ##### ##### ##### # ####### #
     #   #     #     # #       #
 ### # ### ##### ##### ##### # #
 #   # #   #     #   #   #   # #
 # # # # ### ##### # ### # ### #
 # # #   # #     # #   #   # # #
 # # ##### ### ### ######### # #
 # #   #     # #   #     # # # #
 # ### # ##### # ### ### # # # #
 #   #               #         #
