################################
################################
   #   #             #   #     #
 # # # # # # ### ### # # # ### #
 #   #   # #   #   #   # # #   #
 ##### ############# ##### # ###
 # #   #     #       #     # # #
 # # ### ### # ### ### ##### # #
 #   #   #   # #   #   #   #G# #
 ##### ##### ### # # ### # # # #
 #     #   #     # #     # #   #
 # ##### # ####### ########### #
 #     # # # #   # #   #     # #
######## # # # # # # # # ### # #
         # #   #   # # #   #   #
 ######### # ##### # # ### #####
         # # #   #   #     #   #
######## # ### # # ########### #
 #     # #  S# # #           # #
 # # # # ### ### # ######### # #
   # #   # #     #         #   #
 ### ##### ####### ####### #####
 #                       # #   #
 # # # # ############# ### # # #
 # # # #       #   #   #   # # #
 # ### ####### # # ##### # # # #
 #   #   #   # # #       # # # #
#### ### # # # # ##### ##### # #
   # # #   # # # #     #     # #
 ### # ##### # # ####### ##### #
     #       # #         #     #
################################
