################################
         #       #         #   #
 ####### ##### ### ####### ### #
 #   #         #   #     #   # #
## # # ######### ### ### ### # #
   #   #       # #   #   # #   #
 ##### # ##### # # ### ### #####
    G# #     #   #   #     #   #
 ### # ##### ##### # ##### # # #
 # # # #   # #   # #   # #   # #
 # # ### # # # # ##### # ##### #
 # #     #   # #     # # #     #
 # ################# # # # #####
 #       #   #  S#   # #   #   #
 # ##### # # # # ### # ### # # #
   #     # # # #   # #   #   # #
 # # ####### ##### # ### ##### #
 # # #       #   # #     #   # #
 ### # ####### # # ######### # #
   #           # # #       # # #
## ##### # ##### # # ##### # # #
 #     # #     #   #     #   # #
 # ### # ##### ##### ### ##### #
 #   # # #   #     # # # #     #
 ##### # # # ### # # # # # #####
     # #   #   # # # # # # #   #
#### # ####### # # # # # # # # #
   # # #   #   # #   # #   # # #
 # # # # ### ### ##### ##### ###
 # # # #     # #   #     # #   #
 # # # ####### # # ##### # ### #
 #     #         #             #
