################################
 #   #       #           #     #
 # ### ##### # ##### ### ### # #
 #     #       #     # #     # #
 ####### # ##### ##### ####### #
         # #     #   #       # #
 ### ##### # ##### # ### ##### #
 # # #   # #   #   #   # #     #
 # # # # # ### # ##### # # #####
 #   # # #   #  G#   # #       #
 ##### # ######### # # ####### #
 #     #           # # #     # #
 # ########### ##### # # ### # #
   #       #   #   # #   #   # #
 ### # ##### ### # # ######### #
 #   # #   # #   #   #   #     #
 # # ### # # # # ##### # # #####
   #   # #   # #     # # # #   #
#### # # # ######### # # # ### #
   # # # # #     #   # # #   # #
 # ### # ### ### ##### ##### # #
 #     #   #   # #   # #   #   #
 ######### ### # # # # # # #####
   #     # #   #   # #  S# #   #
## # ### # # ####### ##### # ###
 #     # # # #     #     # #   #
 ####### # # # ### ### ### ### #
       # #   # #       #   #   #
###### # ##### ##### ### ##### #
     # #     #   #   #   #     #
 ##### ##### ### ##### ####### #
               #               #
