################################
################################
      G#   #       #   # #   # #
 ### # # # # ##### # # # # # # #
   # # # # #     #   # # # # # #
#### # ### ##### ##### # # # # #
     # #   #   #     #   # #   #
 ##### # ### ### ##### ### ### #
 #     #         #   # #   # # #
## ####### ####### # # # ### # #
   #       #   #   # # # #   # #
 ### # ##### # # ### ### # ### #
 # # # #     # #   #     # #   #
 # # # # ##### ### ####### # ###
     # #  S#       # #       # #
 ######### ######### # ####### #
         #   #   #   #   #   # #
 ##### ##### # # # # ### # # # #
     # #     # #   #   # # # # #
 ### # # ##### ### ##### # # # #
   # # # #       # #     # # # #
## # # # # ##### ### ##### # # #
   # # # # #   #   #   #   # # #
 ### # ### ### ### ### ##### # #
   # #     #     #   #   #   # #
## # ####### ####### ### # ### #
   #               #     #   # #
 ############### # ####### # # #
 #     #     #   #         # # #
 ##### # ##### ### ### # ### # #
       #       #   #   #   #   #
################################
