################################
#     #   #           #   # #   
# ### # # # ######### # # # # ##
# # # # #   #         # #   #   
# # # ######### ####### ####### 
#   #     #   #           #   # 
# ####### # # ######### # # # # 
# #     # # #         # #   # # 
### # # # ########### # ####### 
#   # # # #       #             
# ### ### # ##### # ##### ######
#   #    S#     # #     #   #   
# # ### ######### # ### # # ### 
#G#   # #     #   # #   # #   # 
##### # # ### # ### ##### ### # 
#     #     #   # #     #   #   
# ######### ##### # ### # ######
# #     # #     #   #   # #     
# ##### # # # ### ### ### # ### 
#       #   #     #   #     #   
############### ### ######### # 
#       #     #   #     #   # # 
# ##### # ### # ####### ### # # 
#     # # # # #       #   # # # 
# ### # # # # ### ####### # # ##
# #   #   # #   #   #     # #   
# # ####### ### # ### ##### ### 
# #   #     # # # #   #     #   
##### # ### # # # # ### ##### # 
#   # # # #   # # # # #   #   # 
# ### # # ### # ### # ### # ### 
#     #   #         #       #   
