                               #
###### ########### ##### #######
       #     #   # #     #     #
 ####### ##### # ### ##### #####
 # #   #   #   #     #   # #   #
 # # # ### # ######### # # # # #
 #   #   # # #         # #   # #
 ####### # # ########### ##### #
 #    G  #   #         #   # # #
 # ########### ####### ### # # #
   #           #     #     #   #
 ### ##### ##### ### ### ### ###
     #   #         #   #       #
 ### # # ######### ### #########
   # # # #   #   # #   #   #   #
 # # # # # # # # ### ### # # # #
 # # # #   #   #   #   # #   # #
## ### ########### ##### ##### #
   #   # #   #   #         #   #
 ### ### # # # ############# ###
     #     # #   #       #   # #
 ##### ##### ### # # ##### ### #
         #   # # # # #   # #   #
## # ### # ### # ### # # # # ###
   #   # #     #   # # # # # # #
 ### ### # ####### # # # # # # #
 #   #   # #   #   #   # #   # #
 ##### ##### # # ### ######### #
     # #     #  S#     #     # #
 ### ### ######### ### # # ### #
   #                 #   #     #
################################
