################################
################################
#       #         #     #   #   
# ##### # ####### ##### # ### # 
# #     #       # #         #S# 
# # ######### ### # ##### # ### 
# #   #       #   #     # #   # 
##### # ####### ##### # ##### # 
#     # #   #   #   # #     #   
# ##### # # # ### # # ##### # ##
#     # # # #   # # # #   # # # 
##### # # ##### ### # ### # # # 
#   # # #     #     #   #   # # 
# ### # ##### ####### # ##### # 
#     #   #   #     # #     # # 
# ####### # ### ### # ##### # # 
# #     # #     #   #     # #   
# # ##### # ##### ### ##### # ##
# #     # #  G# #     #   # #   
# ### # # ### # ####### # # ### 
#   # #   # # # #   #   # #   # 
### # ##### # # # ### ### ### # 
#   # #     # # #     # #   # # 
# ### # ##### # ####### ### # # 
# #         # #   #         # # 
# # # # ### # # # # ######### ##
#   # #   # #   # #         #   
##### ### # ##### ######### ### 
#   #   # #   #   #   #   #   # 
# # ### # ### # ### ### # ### # 
# #     #   #           #   #   
################################
