################################
################################
#     #     #           # #     
##### # ##### ##### ### # # ### 
#   # # #     #   #   #   #   # 
# # # # # # ### ##### ####### ##
# #   #   #   #     #  G#   #   
# ### ##### # # ### ### # # ### 
#   #       #     #   # # #   # 
### # ### # ##### ### # # ### # 
# # # #   # #   #   # # # # #   
# # # # ##### # ##### # # # ####
#   # #     # #  S#   #   #     
##### ##### # ### # ########### 
#     #   # #   # #   #       # 
# ### ### # ### # ### # ##### # 
# #   #   # # # #     #     # # 
# # ### ### # # ######### ### # 
# # #   #   # #           #   # 
# ### ### # # ########### # ### 
# #   # # # #   #       # #   # 
# # ### # ### ### ##### ##### # 
#   #   #     #   # #   #   # # 
# ### ######### ### # ### # # # 
#   #     #   #   #     # #   # 
# ####### # ##### ##### # # ### 
# #       # #   #   # #   # #   
# # ####### # # ### # ### ### ##
#   #     #   # # # #     #   # 
# ### ### # ### # # ####### ### 
#       #     #   #             
################################
