################################
################################
#   #           #             # 
# # # ######### # ########### # 
# #   #   # #   #     #     #   
####### # # # ####### # ### ####
#       # # #   #     #   # #   
# ####### # ### # ####### # # # 
# #   #   #   # # #       #   # 
# # # # ##### # # ############# 
#   # # #   #   #     #   #     
####### # # # ####### # ### ####
#   #   # # # #       #   #   # 
# ### ##### # # ######### ### # 
#     #   #   #G#   #       #   
# ##### # ### # # # # # # # ### 
#   # # #   #     # # # # # #   
### # # ### ####### # # ### # ##
# # # #   #     #   # #   # # # 
# # # ### ##### # ### ### # # # 
# # #   # # #   # #     # # #   
# # # # # # # ### # ### # ##### 
# # # # #   #     # #   #  S  # 
# # ### ##### # ### # # ##### # 
#   #         #     # # #   #   
# ### ######### # ### ### # ####
# #     # #     #   #     #     
# ##### # # ####### ########### 
# #   # # # #       #     #     
# # # # # # # ####### ### # ####
#   #   #   #         #   #     
################################
