################################
################################
#             #   #   #         
# ##### ##### # # # # ### ### # 
# # #   #   #   #   #     #   # 
# # # ### # ############# # ### 
#   #   # #         #   # #   # 
# ##### # ######### # # ##### # 
# #   # # #   #   #   #     # # 
# # # # # ### # # ######### # # 
# # # # #   # # #         #   # 
### # ##### # # ##### ### ##### 
#   # #   # #   #   #   #     # 
# ### # # # # ### ##### ##### # 
#   # # #   #   #    S# #G  # # 
### ### ####### ### ### ### # # 
# #     #           #   #   # # 
# ####### ########### ### ### # 
#           #       #   #     # 
# ########### ##### ### ####### 
#       #       #   #   #     # 
# ##### # ####### ####### ### # 
#   #   # #       #       # # # 
### # ### # ##### # ####### # # 
#   # #   #   #   # #       # # 
# # ### ##### # ### ### ##### # 
# #     #   # #   #     #   # # 
# ####### # # ##### ##### # # # 
#         # #     # #     #   # 
### # ##### ##### # # ######### 
#   #     #     #   #           
################################
