################################
################################
#   #     #         #     #     
# ### ### ##### # # # ### # ### 
#     # #     # # #   #   # #   
####### ##### ### ##### ### ####
#       #   #     # #   #       
# ####### ######### # ### ##### 
#   #             #   #   #     
### ############# # ### ########
# #       #   #   #   # #       
# ####### # # # ##### # # ##### 
#   #   #   # #     # # #   # # 
# # # # ##### ### ### # ### # # 
# #   # #           # #     # # 
# ####### # ##### # # ### ### # 
#   #     # #   # # #   #   #   
### # ##### # # # # ### ### ####
# # # #     # # # # #   #       
# # # ### ### # # # # ######### 
# #G# #   #   #   # #     # #   
# # # # ### ##### ####### # # ##
#     #   # # #   #     # # #   
########### # # ### # ### # ### 
#     #   # #     # #     # #   
# ### # # ### ##### ####### # ##
# #   # #   #    S  #         # 
# # ####### # ##### # ######### 
# # #     # #     # # #         
# # ### # # # ### # # # ### # ##
# #     #     #   #     #   #   
################################
