################################
# #     #           #           
# # ##### ##### # ### ######### 
# # #   # #   # #   # #       # 
# # # # # # # # ### # # ####### 
#     # # # # #   # # #   #     
##### # # # ##### # # ### # ####
#   # #   #      G# #     #     
# # # ############# ### ####### 
# # # #     #     #     #       
# # # # ### # ### ####### ##### 
# # # # # # #   # #     #   # # 
# # # # # # ### # # ### ### # # 
# # # # # # #   # # # # #   #   
# # # # # # ##### # # # # ######
# #   #   #       # #   #   #   
##### ### ########### ### # # # 
#   #           #     #   # # # 
# # ##### ##### # ##### ### # ##
# #   #   #   #   #     #   #   
# ### # # # # ##### ##### ##### 
#   # # # # #     #     #       
### # # # # ##### ##### ########
#   # # #   #   # #   #         
# ### # ### # # # # ######### # 
# #   # #   # # # # #       # # 
# # ### # # ### # # # ##### ### 
# #   # # #     # #   #   #   # 
# ### ### # ##### ##### # ### # 
# # # #  S#   # # #   # # #   # 
# # # # ### # # # # # ### # ### 
#   #   #   #   #   #     #     
