################################
################################
#         #                     
# ####### # ##### # ##### ######
#   #   # #   #   #   # #   #   
# # # # # ### # ##### # ### # # 
# # # # # #   #     #     # # # 
# ### # ### ####### ##### # # # 
#   # #     #     #   #   # # # 
# # # ######### ##### ##### ### 
# # # #         #     #   # #   
# ### ### ##### # ##### # # # ##
#   #     # #   #       # # #   
# # ####### # ########### # ### 
# #         # #   #   #   #     
# ####### ### # # # ### # ######
#       #   # # # #     # #     
# ##### ### # # ########### ### 
#   #   #   # #         #   #   
### # ### ### ### ####### ### ##
# # #   #   #   # #       # #   
# # ### ####### # # ####### ####
# # # #       # # #     # #     
# # # ######### # ##### # # ### 
#       #      S# #     #   #   
# ####### ####### # ######### # 
#         #       #  G    #   # 
# ########### ### ####### # ### 
# #           # # #   # #   #   
# ### ######### # # # # ####### 
#     #             #           
################################
