################################
################################
#   #     #   #   #       #     
# # # ### ### ### ####### # ### 
# # # #   #     # #           # 
# # # # ### ### # # ##### ### # 
# # # #       #     #   #   #G# 
# # # ### ### ####### # ##### # 
# # #   #   #       # #   #   # 
# ##### # ######### # ### # ####
# #     #         # # #   # #   
# # ######### ##### # # ### # # 
#   #       # #   #   #   #   # 
##### ##### ### # ####### # ### 
#   # #   #     #     #   # #   
# # # ### ########### # ### # ##
# #   #             #   #   # # 
# ##### ##### ### ####### # # # 
# #   #     # # #       # # # # 
# ### # ### # # ######### # # # 
#   # # # # #   #     #   # # # 
# # # # # # ##### ### # ### # # 
# # # #   #     #   #   #   # # 
# # # ### ##### ### ##### ### # 
# # #     #   #   #     #   #   
### # ##### ########### # # ####
#   #   #S# #   #   #   # # #   
# ##### # # # # # ### ### # ### 
#     # #   # # #     # # # #   
##### # ### # ######### # # # ##
#     #                   #     
################################
