################################
#     #       #   #     #       
# ### # ####### # ### # # ##### 
#   # #       # #     #       # 
##### ####### # ##### ######### 
#       #     #   # # #       # 
# ####### ####### # # # ##### # 
# #     #   #     # # # #   #   
# # ### # ### ##### # # # # ####
#     #   #   #       #   # #   
# ######### ### # ######### # # 
# # #       #   #   #       # # 
# # # ####### # ### # ####### # 
# # # #     # #   # #       # # 
# # # # ### # ### # ####### # # 
# # #   # # # #G  #     # # # # 
# # ##### # ### # ##### # # ### 
# #   # #   #   #   #   # # #   
# # # # ##### ##### # ### # # ##
#   #     #   #     #     # #   
##### # # # ##### ######### ### 
#     # #   #   #         #     
# # ### ##### # # # ##### ######
# #   # #     # # #   #   #     
####### # ##### # ### # # # ### 
#       #   #   #   # # # #   # 
# ########### ##### # # # ### # 
#     #     #     # # # #   # # 
# ### # ### ##### ### # # # # ##
# #   # #   #   # #   #S# # #   
# # ##### ### ### # ### # ##### 
# #       #         #   #       
