################################
#                             # 
# ########################### # 
#   #   #   #             #   # 
### # # # # # ######### # # ### 
# #   #   # # #   #   # # #     
# ######### # # # # # ### ##### 
#       #   # # # # # #     # # 
####### # ##### ### # # ### # # 
# #     #       #   #     #   # 
# # ############# ### # # ##### 
# #               # #G# # #     
# ##### ##### ### # # # ### ####
#       #     #   #   #   #     
# ##### # ### # ######### ##### 
#   #   #S#   #   #     # #   # 
### # ### ### ### # ### ### # # 
#   #   #   #   # #   #     #   
# ##### ### # # # ### ##########
# #     #   # # #   # #   #     
### # ### ### ### ### ### # ### 
#   # #   #     #     #   # #   
# ##### ##### # ####### ##### # 
# #     #     #       #     # # 
# # ########### ##### ##### # # 
# # #         #     #       # # 
# # ######### ### # ########### 
# # #     #   #   #   #     #   
### # ### # ### ##### # # ### ##
#   # # # # #   #   # # #     # 
# ### # # # # ### # ### ####### 
#       #   #     #             
