################################
       # #           #   #     #
 ##### # # # ##### # # ### # ###
 #   # #   # #     # #   # #   #
 # # # ##### # ##### ### # ### #
 # #     # # #   #   #   #   # #
 ####### # # ### # ### ### ### #
 #   # # #    S# #     #   #   #
 # # # # ####### ##### # ### ###
   #   # #     # #   # # # #   #
######## # ### ### # # # # ### #
         #   #     # # #     # #
 ################### # ##### # #
 #         #     #         # # #
 ######### # ### ######### # # #
       # #   # #       # # # # #
###### # ##### ####### # # # ###
 #    G#   #     #   # #   #   #
 # ##### # # ##### # # # ##### #
 # #     # #   #   # # # #     #
 # # ######### # ### # # # #####
   #           # #   # #       #
 ##### ######### # ### ####### #
 #   #       #   #   #   #   # #
 # # ### ##### ##### ### # # # #
 # #   #     #     # #   # #   #
 ##### # ### ##### # # ##### ###
     # #   #   #   # # #   #   #
 ### # ### ### # ### # # # # ###
   #   # # # # #   # #   # #   #
 # ##### # # # ### # ##### # # #
 #           #     #         # #
