################################
################################
   #               #           #
 # # # # ##### # ### ##### #####
 #   #S# #   # # #   #   #     #
 ##### # # # # ### ### # ##### #
     # # # # #   #   # #       #
#### # ### # ### ### # #########
   # # #   #   #   # # #   #   #
 ### ### ##### ##### # # # # # #
     #   #   #     # #   # # # #
 ##### ### # ##### # ####### ###
 #     #   #       #       #   #
 # ####################### ### #
 #           #           #     #
 ########### ### # ########### #
               # #   #     #   #
## ########### # ### # ### # ###
   #     #   #   #   #   # #   #
#### ### # # ### ####### ##### #
   #   # # #   # #     # #     #
 # ##### ##### # # # ### # ### #
 # #   #         # #     # #   #
 # # # ##### ##### ####### # ###
 # # #     #   #   #       # # #
 ### ##### # # # ##### # ### # #
 #   #   #   # #     # # # #   #
 # ### ### ######### ### # # ###
 # #   #G  #       #     #     #
 # # # # ### ############### # #
   # #                       # #
################################
