################################
################################
   #           # #       #     #
 # ### ####### # # ### # # ### #
 #S  # #   #     #   # #   # # #
 ### ### # # # ##### # ### # # #
 #       # # #       #   # #   #
 ######### # ########### # #####
   #     # #       # #   # #   #
## ##### # ####### # # ##### # #
 #   #   #       # # #     # # #
 ### # ######### # # ##### # # #
 #   #     # #   #     # #   # #
 # ####### # # ####### # ##### #
G  #       # # #     #       # #
#### # # ### # # ### ####### # #
   # # #     #   # #   #     # #
 # # # ##### ##### ### ##### # #
 # # #     # # #     #     # # #
 # # ##### # # # ######### ### #
 # # #     #   # # #     #   # #
 # # ########### # # ####### # #
 # #       #     # #       #   #
## ### ### # ##### ### ### ### #
   #   #               #       #
 ####### ########### # # # #####
         #       #   # # #     #
###### ### ##### ### # # ##### #
     # #   #   #   # # # # #   #
 ### # # ### # ### ### # # # ###
   #   #     #   #     #   #   #
################################
