################################
################################
 #   #       #           #     #
 # # # ##### # ### ##### # # ###
   #       #   #   #     # #   #
 ##### ############# # ### ### #
 #     #    G  #   # # #   # # #
 # ### # ##### # # # ### ### # #
 # #   # #   #   # # #   # # # #
 # # ### ### ##### # # ### # # #
 # #   # #     #   # #     #   #
 # ### # # ##### ######### #####
 #   #     #   # #     # # #   #
 ######### # # # # # # # # # # #
 #   #   #   # #   # #   # # # #
## # # # # ### # ### ##### # # #
   #   # #   # #   #   #   # # #
 ####### ### # ####### # ##### #
 #     #   # # #     # # #     #
## ### ### # # # ### ### ##### #
   #   #     #     #S  #     # #
 ######### ########### ##### # #
     #   # #       #   #   # # #
#### # # # # ##### # ### # # # #
   #   # # # # #   #   # # # # #
 # ##### # # # # ### # # # # # #
 #             # #   #   # # # #
 ############# # ##### ##### # #
   # #       # #     # #   # # #
 # # # ##### # ##### ### # # # #
 #   #     #       #     #     #
################################
