################################
################################
           #               #   #
 ##### ##### ######### ### # # #
 #   #     #   #     #   #   # #
 # # # ### ### # ### ### #######
 # # #   #     #   # # #      S#
 # # # # ####### ### # ##### # #
 # # # # #       #   # #   # # #
 # # # # # # ##### ### # # ### #
   # # #   #     #     # #     #
 ### ########### ##### # #######
 # #         # #     # #       #
 # ######### # ##### # ####### #
 #     #   # #       # #   #   #
 ##### ### # ######### # ### # #
   # #     #G    #   # # #   # #
## # ### ####### ### # # # ### #
 # #     #     #   # # # # # # #
 # ### ### ### ### # # # # # # #
         # #   #   #   #   #   #
 ##### # # # ### ############# #
 #     #   # #     #     #   # #
 # ####### # ##### # ### # # ###
 #   #   # #     # # # # # #   #
#### # # ####### # # # # ##### #
   #   #   # #   # #   #     # #
 # # ##### # # ### ### ### ### #
 # # #   # # # #   #   # #   # #
 # ### # # # # # ### ### ### # #
 #     #   #   #           #   #
################################
