################################
################################
# #       #             #       
# # ##### # ### ######### ### ##
#   #G  #   #   #     #     #   
# ##### ##### ### ### # ####### 
#       #   #   # # #   #   #   
####### # # ### # # ##### # # # 
#     # # #   # #       # #   # 
# ##### # ### # ####### # # ####
#       #   #         # # # #   
####### ### ### ##### # # ### # 
# #     #   #   #   # # #     # 
# # ### # ####### # # # ####### 
#   #   #         # # # #     # 
##### # ########### # # # # ### 
#     #         #   # # # # #   
# ##### ### # ### ##### # ### ##
# #   # #   # #   #     #   # # 
### # # # ### # ### ####### # # 
#S  # # #   # #     #       #   
# ##### # # ######### # ########
#     # # #         # #         
##### # ### ####### # ##### ### 
#   # #   #   #   # # #     #   
### # ### # # # # # # # ##### ##
#   #     # #   # #   # # #     
# # ####### ##### ##### # # ####
# # #   #   #   # #   # #   #   
# # # # # # # # # # # # ##### # 
# #   #   #   # #   # #       # 
################################
