################################
################################
#     #   #     #               
# ### # ### ### ##### ######### 
# #   #     # # #   #   #     # 
# # ######### # # # # ### ### # 
# # #     #   # # # # #     # # 
# # # # # # # # # # # # ##### # 
# #   # #   #     #   # #     # 
# ##### ############# # ####### 
# #   # # #     #   # #       # 
# ### # # # ### # # # ####### # 
#     #   #   # # #         # # 
# ############# ####### ### # ##
#     #     #   #   #   #   #   
# ### # ### # ### # # ### # ### 
#   # #   # # #   # #   # #   # 
### ##### ### # ### ### # ### # 
#   #   # #   # # #   # #S# # #G
# ### # # # ### # ### ### # # # 
# #   #   #   # #   #     #   # 
# # ######### # # # ######### # 
# # #   #   #   # #       #   # 
# # # # # # ##### ##### # # ### 
# #   #   # # #       # # # #   
# ######### # # ##### # ### # ##
#     #     #   #   # #   # #   
### # # ##### ### ### ### # ### 
#   # # #     # # #   #   #   # 
# ##### # ##### # # ### # ### # 
#               #   #   #   #   
################################
