################################
################################
               #       #       #
 ##### # ##### # ##### # ##### #
 #   # # # #   #   # # #   #   #
 # # ### # # ##### # # ##### ###
   # #   #         #   #   #   #
#### # ####### ######### # ### #
     #       #           #     #
 ########### ######### ####### #
     #   #   #     # #       # #
#### # ### ### ### # # ##### ###
     # #   #   # # # # #   #   #
 ##### # # # ### # # # # # ### #
 #   # # # # #   # # # # #   # #
 # # # # # # ### # # ### ### # #
 # #S  # # #   # #   #   # #   #
 # ##### # ### # ##### ### ### #
   #   # #   # # #     # #     #
 ### ### ##### # ### # # ##### #
       #     # #   # # #       #
#### # ##### # ### # # ### ### #
   # #     # #   #   #   #   # #
 # ##### # # ### ##### # ##### #
 # #     # #G  #     # # #     #
 ### ##### ### ##### # # # #####
   #   #   # # # #   # # # #   #
## # # ### # # # # ##### # # # #
   # # #   # # # # #     #   # #
 ##### # ### # # # ### ####### #
       #     #   #     #       #
################################
