################################
#       #           #           
# ####### ### ##### # ######### 
#           # #     #     #     
########### # ########### # ####
#   #   #   #         #   # #   
# # # # # ######### # ##### # # 
# #   # #     #   # # #     # # 
# ##### ##### # # ### # ##### # 
# #   # # #   # #  G  #     # #S
# # # # # # ### # ######### # ##
# # #   #   #   # #   #   # #   
# ####### ### ##### # # # # ### 
#           #   #   #   # # # # 
##### ##### # # # ####### # # # 
#   # #   # # #   #     # # # # 
# # # # # # # ##### ##### # # # 
# # # # # # #       #   #   #   
### # # ### # ####### # ##### ##
#   # #   # #       # #   #     
# ### ### # ####### # ### # # # 
#   #     #       # #   #   # # 
### ### ######### # ### ##### ##
# #   #         # #   #   # #   
# ### ########### # # ### # ### 
#   #     #       # # # # # #   
### ##### # ####### # # # # # ##
#   #   # # #       # # #   #   
# ### ### # # ##### # # ### ### 
#   #   # # # # #   #   #   # # 
### ### # # # # # ####### ### # 
#           #   #           #   
