################################
               #   #     #   # #
 # ########### ### # ### ### # #
 #           #     #   #       #
 ########### ### ### ###########
 #     #   #   #   #           #
 ### # # # ### ### # ######### #
     #   #   #   #           # #
########## # ### ############# #
           # #   #         #   #
 ############# ### ####### # # #
 #             # #       #   # #
 # ############# # ##### ##### #
 # #   #       # #   #   #   # #
## # ### ####### ### # ### # # #
   #           #  S  # #   #   #
 ############# ##### # #########
   #   #             #         #
 # # # # ######### # ######### #
 # # # # #G  #     #       #   #
 # # # ### # # ##### ##### # # #
 # # # #   # #   #   #     # # #
## # # # ### ### # ######### ###
   # #   # #   # #     #   #   #
 ### ##### ### ####### # # ### #
 #     #     # #       # # #   #
 ### # ##### # # # ##### ### ###
   # # #     # # # #   # #   # #
## ### # ##### # ### # # # ### #
 # #   #         #   # #   # # #
 # # ############# ### ##### # #
   #                 #         #
