################################
 #     #   #   #   #     #   # #
 # ### # ### # # # # ##### # # #
     # #   # #   #   #     #   #
#### ##### # ####### # #########
  G  #   #   #     #S# #   #   #
 ### # ######### ### # # # # # #
   #         #   #   #   #   # #
 ##### ##### # ### ########### #
 #   # #   #     #           # #
 # # ### # ##### ######### # # #
 # #     #       # #     # # # #
## ############# # # ##### # # #
   #       #   #   #       #   #
 # # ##### # ##### ####### #####
 # # #   # # #   # #           #
 ### ### # # # # # # ##### # # #
   #   # # #   #   #   #   # # #
 # ### # # # ######### # ### # #
 #     # # #           # #   # #
 ####### # ######### ### # #####
     #   #     # #   #   #     #
 # ### # ##### # # ### ####### #
 # #   # #     #   #   #       #
 ### ### # ######### ### # ### #
 #   #   #   #   #   #   # #   #
 # ######### # # # ####### ### #
     #     # # # # #     # #   #
###### ### # # # # # ### # # ###
       # # #   # # # #   # #   #
 ####### # ##### # ### ### ### #
         #       #     #   #   #
