################################
#              G# #         #   
# ##### ####### # # ####### ### 
# #   #       #   #   #   #   # 
# ### ####### ### ##### # ### # 
#   #       # #   # #   #   # # 
# # ##### ### # ### # ##### # # 
# #     # #   # #   #   # #   # 
# ##### # # ### ### ### # ##### 
#     # # #   #         #   #   
##### # # ############# # # # ##
# #   # #   #     #   # # # #   
# # ### # ### ### # # # ### ### 
#   #   # #   # #   # #   # # # 
### # ### # ### ##### ### # # # 
# # #   # # #       # #   #     
# # ### # # ### # # # # ### ####
#   #   # #   # # # # #         
### # # # ### # # ### # ##### # 
# # # # # # # # #           # # 
# # # ### # # # ########### ### 
#   #       # #   #       #   # 
### ######### ### # ##### # # # 
#     #   #   #   # # #   # # # 
# # ### # # ####### # # ### # # 
# #     # #      S  #   #   # # 
# ####### ################### # 
# #     # #   #       #       # 
# # # # # # ### ##### # ####### 
#   # # #   #   #   # # #       
##### # ##### ### # # # # ### ##
#     #     #     # #   #   #   
