################################
#   # #       #   #     #       
# # # # ##### # # # # ### ##### 
# #   #   #   # # # #     #     
##### ### ##### # # ####### ####
#   #         # # # # #   # #   
# # ### ##### # ### # # ### # ##
# # #   #   #     # # #   # #   
# # # ### # ##### # # ### # ### 
# # #   # #     #   #   #   #   
# # ### # ##### # ### # ##### ##
# # #   #   # # #   # #     #  S
### ##### # # # ### ####### # # 
#   #   # #   # # #       # # # 
# ### # ####### # ####### # # # 
# #   #   #   #G# #           # 
# ### ### # # # # # ######### # 
# #   #   # #       #   #   # # 
# # ### ####### ##### # # # ### 
# # # #   #   # #     # # # #   
# # # ### # # # # ##### ### # ##
#   #   #   # # #     #     #   
##### ####### # # ##### ####### 
#   #     #   #   #   #   #   # 
# ### ### # ##### # # # ### # ##
#   #   #   #   # # # # #   #   
# # ### ####### # # # ### ##### 
# #   #       # #   #     #     
# ####### ### # # ######### ####
#       #   #   # #     #   #   
# ######### ##### # ### # ### # 
#                   #   #     # 
