################################
################################
   #     #     #   #   #   #   #
## # # # # ### # # # # # # ### #
   # # # # #   # # # #   # #   #
 ### # ### # ### ### ##### # ###
     #     # #     #   #   #   #
 ########### # ### ### # ##### #
   #     #   #   #G#   #   #   #
## # ### # ### ### # ##### # # #
   # # #   #   #   # #   # # # #
 # # # ##### ### ### # ### ### #
 # # #  S#   # # #   #   #   # #
 # # ### # ### # ####### ### # #
 # #     # #   #         #   # #
 ######### # ######### ### ### #
                     #     # # #
## # ######### # # ######### # #
 # # #     #   # #           # #
 # # # ### ##### ### # ##### # #
 # #     #   #     # #     # # #
 # # ####### ##### # # ### ### #
 # #   #   #   # # # #   # #   #
 # ### # # ### # # # ### # # ###
 #   # # # #   # # # #   #   # #
 ### ### ### ### # # ### ##### #
 #   #   #   #     #   #       #
 # ### ### ### ####### ####### #
 #   #   # # #   #     #     # #
 ### ### # # ### # ##### ### # #
     #     #     #       #   # #
################################
