################################
################################
#   #       # #       #         
### # ##### # # ##### # ### ####
#   #   # #   #   #   # #   #   
# ##### # # ##### ####### # # # 
#     #   # #     #     # #   #G
##### ##### # ##### ### ##### ##
#   # #     # #     # #     #   
# # # # ### # # ##### ##### ### 
# # #   #   #   #   #   #   #   
# # ##### # ##### # # ### ##### 
# #     # #   #   # #   # #     
# ##### # ### ### # ### # ### # 
#     # # # # #   #     # #   # 
##### # # # # # ####### # # ### 
#   # #   # #   #     # #   #   
# ### ##### ######### # ##### ##
# #   #   #     #   #       # # 
# # ##### # ##### # # # ### # # 
# # #   # #   #   # # # #   #   
# # ### # ### # ##### # # ##### 
# # #   #     #       # #     # 
# # # ### ### ####### # ####### 
# # #   # #           # #       
# # ### ### ##### # # # # ######
# #   #     #     # # #   # #   
# ### ### ####### # ####### # # 
#   # # # #    S# #         # # 
### # # # # ### ##### # ##### # 
#     #   #   #       #       # 
################################
