################################
################################
#       #     #       #     #   
####### # ##### ####### # ### # 
#     # #   #     #     #     # 
# ### # # ### ##### ########### 
#   # #   #   # #   #     #   # 
### # ### # ### # ### # ### ### 
#   #   # #     # #   #     #   
# ##### # ### ### # ######### ##
#   #   #     #   #         #   
##### ### ##### ### ############
# #   #   #   # # # #           
# # ##### # # # # # # ######### 
# #G#       # # #   # #         
# # ####### ### # ### ##########
# #     #   #       #     # #   
# ##### # # # ########### # # # 
#     #   # # #         #   # # 
##### ##### # # ####### ### # ##
#   #       # #   #   #   # #   
# # ### ### # ### # # # # # ### 
# #     #         # # # #     # 
# ####### ####### # # ######### 
# #     #   #     # # #S    #   
# # ####### # ### # # # ### # ##
#   #       #   # # #   # # #   
# ### ######### # # ##### # ### 
# # #     #   # # # #   # #     
# # ##### # # # ### # # # ######
#       #   # #       #         
################################
