################################
################################
# #     #           #     #     
# # ##### ####### # # ### # ### 
# #     #   #     # # #   # #   
# ##### # ### ##### ### ### ####
#           #     #   #   #   # 
######### # ##### ### # ##### # 
#       # #     #   #   #       
# ##### # ##### ### ##### ### ##
# #       #   #   # #     # #   
### ####### # ### ### ##### ### 
#   #   #   #   #   # #   # #   
# ### # # ##### # # # # ### # # 
#     #     #  G# # # #       # 
# ########### ##### # # ####### 
# #       #   #     # # #  S#   
# ####### # ##### # # ### # # # 
# #   #     # #   # #   # # # # 
# # # ####### # ####### ### # # 
# # #       #   #       #   # # 
# # ####### ##### ####### ### # 
# #   #   #     #         #   # 
# ### # # ##### ########### ### 
# #   # #     # #       #   # # 
# # ### ##### # ### ### # ### # 
# # #   #   # # #   # #   # #   
# # # ##### # ### ### ##### ### 
# # # #     #   #   # #       # 
# # # # ### ### ### # # # ### # 
#     #   #         #   #   #   
################################
