################################
################################
     #       #   #   # #       #
 ### # # ##### # # # # # ##### #
 # #   #       # # #   #     # #
 # ############# # ######### # #
   #   #   #   # #   # #   # # #
## # # # # # # # ### # # ### ###
   # #   #   # # #             #
 ##### ######### ##### ####### #
 #   # #     #   #   # #   #   #
 # # # # ### # # # # ### # # # #
   #     #   # # # #     # # # #
###### ##### # ### ####### ### #
     #     # #     #   #   #   #
 ### # ### # ####### ### ### ###
   #   #   #     # #     #   # #
## ##### ### # # # ####### ### #
   #     #   # #   # #     # # #
 ### ##### ### ##### # ##### # #
   #   #   #                   #
 # ### ####### #################
 #   #   #     #S      #       #
 ### ### ####### ##### # ##### #
 #   #   #     #     #     # # #
 # ####### ### ##### ##### # # #
 #       #   #G#     #   #   # #
 ####### # ### # ##### # ##### #
       #   #   # #   # # #   # #
 ##### ##### ### # # # # # # # #
     #     #     # #   #   #   #
################################
