################################
#   # #   #S  #             #   
# # # # # ### # # ####### # # # 
# # #   #       #       # #   # 
# # ##### ########### # # ##### 
# #   #   #     #   # # #     # 
# ### # # # ### # # ### ##### # 
#   #   # # # #   # #   #   # # 
### ##### # # ##### # ### # ### 
#   #   # # #     # #   #G#   # 
# ### ### # ##### # # # ##### # 
# #     # #   #   # # #   #   # 
# # ### # ### ### # ##### # ### 
# #   #   # #     #     # # #   
# ### ##### ##### ##### # # # ##
# #   #         # #   # # # # # 
# # ########### # # # # # # # # 
# #     #       # # #   #   # # 
# ##### # ### ### # ######### # 
# #   # #   # #   # # #   #     
# ### # ##### # ### # # # # # ##
#     #     # # #   #   #   #   
########### # # # ######### ### 
#         # # # #   #   #     # 
# ### ### # # # ### # # # ##### 
#   #   # # # # #   # #   #     
### # # # # # # # ####### # ####
#   # # # #   # # # #   # # #   
# ### # ### ### # # # # # # # # 
# #   #     #   # #   # # # # # 
# ########### ### ##### # # ### 
#               #       # #     
