################################
     # #         #     #       #
 ### # # ##### ### ### # ### # #
 #       #   # #   # # #   # # #
## ####### # ### ### # ##### # #
   #   #   #     #     #     # #
 ### # # ######### ##### ##### #
     # # #     # # #     #   # #
 ##### # # ### # # # ##### # # #
     # # # # # # # #     # # # #
#### ### # # # # # ##### # # # #
     #   #   # # #       # # # #
#### # ##### # # ### ##### # # #
   # #       # #     #S    #   #
 # # ######### ##### # #########
 #     #   #   #     # #       #
###### # ### ### ### # # ##### #
     # #     #   #   #   # #   #
 ### # ####### # # ####### # ###
   #           # # #       # # #
 # ##### # ##### # # ### # # # #
 # #     #     # #   # # # #   #
 # ########### # ##### # #######
 #           # # #     #     # #
 ############# # # ######### # #
       #   #   #   #       #   #
 ####### ### ### ### ### # #####
   #   #   #   # #   #   #     #
## # # ### ### # # ### ##### # #
   # #   #   # # # # # # #   # #
 ### # ##### # ### # # # # ### #
     #       #     #   #   #G  #
