################################
 #     #   #           # #   # #
 # ### # # # # ### ### # # # # #
 #   # # # # # #   # # # # #   #
 ### # ### # # # ### # # # #####
   # #   #   # # #     # #     #
## # ### ####### # ##### # #####
   #   #       # #         #   #
 ##### ####### ######### ### # #
 #    G#   # #   #       #   # #
 # ##### # # ### ####### # ### #
 #   # # # # #   #     # # # # #
 ### # # # # # ### ### # # # # #
 #   # # #   #     # #   #   # #
 # ### # ### ####### ### ### # #
 # #     #     #     #   # # # #
 # # ##### ### # ##### ### # # #
   #   #   # # #     #   # # # #
######## ### # ##### ### # # # #
         #         #         # #
 # # ############# # ####### ###
 # #   #     #       #     #   #
## ### # ### # ####### ### ### #
   #   # # # # #       #   #   #
 ### ### # # ### ####### ### ###
   #   # # #     #   #S#   #   #
###### # # ####### # # ### ### #
       # # #   #   # #   #   # #
 ####### # ### ##### ### ### # #
 #   # # # #   #   #     #   # #
 # # # # # # ### # ##### # ### #
   #   #   #     #             #
