################################
################################
   #   #   #   #           #   #
 # # # ### # # # ### # ### # ###
 #   #     # #   # # # #       #
 ########### ##### # # ####### #
   #   #S  # #       # #   #   #
## # # # ### ####### # # # # # #
 # # # #     #     # # # #   # #
 # # ##### ### ### ### # ##### #
 # #       #   # #   # #   #   #
 # ### ##### ### ### ##### # # #
 #   # #   # #   # #   #   # # #
 ### ### # # # ### ### # ### # #
   #     #   #       #   #   # #
 # ################# ####### # #
 #                           # #
 ### ##### ##### # ####### # # #
 #   #   # #     # #       # # #
 # ### # # # ####### ####### # #
 # #   #   #       #     #   # #
 # # ##### ####### ##### ##### #
 # # #   #     #   #   # #     #
 # # ### ##### # ### # # # ### #
 # #   #       # # # #   #   # #
## ### ######### # # ### ### # #
   #   #       #   #   # #   # #
 ####### ##### ####### ### ### #
 #     #G  #   #   #   #   # # #
 ##### ### ##### # ##### ### # #
         #       #       #     #
################################
