################################
#             #       #   #     
# ########### # # ##### # # ####
# #   #   #   # #       # # #   
# # # ### # ### ######### # # # 
#   #     # #   #         #   # 
########### # ############# ### 
#   #   # # #       #   #   #   
# ### # # # ####### ### # ### ##
#     #           #   #   #   # 
########### ######### # ####### 
#           #   #     #       # 
# # ####### # # # ##### ##### # 
# # #   #   # # # #     #   # # 
# ### # # # # ### # ##### # # # 
# #   #   # #   # # #     # # # 
# # ####### ### # # # ##### # # 
# #   # #   # # # # # #   # #   
# ### # # ### # # ### ### # # ##
#   # #   #   # #   # #   # #   
##### ### # # # ### # # ### # # 
#  S#   #   #         #     # # 
# # ### ############### ##### ##
# #   #   #     #     # #       
# ### ### # ### # ### # ####### 
#   #     # # #G  #   # #       
### ##### # # ##### ### # ##### 
#   #     # #         #   #     
# ######### # ####### ##### ####
# #   #     #   #   #     #     
# ### # ######### # ##### ##### 
#     #           #     #       
