################################
################################
   #     #       #             #
 # # ### # ### # # ##### #######
 # #   # # #   # # #     #     #
 ##### ### ####### # ##### ### #
 #   # #   #     # #   #     # #
 # ### # ### ### # ##### ##### #
   #       #   # # #G#   # #   #
 ### ##### ##### # # # ### # ###
 #   #   #   #   #       # #   #
 # # # # ### # ##### ### # # # #
   # # #   # #   #   #   # # # #
#### # ### # ### # ### # # # # #
     #   # #       #   # # # # #
 # ##### # # ####### ### # ### #
 # #     #   #   #   #   # #   #
 # # ##### ### # # ### # # # ###
 # # #   # #   # #   # # # # # #
 # # # # ### ### ### # ### # # #
 # #   # #   # # #   #   # # # #
 # ##### # ### # # ##### # # # #
 #     #       # #   #   #   # #
 ### # ######### ### ######### #
 #   #   #         # #       # #
## ####### ##### ### # ### # # #
   # #     #   # #   # # # # # #
 ### # # ### # ### ### # # ### #
   # # # #   # #   #   # #     #
 # # # ### ### # ### ### #######
 #S  #     #   #               #
################################
