################################
################################
     #           #         #   #
 ### # ### # # ### ##### # ### #
   # #   # # #   # #   # #     #
## # # # # # ### # ### # ### ###
   #   # # # #   #     #   #   #
 ####### # # ####### ##### # ###
 #   #   # #   #     #     #   #
 ### # ### ### # ##### ####### #
   #   #     #   #   # #     # #
## ##### ### ####### # # ### ###
 # #   # # #   #   # #   # #   #
 # # ### # # ### # # # ### ### #
 # #     # #   # #   #       #S#
 # ####### ### # ##### ####### #
 # #   #   #   # #     #       #
 # # # # ### # # ####### #######
   # # # #   # # #   #   #     #
#### # # # ### # # # # ### ### #
   # # #   #   #   #   #   # # #
 ### # ##### # ######### ### # #
 #   #     # #         #   # # #
 # ####### # # ####### ### # # #
 #   # #   # #   #   #   # #   #
 ### # # ### # # # ##### # #####
     # # #   # # # #     # #   #
###### # # ### # # # ##### # ###
 #   # # #  G# # #   #     #   #
 # # # # ### # ####### ####### #
   #         #                 #
################################
