################################################################
 #   #   #     #           #   # #                 #           #
 # # # # # ### # ######### ### # # ##### ##### ### # ######### #
   # # #   # # #         # #   #   #   #   # # # # #   #   #   #
#### # ##### # ####### ### # ### ##### ### # # # # ### # # # ###
     #   #   #       # #   # # #         # #   #     #   # #   #
 ####### ### ### ##### # ### # ######### # ############### ### #
   #       #   #       #     # #       # #         #     # #   #
## ### ### ### ############### # # ##### ######### # # ### # ###
 #   #   #                       #       #       #   #     # # #
 ### # # ######### # ##### ############### ##### ########### # #
 #     #       #   # #G  #               #   #             #   #
 # ########### ####### # ############# ### # ####### # # # #####
 #     #     #         #       #     #     #   #     # # #     #
 ##### ### # ############# ### # ### ######### ####### # #######
 #   #   # #   #   #     #   # # #           # #   # # #       #
 # ##### ##### # ### ### ##### # ########### # # # # # ####### #
 # #   #   # # # #   #   #     #     #   #   #   # # #   #   # #
 # # ##### # # # # ### ### ######### # # # ####### # ### # # # #
 # #   #   # # # #   #   #   #   #   # # #         #   # # #   #
 # ### # ### # # ### ####### # # # ##### ############# # # ### #
 # # #   #         #         # # # # #   #     # #   #   #   # #
 # # ##### # ##### ############# # # # ##### # # # ######### # #
           # #   # #           # # # # # #   #         #     # #
## ########### # # # ######### # # # # # # ### ##### # # ##### #
   #       #   # #   # #   # #   # # # #   #   #   # #   #   # #
 # # ##### # ### # ### # # # ##### # # ####### # # # ##### # # #
 # # #   # #   #       # #     #   # #   #     # #   #   # # # #
 # # # # # ### # ##### # ##### # ### ### # ### # ##### # # # # #
 # # # # # #   # #   # # #   # # #   #   # #   # #     # # # # #
 # # # # # ##### # # # # # # ### # ### ### ##### # ##### # # # #
 # # # #   #   # # # #   # # #   #   # # # #     #     #   #   #
## # ####### # # # # ##### # # ##### # # # # ##### ### #########
   #       # #   # #       # #     # # #   #   #   #   #   #   #
 ######### ##### # ######### ##### # # ####### # # # ### # ### #
 #     #         # #       #   #   # # #       # # #     #   # #
 # ### # ##### ### # ##### ### # ### # # ######### ######### # #
 # # # # #   #   # # #   #   #   #   #   #         #     #   # #
 # # # # # # # ### # # # ### ##### ####### # # ### # ### # # # #
 #   # # # # # #   #   # # # #   # #       # #   # # #   # # # #
###### # # # ### ##### # # # # ### ### # ### ### # # # ### ### #
   # #   # #   #     # # # # #   #   # #   #   # # # #   #     #
 # # ### # ### ##### ### # # ### ### # ### ### # ### ### #######
 #       # #   #     #   #   # # #   # #   #   # #     #   #   #
## ####### ##### ##### ### ### # # ### # ### ### # ####### ### #
   #     #   #   #   #   # #   # # #   #   #   #   #   # # #   #
 ### ### ### # ##### ### # ### # # # # ### ### ##### # # # # # #
   # #   # #   #     #   #     # #   #   #   #     # # # # # # #
 # # ##### ##### ##### ####### # ##### # ### ### # # # # # ### #
 # #   #       # #     #   #   #     # #   #   # # # #   #   # #
 ##### ### ### # ### ### # # ####### ##### ### # # # ####### # #
     # #   #   #     #   # #   #     #       # #S# #       # # #
#### # # ### ######### ### ### # ##### ####### # ######### # # #
 #   #   #   #   #       #             #       # #   #   # # # #
 # ####### ### ### # ### ##### # ####### ##### # # # # # # # # #
 #   #   # #   #   # #   #   # # #       #     # # # # # #   # #
 ### # # # ### # # # # ##### # # # ############# # # # # ##### #
   #   # #   #   # # # #   #   # #           #   # #   # # #   #
 ####### ### ##### # # # # ##### ########### # ######### # # ###
   #     # #     # # #   # #         #       #       #   # #   #
## # ##### ##### ### ##### # ######### ############# # ### ### #
   #     #   # #   #   #   # #   #     #   #         # #     # #
 ####### # # # ### # # # ### # # # ##### # # ######### # # ### #
           #         # #   #   # #       # #             #     #
