################################################################
     #     #         #     #     #   # #     #             #   #
 ### # ##### # ##### # ### # ### # # # # ### ####### ##### # # #
 # # #   #   # #   # #   # # # #   #   # # #     #   #   # # # #
 # # # ### ### # # ##### # # # ######### # ##### # ### ### ### #
 #     #   # #   # #     # # #     #   #   #     # #     #     #
 ### ### ### ##### # ##### # # ### # # ### # ##### # ### ##### #
 #   #   #   # #   #   #   # #   #   # #   #   #   #   #   #   #
## # # ### ### # ##### # ### ######### # ####### ### ##### # ###
   # #   # #   #     # #   #         # #   #     #   #   # #   #
 ### ### # # # ##### # ### ######### # ### # ##### ### # # ### #
 #     # #   #   # #   #   #   #   # #   #   #   # #   # # #   #
## ##### ####### # ##### # # # # # # ### ##### # # # ### ### ###
   #   # #   #     #     # # # # # #   # # #   #   #   #     # #
 ### # # # # # ##### ##### ### # ##### # # # ######### ####### #
 #   # # # # # #     #     #     #     # # # #       # #       #
 # ### # # # # # ##### ### # ##### ##### # # # ##### # # #######
   # # #   #   #   #     #     #   #   #   # #   #   # #       #
 ### # ####### ### ####### ##### ### # ### # ##### ### ####### #
   #       #   # #       # #     #   #   #   #     #   #       #
 ########### ### ####### ### ########### # ### ### # ##### #####
             #         #     #           #   #   # #     #     #
 ############# # ### # ####### # # ######### ##### ##### ##### #
 #         #   # #   #         # #         # #         #     # #
 ##### ### # ### ############# # # ### # ### # ####### ##### # #
       # # #   # #     # #     # #   # #     # #   #     #   # #
######## # ### ### ### # # ##### ### # ##### ### # # ##### ### #
     #   #   #     #   #   #     #   # #   #     #   # #   #   #
 ##### # ### ##### ##### ############# # # ### ####### # ##### #
       #     #   # #   # #   #     #     #   #         # #     #
 ############# # # # # ### # # ### ######### # ### ##### ##### #
 #         #   # #   #     #     #     #     #   # #   # #     #
 # ####### # ### # ############# ##### ######### # # # # # #####
   #     # # # # # #     #     # #     #       # # # #   #     #
######## # # # # # # ### # ### ### ##### ##### # # # ######### #
   #   # #   # # # # # #     # #   #     #     # # # #     #   #
 ### # # ##### # # # # ####### # # # ##### ##### # # # # # # ###
     #   #   # #   #   #   #   # # # #   # #   # # # # # #     #
 ######### ### ### ### # # # ### # # # # # # # # # # # # ### # #
 #   #               # # # #   # # # # #   # #   # # # #   # # #
 # # # # ########### # ### ### # ### # ############# # ### # ###
   #   # #           #   #     #     # #        G    #   # #   #
######## # ######### ### ############# # ############### # # # #
   #     #   #     # #   #   #   #   # #   #       # #   # # # #
 # ########### ### # # ### # # # # # # ### # ##### # # ### # # #
 #     #       #   #       #   # # # # #   #   #   # # # # # # #
 ##### # ####### ######### ##### ### ### ####### ### # # # ### #
 # #   # #       #       #     #     #   #       #   #   #   # #
 # # ### # ############# ##### ####### ##### ##### # # ##### ###
 #   #   #   #     #     #   # #     #     # #   # # # #   #   #
 # ### ##### ### # # ##### # # # # ####### # # # # # # # ##### #
 #   # #   # #   # #       # # # # #       # # # # # # #       #
 ### # # ### # ### ######### # ### # ####### # ### # # #########
   # # #   #   # #       #   #     #   #           #           #
## # # ### ##### ####### # ####### ### # # ############# ### # #
 # #   #   #   # # #     # #           # # #     #   #   # # # #
 # ##### ### ### # # ##### # ##### ##### ### ### # # ##### # ###
 #       #   #     # #   # # #   #   #   #   # #   #     # #   #
 ########### # ##### ### # ### # ### ### # ### ######### # ### #
         #S  # #   #   # #     #   #     # #     #     # #     #
 ####### # # # # # ### # ######### # ##### # ##### # # # # #####
 #       # #     #     #         # # #   # # #     # # # # #   #
 ############# # ####### ######### # # # # # # ##### # # ### # #
               #                       #       #     # #     # #
