################################################################
         #   #     #     #     #                     #   #     #
 ##### # # # # ### ### # # ##### ##### # # ######### # # # ### #
 #   # # # # #   #   # # #     #     # # # #       #   # # # # #
 ### ### # ######### # # # ### ##### # # # # ##### ##### # # # #
   #     #     #   # # # #   # #     # # # # #   #   #   # #   #
## ####### ### # # # ### # # # # ##### # # # # # ### # ### #####
 # #     #   # # # # #     # #   # #   # # # # # #   # #   #   #
 # # ### ### ### # # # ##### # ### # ##### # ### # # ### ### # #
   # # # #   #   #         # #   #   #     #   # # # #   #   # #
 ### # # # ### ##### ##### # ################# # # ### ### ### #
       #     #     #   #   #               #     #           # #
#### ############# ### # ############### # # ######### ####### #
     #       #   # # # #               # #   # #     #   # #   #
 ##### ##### # # # # # ############### # ##### # ### ### # # ###
   #     #   # #   # # #             # #   #   # # #   # # # # #
 ### ##### ### ##### # # # ####### ### ### # ### # ### # # # # #
     # #   # # #   # # #S# #     #   #   #     # #     # # #   #
 ##### # ### # ### # # ### # ### ### ### ####### ####### # #####
   # # # # # #   # # #   # #   #   #   #         #       # #   #
## # # # # # ### # # ### # ### ### # ############# ##### # # # #
   # #   # #   #   #   # # #   # # #     #       #     # # # # #
 ### ##### # ######### # ### ### # ##### # ########### # # # # #
 #     #     #         #   #   #         #             # # # # #
 # ### ### ### ########### ### # ### ############### ### # # # #
   # #   #   # #         # # # # #   #       #       #   # # # #
#### ### ### # # ####### # # # # # # # ####### # ##### # # # # #
       # #   #   #     #   # # # # # #         #   #   # #   # #
 ##### # # ####### ### ##### # # # # ######### ### # ######### #
   #   # #       #   #   #     # # # #           # #   #     # #
 # ##### ##### # ### ##### # ##### # # # ### # ### ### # # ### #
 # #   # #     #     #     # #     # # # #   #   #   # # #     #
 # # # # # ######### # ##### # ##### # ### # ### ### # # #######
 # # #   #   #     #   #     # #   # # #   # #     # #   #     #
 # # ####### # ### ########### # # # # # ### # ### # ##### ### #
 # # #       #   #             # # #   # #   # #   #     #   # #
 ### ##### # ### ############### # ### # # ### # ####### ### # #
   #       #   #       #         #     # #   # # #   #   #   # #
## ######### ######### ####### # ##### # ##### # # # # ####### #
 #   #             # #     #   #   #   #     # # # # #         #
 ### # # ######### # ##### ### ### # # ##### # ### # ###########
   #   # #   #   # #     #   #   # # #   #   #     #       #   #
## ### # # # # # # ### ##### ##### # ##### # ######### # # # # #
   #   # # #   # #   #     #     # # #     #   #     # # #   # #
 # # ### # ######### ##### ##### # # # ##### # # ### # # ##### #
 #   #   # #       # #     # #   # # #   #   #   #   # #     # #
 ##### ### # ##### # ##### # # ### # ### ##### ####### # ##### #
     # #   # #   # #     # # #   # #   #     #   #     # #   # #
#### # # ### # # # ##### # # ### # ######### ##### ##### # # # #
     #   # #   # # #     # #   # #   #       #     #     # # # #
 ### ##### ##### ### ##### # ### ### # ####### ########### # # #
 #             #   #     # # #   #   #   #   #     #       # # #
 ####### # ####### ##### # # # ########### # ##### # ####### # #
 #     # #       #     # # # # #     #   # # #   # #       # # #
 # ### ######### ##### # # # # # ### # # # # # ### ####### # # #
 #   #     #         #   #   #   # # # #   # #   # #   #   # # #
 ### ##### # ### ######### ####### # # ##### ### # # # # ### # #
   #   #   # #   #   #   #   #     # #     #     #   # # # #   #
 # ### # ### ##### # ### # # ### ### ##### ########### # # #####
 #   # # #       # # #     #     #       #     #       # #     #
 ##### # ####### # # # ########### ##### ##### # ####### ##### #
 #     #   #     # # # #     #     #   #   #   #    G#   #     #
 # ####### # ####### # # ### # ##### ### # # ####### # ### #####
   #       #           #   #   #         # #         #         #
