################################################################
   #   #     #   # #             #             #           #   #
 # # ### ### # # # # # ########### ### # ##### # # ##### # # # #
 #   #   # #   # #   # #     #   # #   # #   # # #     # #   # #
#### # ### ##### ##### # ### # # # # ### # # # # ##### # #######
     # #       # #   #     #   # # # #   # # # # #G#   #       #
 ### # ##### # # # # ##### ##### # # ##### # ### # # ### ##### #
   # #       # # # #   #       #   #       #   # # #   #     # #
## # ######### # # ### ####### ####### ####### # # ### ##### # #
   # #     #   # #   # #   #   #     #       #   #   # #     # #
 ### ### # # ### ### # # # ### # ### # ############# # ####### #
   #   # # #   # #   #   #     # #   #               #       # #
## ### # # ### # # ########### # ####### ### # # ########### ###
 # # #   #   # # # #   #       #       #   # # #   #       #   #
 # # ####### # ### # ### ############# ##### # ##### ##### ### #
   # #     # #     #   #         # #   #   # #       # #   #   #
#### # ### # ####### # ######### # # ### # # # ####### # ### # #
 #   #   # #   #     #     #   # # #     # # #       #   # # # #
 # ##### # ### # ####### ### ### # ####### # ### ### ##### # ###
       # # #   #       #     #   #     # # #   #   #       #   #
 ##### # ### ######### ####### ### ### # # ### ####### ### ### #
 #   # # #   #             #   #   #   #     #     # #   #   # #
## # # # # ##### ######### # ##### # ### # # # ### # ### ### # #
   #     #       #   #     #       # #   # # # #   #   # #   # #
 ####### ####### # # ##### ######### # ### # # # ##### # # ### #
   #             # #       #       # # #   # # #   #   # #   # #
## # ### ##### ### ####### # ##### # # ### # ##### # ### ##### #
 # # # # #     #   #     # # #   # #   #   #   # # # #   #   # #
 # # # # # ##### ### ##### # # ### ##### ##### # # # ### # # ###
   # #   # #   #   #     # #   #         #   # #   #     # #   #
#### ##### # # ### ##### # ##### # ##### # # # ######### # ### #
     #   # # # #   #     #       # #     # # #   #     # #   # #
 ##### # # # # # ### ############# # ####### ### # ### # ### # #
 #   # # #   # # #   #         #   # #     #   # # # # # #   # #
 # # # # ####### # ### ####### # ### # ### # ### # # # # # ### #
   #   #     #   #   #   # #   # #   # # #   #   # #     # #   #
######## ##### ##### ### # # ### # ### # ##### ### ####### # ###
         #     #       #   # #   # #   #   # #   #       # #   #
######## # # ######### ### ### # # # ##### # ### ####### # ### #
   #     # # #     #   # # #   # #   #         #     #   # # # #
 # ####### # # ### # ### # # ######### ####### ##### ##### # # #
 #         # # # # #       #           #     #     #       #   #
 ########### # # # ####### ######### # # ### # #################
 #   #   #   # # #       # #         #   #   #       #         #
 # # # # # # # # ####### # # ############# ######### # # ##### #
 # # # #   # #   #       #   #     #       #       # # #     # #
 # # ####### ### # ########### ### ### # ### ##### # # ##### # #
   # #   #   #   #         # #   #     # #   #   # # # #     # #
 ### # # # # # ########### # # # ####### # ### ### # # # ##### #
   #   # # # #       #   # #   #   #     # #       #   # #     #
## ##### # ######### # ### ### ### ####### # ####### ### # ### #
 #     # #     #       #   #     #       # # #   #     # # #   #
 ### ### ##### # ####### ############### ### # # ####### ### ###
     #   #   # #S  # #   #       #   # #     # #   #     #   # #
#### # ### # ##### # # # # ##### # # # ####### ### # ##### ### #
     #     #     #   # # #     # # # # #       # # # #       # #
 # ############# ### # ### ##### ### # # # ### # # # # ### # # #
 #   #       # #   # #   # #     #   #   # #   # #   # #   # # #
 ### # ### # # # ### ### # # ##### ####### # ### ##### # ### # #
 # # # #   #   #     # #   #     #   #   # # #   #     # # # # #
 # # # # # ########### ######### ### # # # # # ### ### # # # # #
 # # # # # #   #       #       #   # # # # # # #   # # #   #   #
 # # # # ### # # ####### ### ##### # # # # # # # ### # #########
   #   #     #             #     #   # #   #   #     #         #
