################################################################
             #   #     # #   #     #           #   #   #       #
 ##### ### # ### # ### # # # ##### # ######### # ### # # ### ###
 #   # #   #         # #   # #     #   #       # #   #     #   #
 ### # ####### ####### ##### # ### ### # ####### # ########### #
     # #     #   #   #     # # #   #   #     #     #       #   #
#### # # ### ##### # ### ### # # ### ####### # ########### # # #
     # # #   #   # #   #   # # # # #   # #   # #         #   # #
 ####### # ### # # ### ### # ### # ### # # ### # ####### ##### #
   #     #     #     #   #   #     #   #   #   # #   #   #     #
 ### ################### # ### ##### ####### # # # # # #########
   # #   #       #     # #       #   #   # # # # # # # #       #
 # # # # ####### # ##### ### ##### ##### # # ### # # ### ##### #
 # # # #         #     #   # #   # #   #         # #     # #   #
 ### ##### ########### ### ### # # # # ######### # ####### # ###
   #     #           #     #   # # # #     #     #   #         #
 # ##### # ################# ### # # ##### # ### ##### #########
 #     #   #             #   #   # # # #   #   #       #       #
 ##### ### # ########### # ### ### # # # ########### ### ##### #
   # #     #   #       # # #   #   # # #           #   #     # #
## # ######### # ##### # # ### # ### # ########### ### ####### #
 #     #     # # # #   # #   # #     #         # #   #   # #   #
 ##### # ##### # # # ### ### # ############### # ### ### # # ###
   #   #       # #     #   # # # #     # #       #   # # # #   #
 # # ############# ####### # # # # ### # # ####### ### # # ### #
 # # #           # #     #   # #   # # # #   #     # # # #   # #
 # # # ######### # # # ####### ##### # # ### # ##### # # ### # #
 # #   #     #   # # #       #   #         # # #   #   #       #
 ########### # ### # ####### ### # ####### # # # # ### ### ### #
       #   # #   #     #     #   # #       # # # #   #     #   #
 # ### # # # ### ##### ####### ##### ##### # # ##### # ##### # #
 #   #   #     #     #     #   #   #   #   # #     # # #     # #
 ### ####### ####### ##### # ### # ### # ### ##### # # # ##### #
   # #   # # #   # #       # #   # #   #   #     # # # # #   # #
 ### # # # # # # # ####### # ##### # ##### ##### # # ### # # # #
 #   # # # # # # # #   #   #     # # #     #     # # #   # #   #
 # # # # # # # # # # ### ####### # # # ##### ##### # # ### #####
 # # # # #   # #   #   #     # # # # # #   # # #   # # # # #   #
 # ### # # ### ##### # ##### # # # ### # # # # # ### # # # ### #
 #   # # #   # #   # #   #     # #     # # # # #   #   # #   # #
 ### # ##### # # # # ##### ##### # ##### # # # ### ##### ### # #
   #   #   # # # #     #   # #   # #     # # #   #     #     # #
######## # # # ####### # ### # ### # ##### # # # ##### ### ### #
   #     #   #     #   #     # #   #   # #   # #  S# #   #     #
 # # ####### ##### # ####### # # ##### # ##### ### # ### ##### #
 #   #     #     #     #     # #   # # #         #     # #     #
 ##### ### # ####### ### ##### ### # # ############# ### # ### #
   #   #   #   #     #   # #   #     #             # #   #   # #
#### ### ##### # ##### ### # ##### ############### # # ####### #
     # # #     #   # #   # #     #           #   #   #       # #
 ##### # ### ##### # ### # ##### # ######### # # # ######### # #
 #   # #   #     #     #   #   # #         # # #   #     #   # #
 ### # ### ### ##### ##### ### # ######### ### ##### ### # ### #
   #         #     # #     #   #   #   #   #   #   # #   #     #
 # ######### ##### # # ##### # ### # # # ### ### # # # # ##### #
G#         #       # #       #   #   #     # #   # # # # #   # #
#### ##### ####### # ##### ### ####### ##### # ##### # # # # # #
   # #   # #     # #   #   #   #       #     # #   # # #   # # #
 # ### # # # ### # ### # ### # # ####### ##### # # # # ####### #
 #     # # #   #         #   # #   # #   #   #   #   #         #
 ####### ##### ########### ### ### # # ### # ######### #########
 #     #       #   #   #   #     # # # #   #     #   #         #
 # ### ######### # ### # ####### # # # ####### # # ### ####### #
     #           #     #       #               #       #       #
