################################################################
     #         #           #       #   #       #               #
 ##### ####### # ######### ##### ### # ### ### # # # # ####### #
   #   #     #   #       # #   #   # # #   #     # # #   #   # #
## # ### ############### # # # ### # ### ### # ##### ##### # # #
 #   #   #   #     #     #   #     # #   #   # #   # #     # # #
 ##### ### # # ### # ### ######### # # ### # ### # ### ##### # #
 #   # #   # # #   #   #               #   # #   #     #   # # #
 # ### # ### # # ##### # # ############# ### # ######### # # # #
   #   # # #   #  S  # # # #         #   #   #       #   # # # #
 ### ### # ######### # # # # ####### ####### ######### ### # # #
   #     # #       #   # # # # #   #   #     #   #     #   #   #
 # ####### # ######### # ### # # # ### # ##### # # ##### ##### #
 #   #     #   #       #   # # # #   # # #     # # #   # #   # #
 ### # # ##### # ######### # # # ### # # # ##### # # # # # # # #
   # # # #     # #     #   # # #   #   # #     # # # # # # #   #
## ### # # ##### # ### ##### # ### ########### # # # ### # #####
       #   #     # # #       # # #   #       # #   #   #   #   #
###### ##### ##### # ######### # ### # ##### ######### ### # # #
     # #     #   #     #   #   #   #   #   #         #     # # #
 ### # # ##### # ##### # # # ### # ##### ##### ##### ### ### # #
   # #   #   # #     # # # #     # #   #     #     #   # #   # #
#### # ### # # ##### # # # ### ##### # ##### ######### # # #####
     # #   #   # #   #   #   #       #     #         # #   #   #
 ####### ####### # ######### # ######### ########### # # ### # #
 #   #   #     #   #   #   # #         #         # # # #     # #
 # # # ####### # ##### # ### ### ##### ####### # # # # # ##### #
 # #   #       #     # #   # #   #   #   #     #   #   # #   # #
 # ##### # ######### # ### # # ### # ### # ############# # ### #
 # #   # # #         #     #       # #   #     #         #   # #
 # # # # ### ############# # ##### # ####### # # ########### # #
 #   # # #   #         #   # #   # #       # # #     #     # # #
 ### # # # ######### # # ### # # ### ##### # # ##### ##### # # #
   # # #   #         # # #   # #   # #     # # #     #   # #   #
## # # ### ### ####### # # ### ### ### ####### # ##### # # #####
 # # #   #     #     # #   #   #   #   #     #   #   # #   #   #
 # ##### ####### ##### # ### ####### ### ### # ### # # ##### # #
 # #     #   # #       #     #     #     #   # #   #   #   # # #
 # # ####### # # ####### ##### ### ####### ### # ####### # ### #
 # #         #   #           # # #     #   #             #     #
 # ########### ### ### ##### # # ##### # ########### ###########
 #       #   # #   # #     # # # #     # #         #       #   #
 ####### # # # # ### ##### ### # # ##### # ####### ##### ### # #
       # # #   #         #       # #       #   # #     # #   # #
###### # # ############# ######### ### ##### # # ##### # # ### #
       # # #         # # #     #   #   #   # # # #   # # # # # #
 ####### # # ####### # # # ##### ### ##### # # # # # # # # # # #
 # #     # # # #     #     #     #   #       #   # #   #   #   #
 # # ##### # # # ##### ##### ##### # # ########### ####### #####
   #     #   #   #   # #     #     # # #   #   #   # #   # #   #
## ##### ##### ### ### # ##### ##### # ### # # # # # # # ### # #
     #   #     # #     # #   #   #   #   # # #   # #   # #   # #
 ##### ### ##### # ##### # # ##### ##### # # ##### ##### # ### #
       #   # #   # #   #   # #     #   #   # #   # #     # # # #
 ####### ### # # # # # ##### # ##### # ### # # # ### ##### # # #
 #           # # # # #     # #       #     #   #         # #   #
 # # ### # ### # # # ####### # ########################### # ###
   #   # #     #   # #       # #   #     #   #   #   #  G# # # #
###### # ##### ##### # # ##### ### # # ### # # # # # # # ### # #
       # #   #       # # #   #       # #   #   #   #   #   # # #
 ######### # ### ##### # # # ######### # ################# # # #
 #   #     # # #     # # # #       #   #     #   #     # #   # #
 # # ####### # ##### # ### ####### ######### ### ##### # ##### #
   #         #       #           #                             #
