################################################################
################################################################
#   #   #         #     #                       #       #       
# # # # # ####### # ### # # ####### ##### # # ### ##### # ######
# # # #   #     # # #   # #     #   #     # #   # #     #       
# ### ##### ### ### # ### ##### ############# # ### ########### 
#   #   #   # # #   #         #     #   #   # #     #     #   # 
# # # ### ### # # ########### ##### # # # # # ########### # # # 
# #   #   #   # #   #   #   #     #   #   # #   #     #   # # # 
# ##### ### # # ### # # # # ##### ######### # # # ### # ##### # 
# # #   #   # #     # # # #               # # #     #   #   # # 
# # # ### ########### # # ############# ### ####### ##### # # # 
#   #     #       #   # #     #   #   #   #   #   #       # # # 
### ### ### ##### # ### ### # # ### # ### ### # # ######### # # 
#       #   #     # # #   # # # #   # #     #   #         # # # 
##### ### ### ##### # ### # # # # ### # ############# ### # # # 
#   #   #   #     # #   # # # # # #   # # #     #   #   # #   # 
# # # # ### ####### # ### ### # # # ### # # ### # # # # # ##### 
# # # #     #     # #   # #   #   #   # # # # #   # # # #       
# # # ####### ### # # # # # ######### # # # # ##### # ##########
# # #         #   # # # # #     #   # #   # # #   # #   #   #   
# # ### ########### # # # ### # # ### # ### # # # # ### # # ### 
# # #     #           # # #   #   #   # #       # #   # # #   # 
# # # # ### ########### # # ####### ### # ####### ### # ##### # 
# # # # #   #       #   # #     #   #   # # #   #   # #     # # 
# # # # # ### ##### # ### ##### # ### ### # # # ##### ### # # # 
# #   # #   #   # # #   #     # # #   #   # # # #   #   # #   # 
####### ### ### # # ######### # # # # # ### # # # # ### ### ### 
#   #       # # #           # #   # # #   #   # # #   #   #     
# # # ##### # # ########### # ##### # ### ##### # ### ### # # ##
# # # #   # #   #   #   # #   #     # # #     #   # #     # #   
# # ### # # ##### # # # # ##### ##### # ##### ##### ####### # ##
# # #   # # #   # # # #         #       #     #     #       #   
# ### ### # # # # # # ########### ### ### ##### ########### # # 
#   #   # # # # # # #       #   #   # # #   # #             # # 
### ### # # # # # # # ##### # ##### # # ### # ################# 
#       # # # #   # # #     #       #     # #     #             
# ####### # # ##### ### ################### # ### # ### # ######
# #     #   #   #     # #           #  G    #   # #   # # #     
# # ### ### ### ##### # ########### # ######### ##### # # # ####
# #   #   #   # #   # #           # #   # #   #       # # #     
# ### ### # # # # ### ##### ### ### ### # # ######### # ####### 
#   #   # # # #   #   #   #   #     #   # #       #   # #   #   
# ##### ### # ##### ### # ########### ### ####### # # # # # # ##
# #   #     #     #     #     #    S  # # #     #   # # # # # # 
# # # ########### ########### # ####### # # ### ##### # # # # # 
# # #   #     # # #       #   # #           # #       #   #     
# # ### ##### # # ####### # ### ############# ### ### ##########
# #   #   #   # # #       #   #       #     #     #     #   #   
##### ### # ### # # ##### ### ####### # ### # # ### ### # # # # 
#     # # #   # # # #       # #       #   # # # #   #   # #   # 
# ##### # ### # # # # ##### # # ######### # ### # ####### ##### 
# #   #   #   #     #     #   #   #       #   # # #     # #     
# # # ### ### # # ######### ##### # ######### ### ##### # ######
# # #   #   #   # #       #       #   #     #   #       #       
# # ### ### ##### # ##### ####### ### # ####### ############### 
# # # #   # #     #   # # #             #     # #         #     
# # # ### # ### # ### # # # # ####### ### ### ### ##### # # ####
# # # #   #   # #   # # #   # #     #   # #   #       # # #     
# # # # ##### # ##### # ####### ### # # # # # # ####### # ##### 
#     #   #   # #   #   #       #   # # # # # #   #     #     # 
######### # ##### # ##### ####### ### # # # ##### # ########### 
#         #       #       #           #   #       #             
################################################################
