################################################################
################################################################
   #           #           #     # #         #     #          S#
 ### ##### ### # ######### # ### # # ### ##### # ### ### ### ###
     # #   #   #       # # # # #   # #   #   # # #   # #   #   #
 ##### # ##### ####### # # # # ##### ##### # # # # ### ### ### #
   #   # #   #   #   # #   #   #     #   # # # #   #     #   # #
 ### ### # # ##### # # ##### ### ##### # # # # ##### ####### ###
 #   #   # # #     # #     #     #   # #   #   #       #   #   #
 # ### ### ### ##### ##### # ##### # # ######### # ##### ##### #
 #   # # #   # #     #   # #     # # # #       # # #     #   # #
 ### # # ### # ### ### ### # ### ### # # ##### # # # ##### ### #
 # #   #   # #   #       # #   #     # #     #   #       #     #
 # ####### # ### # ##### # ### ####### ##### # ##### ### #######
 # #     # #     # #   # #     #     #       # #   #   #   #   #
 # ##### # ####### # # # ##### # ### ######### # # ### # # # # #
             #   # # # # #     # #         #   # # #   # #   # #
## ######### # ### # # # # ##### # ######### ### # ### # #######
   #   #     #     # # #       # #           #   #   # # #     #
 ### # ########### # # ####### # ####### ##### ##### # # # ### #
 #   #   #         # #             #   #     # #     # #   #   #
 # ##### # ### ##### ############# # # ####### # ##### ##### ###
 # #   # #   # #     #   #     #   # #         # #     #     # #
 # # ### ### # # ####### # ### # ### ##### ##### # ### # ### # #
 # #   # #   # # #     # # #   #     #   # #     # #   #   # # #
 # ### # # ### # ##### # # ##### ##### # ### ##### # # ### ### #
 # # #   #   # #       # #     # # #   #   # #   # # #   #     #
 # # ####### # ######### ##### # # # ##### # # # # # ###########
 #     #   # #               # #     #     #   # # #         # #
 ##### # # # # ####### ####### ### ### ######### # ######### # #
   #   # # # # #     #       #   # #   #     #   #   #   #   # #
 # # ### # # # # ### # ##### ### # # ##### # # ### # # # # ### #
 # #     #   # #   # #   #   #     # #     # # #   #   # #   # #
 # ########### # ### # # # ### # ### ####### # # ####### ### # #
 #       #     # #   # # #   #G#   #   #   #   # #         #   #
 # ##### # ### # # ### ##### # ####### # # ##### # #############
 # #     #   #   #   # #   # # #     # # # #     #   #       # #
## # ####### ####### # # # ### # ### # # ### ##### # ####### # #
   #             #   # # # #   # # #   #     #     #       # # #
 ############# ### # ### # # ### # ########### # ######### # # #
 #       #   # #   # #   # # # #   #           #       #   # # #
 # ##### # # # # ##### ##### # ##### ####### # ### # ### ### # #
 #   #   # # # #   #   # #   #   #   #       #   # # #   #   # #
 ### # ### # ##### # ### # ##### # # ### ######### # # ### ### #
   # #   # # #     # # # #   # #   #   #     #     # #     #   #
## ##### # # # ##### # # ### # # ##### ####### ##### ######### #
   #   # # #   #           # #   #     #     # #   #     # #   #
 ### # # # ##### ######### # ##### # ### ### # # # ### # # # # #
     #   # #     #       # # #     # #     # # # #   # # #   # #
 ######### # ##### ##### ### # ####### ##### # # ### # # ##### #
         #   #   # #   #     #       # #     #   #   # #       #
#### ####### # ### # # ########### # # # ######### ### ##### ###
   # #     # # #   # # #   #     # # # #     #     #   #   #   #
 # # # ### # # # ### # # ### ### # # # ####### ######### # #####
 #   #   # # # # #   # #   # #   # #   #     # #   #     # #   #
 ### ##### # # # ##### ### # ########### ### # # # # ##### # # #
   # #     #   #   # #   # #   #       # # # #   #       #   # #
## # # ##### ##### # ### # ### ### ### # # # ####### ######### #
 # # #     # #   # #     #   # #   #   # # #       # #         #
 # # ##### # ### # ### ##### # # ### ### # ####### # # ####### #
 # #   # # #     #   #   # # # #   # #   #       # # #       # #
 # # # # # ######### ### # # # ### # # ######### # ######### # #
   # #   #           #             #   #                     # #
################################################################
