################################################################
#   # #     #   # #       #     #                 # #           
### # # ### # # # # ####### ### ######### # ##### # # ######### 
#   #   #   # #   # #       # #   #     # # #   # #   #       # 
# ####### ### ##### # ####### ### # ### # # # ### # ### ##### # 
# #   #   # #     # #           # # #   # # #   #     #     # # 
# # # ### # ### ### ########### # # ##### ##### # ######### # # 
#   #   #     # #   # #         # #     #       # #       # # # 
####### ##### # # ### # ######### ##### ##### ### # ### ### # ##
#     #   #   # #     #     #     #   # #   # #       #   # #   
# ### ### # ### ### ####### # ####### # # # ### ##### ### # ### 
# #     # #       # #     # #   #   # #   #     #   # #   #   # 
# ####### ####### # # # ### ### # # # ##### ##### # # # ##### ##
#     #   #     #   # #   #   # # #         #   # # # # #   #   
##### # ### ### # ### ### ### # ############# # # # # # # # ### 
# #   #   #   # #     # #   # #   #       #   #   # # # # #   # 
# # ##### ##### # ##### ### # ### # ##### # ####### # # # ### # 
# #     # #  S  # #       #   # #   # #   #   #       # # # # # 
# ### ### # ##### # ##### ##### ##### # ####### ##### ### # # # 
# #   #   #         #         #     # # #     #     # #   # #   
# # ### ### # ### ### ### # ### ##### # # ### # ### # # ### ####
# # #   #   #   # # # #   # #   #     #     # # # # # # # #   # 
# # # ### ### # # # # # ### # ### ########### # # # ### # # # # 
#   # #   #   # #   # #   #G    #   #         # # # #   #   #   
# ### # ####### # ### ############# # # ####### # # # ### ######
#   #   #       # #   #   #       # # #     #   #   # # # #     
### ##### ####### # ### # # ##### # ####### # ####### # # # ### 
#         #   #   # #   #   #   # #     #   #     #   # # #   # 
# ### ##### ### # # ######### # # ##### # ####### # ### # # ### 
#   #   # #     # #           # # #   # # #       # #     # #   
### ### # ####### ####### # ##### # # # # # ##### # # # # # # ##
#   #   #         #     # #   #   # #   # # #   # # # # #   #   
# ### ### # # # # # ### # ##### ### ##### # # # ### # # ####### 
# #   # # # # # # # # # #     #   #       #   # #     #     # # 
# # ### # # # # ### # # ##### ### ########### ### ######### # # 
# # #   # # # # #   # #     #     #         #   # #     #   #   
### # ### # ### # ### ##### ############### # # # # ### # ######
#   #     #   # #   #     #     #     #     # #   #   # # #     
# ########### # ### ### # ##### # ### # ##### ####### # ### ### 
# #         # #   #     # # #   # #   # # #   #   # # #     # # 
# ######### # ### ####### # # ### # ### # # ### # # # ####### # 
# #   #         #   #     # #     #   # # # #   # # # #   # #   
# # # ####### ##### # ##### ######### # # # # ### # # # # # ####
# # #     #   #   #   #   #   #     # # # # # #   # #   #     # 
# # ##### # # # # ##### ##### # ##### # # # # ##### ######### # 
# #   #   # #   #       #   #   #     # #     #       #     # # 
# ### # ##### ####### ### # ### # ##### ##### # ##### # ##### # 
#     #     # #     #     # #   #     #     #   # #   #     # # 
# ######### ### ### ### ### # ####### ##### ##### # ### ### # # 
#     #   #     # #   #   #         #     # #             # # # 
# ##### # ####### ### ######### ### ### ### # ############# # # 
#       #   #   #   #   #     #   #   #     # #   #   #   # #   
# ######### ### ### ### # ### # ##### ####### # # # # # # # ### 
#         #     #     #   # # #     # #     # # # # # # # #   # 
# ### ### ########### ##### # ### # # ##### # # # # # # ##### # 
#   # #   #       #   #     #   # # #   #   # # #   # #       # 
##### # ######### # ##### # ### # ##### # ### # ##### ### ##### 
#     #       #   #       #   # #     #         #   #   # #     
# ### ####### # ######### ##### # ####### ### ### # ### # # ####
# #   #   #   # #         #     #   #   #   #   # # #   # #     
# ##### # # ### # ######### ##### ### # ##### # # # # ######### 
#       # # #   #   #     #   #   #   # #   # #   # # #       # 
######### # # ##### # ####### ##### ### # # ####### # # # ##### 
#         #                 #       #   # #         #   #       
