################################################################
################################################################
   #   #   #   #     #               #   #               #     #
 # # # # ### # ##### # ##### ####### # # # ####### ### # ##### #
 # # #   #   #     #   #   #     # #   # # #   #   #   #       #
 ### ##### ####### ##### # ##### # ##### ### # # ### ######### #
   # # #   #     # #   # #     #     # #   # # #   #   #   #   #
 # # # # ### # # ### # # ##### ##### # ### ### # # ### ### # ###
 #     #   # # #     # # #         # #   #     # #   # #   #   #
 ######### ### # ##### # ######### # ### ############# # ##### #
 # #     #   # # #   #   #   #   # #   #       #     #   #   # #
 # # ####### # # # # ##### # ### # ### ####### # ### ##### # # #
   # #         # # #       #   #   #   #     #   # # #     # # #
## # ### # ####### ########### # ### ### ### ##### # ### ### # #
   #     # #               #   #       #   #       #   # # # # #
 ######### # ########### ### ### ##### ### # ######### # # # # #
 #         #     # #   # #   # #     #   # #         # #   # # #
 # # ########### # # # ### ### # ### ### # ####### ### # ### # #
 # # # #         # # #   # #     # #   #   #     #         # # #
 # # # # ##### ### # ### # ### ### ### ##### ### ######### ### #
   #   # #   #     #   # #   #   #   # #     #   #       #     #
## ##### # # ######### # ### ### ### # # ######### ##### ### ###
 #     # # #           #     # #     #   #             #   #   #
 ### ### # ################### ##### ##### ############# # ### #
     #   #         #   #     #           # #     #     # #   # #
#### # ########### # # ##### # ##### ##### ### # # ### ##### # #
     # #       # # # #       # #   #     #   # # # #   #     # #
 ### # # ### # # # # ######### # # ##### ### ### # # ### ##### #
   # # # #   # # #   #           #   #     #     # #     #     #
## # # ### ### # ##### ### ######### ######### ### ######### # #
   # #     # # #   #     # #  G  # #           #   #     #   # #
#### ####### # # # # ### # ##### # ############# ### ### # ### #
             # # # #   # #     # # # #   #   #   # #   #   #   #
 ####### ##### # ##### # ### # # # # # # # ### ### ### ##### ###
 #     #   #   #       #   # # # # # # #     # #       #   #   #
 ##### ### # ### ####### # # ### # # # ##### # ######### ##### #
 #     #   #     #     # # #     # #   #   # #       # # #   # #
 # ##### # ##### # ### ### # ##### ##### # # ####### # # # # # #
   #     #   #     # # #   #     # #     #     #     # #   #   #
#### ### ### # ##### # # ##### # # # ####### ### ##### ####### #
 #   #   #   #   #   # # # #   # #   #     # #   #             #
 # # # # ######### ### # # # ### ####### ### # ### ########### #
   # # # #   # #   #   # # #   #         #   #   #     #     # #
#### # ### # # # ### ### # ### # # ####### ##### ####### ### # #
   # #     #   # #   #   #     # #   #     #   #       # #     #
 # # ########### ### # ######### ##### ##### # ####### # ##### #
 #     #   #     #   #     #   #         #   #       # #   #   #
 # ##### # # ##### ####### # # # ##### ### ######### # ### #####
 # #   # # #       # #   #   # # #   #     #   #   # #   #    S#
 ### # # # ######### # # ##### # # # ##### # # # # # ### ##### #
     #   # #   #   #   # #     # # #     #   #   # # #   #     #
 ######### ### ### # ### # ##### # ##### # ######### # ### #####
     # #   #   #   # # # # #     # # #   #   #     # # #   #   #
 ### # # ### ### ### # # # ##### # # # ####### ### ### ### ### #
   #   #     #   #   # # #   #   # #   #   #   #   #   #   #   #
 # ############# # ### # ### # ### ### # # # ### ### ### ### ###
 #               #   # #   # #   #   # # # # # #   # #   #   # #
 ##### ############# # ### # # # ### # # # # # ### # # # # ### #
     #             #   #   # # #   # #   #   #   # # # # # # # #
#### ########### # ### ##### # ##### ######### # # # # # # # # #
 #   #   #     # #   #     # #   #   #   #   # #   # # # # # # #
 # ### # # ### # ### ##### # ### # ### # ### # ##### # # # # # #
   #   #   #     #       #   #   #     #     #       # #       #
################################################################
