################################################################
################################################################
#       #           #       #     #   #             #       #   
# ##### # ######### # ### ### ### ### # ##### # ### # ##### ### 
# #   # # # #       #   # #   # #     # #     #   #       #     
# ### # # # # ######### # # ### ####### ####### # ##### ########
#     # #   # # #       # #   #   # #     #   # #     #     #   
####### ##### # # # ##### ### # # # # ### # # # ##### ##### # # 
#       #     #   # #     #   # #   # # # # # #   #   #   #   # 
# ####### ########### # ### ####### # # # ### # ### # # # ##### 
#   #     #         # #     #     # # # #     # #   # # #     # 
# # # ####### ##### ### ######### # # # ######### ##### ##### # 
# # #         #   #                     #     #   #     # #   # 
# # ########### # ##### ################# ### # ### ##### # ### 
# #   #         # #     #                 # # # #   # #   #   # 
# ##### # # ##### # ##### ################# # ### ### # ##### ##
#   #   # # #   # #   # #   #           #   #   #   #   #   #   
### # ### # ### # ### # ### # # ####### # ##### ### # ### # # # 
#     # # #     #   #     # # #   #           #     # #   # # # 
####### # ######### # ##### # ### # # ##### # ####### # ### # # 
#     #   #   #   #   #     # #   #S#   #   #   #     # # # # # 
# ### ##### # # # # ### ####### ####### # ##### ##### # # # ### 
# # #   #   #   # #   #   #     #       # #   #   #   #   #     
# # ### # ####### ### ### # ####### ##### ### ### # # ##########
#     # # #   #   #     # #   #   #     #   #       #   #   #   
##### ### # # # ####### # ### # # ######### ##### ##### # # # # 
#   # #   # # #         #   # # #         #G#     #   #   # # # 
# ### # ### # ####### ##### # # ########### # ##### # ##### # ##
# #   # #   # #     # #     #   #       #   #     # #     # #   
# # ### # ### # ### # # ######### ##### # # ####### ##### # ### 
# #   # #   #   # # # #           #   #   # #     # #   # #   # 
# ### # ### ##### # # ############# ####### # ### # # ### ### # 
# # #   #   # #   # # #     #     #         # # #   #   #   # # 
# # ### # ### # # # # # ### # ####### ####### # ####### ### # # 
# #     #   # # # # # # #   #   #     #     #   #     #   # # # 
# # ### ### # # # # # # ####### # # ### ### ####### ##### # # # 
#   #     # # # #   #         #   # #   # #   #   #       # # # 
##### ### # # # ##### ####### ##### # ### ### # # ####### # # # 
#   #   # # # # #   # #   #         # #   # # # # #     #     # 
# # ##### # # # # # ### # ######### # # # # # # # # ### ### ### 
# #       # # #   #     #     #     # # # # #   # # # #   # #   
# ######### # ############### # ##### ### # ##### # # ### # # ##
# # #     #   # #   #   #     # #     #   #   # # # #   # #     
# # # ### ##### # # # # # ####### ##### ### # # # # ### # ##### 
#   # # #   # #   #   #     #   #           #   # # # # #     # 
# ### # ### # ##### ####### # # # ##### # ####### # # # ##### # 
# #   # # # #       #   #   # #   #   # # #     #   # # #     # 
# # ### # # ####### # # # ##### ### # ### # ### ##### # # ##### 
# #     # #       # # # # # #   #   #   #   #         #   #     
# ####### ####### ### # # # # ### ##### ####### ##### ######### 
#         #     #   # # # # #   #     #       # #   #   #     # 
##### ##### # ##### ### # # ### ##### ####### # # # # # ##### # 
#     #   # #     #   # #       #   #     # # # # # # #       # 
##### # # # ##### ### # # ### ### # ##### # # ### # ### ####### 
#   # # # #     #   # # #   #   # # #   #   #   # #   #         
# # ### # ##### ### # # # # ##### # # # ####### # ### # ### # ##
# #     #     # # #   #   # #     #   #   #   #   #   #   # #   
# ########### # # ##### ##### ######### # ### ##### ##### # ### 
# # #       #   #     #     # # #     # #     #   # #   # #   # 
# # # # ############# # ### # # # ### # ### ### ### # # # ### ##
# #   #         #     # # #   # # # # #   #     #   # #   # #   
# ### ####### ### ##### # ##### # # # ### ####### ### ##### ### 
#           #                       #   #         #   #         
################################################################
