################################################################
################################################################
# #   #     #                                     #       #     
# # # # ### # ########### ####### ### ##### ### # # # ##### # # 
#   # #   #         #   # #     # # #     # #   #   #       # # 
# ####### ########### # # # ### # # ##### ### ######### ##### # 
#         #   #   #   #   #   # #       # #   #       # # #   # 
# ######### # # # # # ####### # # ####### # ### ##### # # # ### 
#       #   #   #   #G#     # # # #   #   #   #   #   #   # # # 
### ##### ############# ### # # ### # # ##### ### # ### ### # # 
#   #   #         #     # # # # #   # #     # #   # #   #   #   
# ### # ########### ##### # ### # ### ### # # # ### # ### ######
# #   #         #         #     # # #   # # #   #   #   # #     
# # ######### # # ####### ####### # ### ### # ########### # ### 
#   #   #   # #   #     #  S#   # #         # #   #       # #   
# ### # # # ### ### ### ##### # # ########### # # # ####### ####
#     #   #   # #   # #       # # #     #     # # #       #     
# ########### ### ### ######### ### ### ####### # ### ######### 
# #         #     #   #       #       #   #   # #   # # #   #   
# # ####### ######### # ### ########### # # # # ### # # # # # ##
# #   #   # #   #         #     #     # #   #   #   #   # # #   
# ### ### # # # # ############# # ### ########### ####### ##### 
# #   #   # # #     #   #   #   # # #   #       # #       #     
# # ### ### # ##### # # # # ##### # ### # ##### # # ####### ####
# # #     # # #   #   # # #       #     #   # # # #   #   #     
# # # ##### ### # ### ### ################# # # # # ### # ##### 
#   # #   #   # #   # #   #               #   # #   #   #   #   
##### # # ### # ### # # ######### ####### ##### ##### ##### # ##
#       #   #   #   # # #       # #         #   #   # #   #   # 
# ####### ####### ### # ####### # # ######### ### # # # # ##### 
# #     #             #   #   # # #     #   #     # #   #     # 
# ### # ########### ##### # # # ####### # # ####### ##### # # # 
#   # #   #       #     # # #   #   #     #     # #     # # #   
### ##### # ##### # ##### # ##### # ##### ##### # ##### # # ####
# # #     #   #   #   #   #       #     #     #   #   #   #     
# # # ### ### ####### # ####### ####### ##### ##### # ##### ### 
#   #   # # #   #     #     #   #   #   #   # #     #     # #   
# ####### # ### # ### ##### ##### # ### # # # # ########### # ##
# #   #   #   # #   #   # #       #   #   #   #   #       # #   
# # # # ### ### ### # # # ########### ##### ##### # ##### # # # 
#   #       #   # # # #             # # #   #   #   #   #   # # 
##### ####### ### # ######### # ##### # # ### ######### ####### 
#     #     # #     #       # # #   # #   #               #     
# ##### ### # ####### ##### # # # # # # ### # ####### ### # # ##
#     # # #   #         #   # #   # # #     # #   #   #   # # # 
# ### # # ##### ######### ### ##### # ####### # # # ### ### # # 
# # # # #     #     # #   #   #   # # #     # # #   #   #   #   
# # # # # ######### # # ##### # ### # # ### # # ##### ### # ####
# #   #   #       #   # #     #     #   #     # # #   #   # #   
# ####### # ##### ### # ################# ##### # # ### ### # ##
# #   #   # #       # # #   #       #     #     # # #   #   #   
# # # # ### # ####### # # # # ##### ##### # ##### # # # ####### 
# # #   # # #     #   # # # #     #   #   # # #   #   # #       
# # ##### # ##### # ##### ####### ### # ### # # ####### # ######
# #   # # #     # #     # #       # #   #   # #         # #     
# ### # # ##### ####### # # ####### # ### ### ### # ##### # ### 
# #   # # #     #       #   #   # #   #   #   #   #   #   # #   
# # ### # # ##### ##### ##### # # # ### ### ### ####### ### ####
#   #     # #     #         # #   # #   #     # #     #   # #   
# ####### # # # ### ####### # ##### # ####### # # ### ### # # # 
# #       #   # #   #     # # #   # # #   #     # # #     #   # 
# # ##### ##### # ### ### # # # # # # # # ####### # ########### 
#   #           #     #   #     #   #   #                       
################################################################
