################################################################
################################################################
#   #   #       #   #         #   #                             
# # # # ####### # # # ######### # ### # ####### # ############# 
# #   # #     #   #   #   #     # #   # #     # # # #           
# ##### # ### ##### ### # # ##### # ### # ### ### # # ##########
#   # #   # #       #   # # #   # # # # # #       # #     #     
### # ##### ######### ### # ### # # # # # ######### ##### ##### 
# # #       #   #   #   # #     #   #   #     #           #     
# # ##### ### # # # ### ############### ##### ##### ####### ####
#   #   #     # # #   #   #                 #     # #   #       
# ### # ####### # ### ### # # ### # ############# # # # ### ### 
# #   # #       # # #   # # # #   #           #   #   #   #   # 
# # ### ##### ### # ### # # # ################# ######### ### # 
#   # #     #     #     #   # #     #     #     #         # # # 
##### ##### ##### ######### # # ### # ### # ##### # # # ### # ##
#         #     #           #   # # #   #   #     # # #     #   
# ####### ##### ######### # ##### # ### # ######### ### # # ### 
# #     #     #         # # #   # # #   # #       # #   # #   # 
### ### ### ########### # # ### # # # ### # ##### # # ######### 
#   #   # # #   #     #   #   # # # #   # # #     # #         # 
# ####### # # # # ######### # # # # ### # # # ############### # 
#       #   # # #           #     #   # # # #         #     # # 
####### # ### ##### ### # # ######### # ### ######### # ### # # 
#     #   #   #     #   # #   # #     #     #       # #   # #   
# # ##### # ### ### # ####### # # ########### ### # # ### # ####
# #       #   #   # # #     #   #   #         #   # # #   # #   
# ########### ### ### # ### ####### # # ### ### ### # # ### # # 
#     #   #   #   #   # #         #   #   #   #   # # #   #   # 
##### # # # ### ### ### # ### ########### # # ### ### ### ##### 
#   #   # #     #   #   # #   #           # #   #   #    S#     
# # ##### ##### # ### ### # ### ####### ##### # ### ####### ####
# #     #       #       # #   #     #   #   # #   #       # #   
# ##### # ##### ######### ### ##### ##### # ########### # # # # 
# #   #   #   #     # #   #   #   #       #           # # # # # 
# # ####### # # ### # # ### # # # ########### ####### ### # # # 
# # #       # #   # # # #   # # # #   #     # #   #   #   #   # 
# # # ####### ### # # # ### ### # # # # ### # # ### ### # ##### 
#   # # #   # #   #   #   # #   # # #   #   # # #   #   # #   # 
# ### # # # # ########### # # ### # ##### ### # # ######### # # 
# # # #   #           #   # #   #   #   #   #   # #         # # 
# # # ####### ####### ### ##### ##### # ### ##### # ######### # 
#   # #       #   #     # #   # #   # #   #       # #       # # 
##### ######### # ##### ### # # # # ##### ####### # ####### # # 
#     #       # #   # #     #   # #     #   #   # #   #   #   # 
# ##### ##### # ### # ########### ##### ### # ### ### # # ##### 
#       #   #   #   #     #   #   #   # #   #       #   # #     
########### ##### ####### # # # ### ### # ####### # ##### # ####
#       #     # # #     # # # # # # #   # #       #   #   # #   
# ####### ### # # # ### # # ### # # # ### # # ####### # ### # # 
#         #     #   #   #   #   #   # # #   #       # #     # # 
########### ######### ##### # ### ### # ### ####### # ######### 
#         # #       # #   # #   #     #           # #           
# ######### # ##### # ### # ### ##### ##### ### ### # ### ### ##
# #     #   # #   # #     #   #     # #   # #   #   # #   # #   
# ### # # ### # # ######### ####### # # # # # ### ##### ### ### 
#   # # #   #   # #   #   # #     # # #G#   # #   #     #       
### # ##### ##### # # # ### # ##### # ### ##### ### # ##########
# # # #   #   # # # # #   # #       #   # #     #   #           
# # # # # ### # # # # ### # ########### # # ################### 
# # #   #   #   # # # #   # #   #     # # # #   #     #         
# # ####### ### # # ### # # # # ### # # ### # ### ### # ####### 
#                       #     #     #       #     #     #       
################################################################
