################################################################
#     #   # #                   #     #     #         #         
# ##### # # # ##### ##### ### # # ### # ##### ### ### # ####### 
#       # #       #     # #   # #   # # #   # # # #   # #     # 
######### # ########### # # ####### ### # # # # # ##### # ### # 
#       # #   #         # #       # #   # #   # #       #   #   
# ##### # ### # ############### ### # ### ##### ########### ### 
# #   # # #   # #       #     # #   # # #   #   #         #   # 
# # # # # # ##### ##### # ### # # ### # ### # ##### ##### ### ##
# # #   # # #     #   #     # # #   #   #   #     # #     # #   
# # ##### # # ##### # ####### ### ##### # ####### ### ### # ### 
# # #   # #   #     # #     # #   #     # #     #     # #     # 
# # # # # # ######### # ### ### ### ##### # ########### ### ### 
# #   # # #           # #   #   #   #     #   #       #   # #   
####### # ########### # ##### ### ### ####### # ##### # # # # ##
#   #   #       #   #       #       #       #   #       #   #   
# # ### ####### # # ### ### ### ### ####### ##### ### ######### 
# #           # # #     #G      #         #     # #   #     #   
# ########### # # ##### # ##### # ##### # ##### # # ### ### # ##
#   #             #   # # #     #   #   #     #   # #   #   # # 
# # # # ########### ### # # ######### ####### ##### # ### ### # 
# # # # #   #     #     # #       #   #       #     # # # #     
# # # ### ### ### ####### ######### ### ####### ##### # # ### ##
# # # #   #   # # #       #   #     #     #   # #   #   # #   # 
# # # # ### ### # # ##### # # # ##### ##### # # # # ##### # ### 
# # #   #   #   # # #   # # # # #   #       # # # #     # #   # 
# # ##### ##### # # ### ### # ### # # ####### # # ####### # # # 
# #     #     #   #   #   # #   # # #   #   # # # #       # # # 
####### ##### ### # # ### # ### # # ### # # ### # # ####### # # 
#       #   #   # # #     # # #   # #     # #   # #   #   # # # 
# ######### ### # # ####### # ##### # # ##### ### ### # # ### # 
#     #     #   # #   #     #     # # # #   #   # # #   #   # # 
# ### # ##### ### ##### ##### ### # ### # # # ### # ####### # # 
#   #       #   #   #   #       # #   #   # # #   #       # # # 
# # ########### ### # ### ##### ##### # ### # # ##### # ### # # 
# #     #   #   #   # # # # #   #     # # #   # #     # #   #   
##### ### # # ### ### # # # # # # ##### # ##### # ##### # ######
#   # #   # # #   #   # # # # # # #   # #   #   # #             
# # # # ### ### ### ### # # # ### # # # # ### ### # ####### ### 
# # # #   #     #   #   #   #     # #   # #   #   #   #   #   # 
# # # ### ####### ### # ### ####### ##### # ### ##### # # ### # 
# #     # #       #   #   # #   # #       # #   #   # # #   # # 
# ####### # ####### ####### # # # ####### # # ### # ### ### # # 
#   #     # #   # #       # # #               #   #   # #   # # 
# # # ##### ### # # ##### # ##### ######### ### ##### # # ### # 
# # #       #   #       # #     # #   #     #   #     # # #   # 
# # ######### ######### # ##### ### # # ##### ### ##### ### # # 
# #             #     # #     #   # #   #   # #   #   #     # # 
# # ######### # # ### # ### ##### ####### # # # ##### ######### 
# #   #     # #   # # #   #   # #         #   #       #         
##### ##### # # ### # ### ### # ##################### # ########
#     #   # # #   # # # #   #   #       #   #   #   #   #       
# ##### # # # # ### # # ### ##### # ##### # ### # ############# 
# #   # #   # #   #   #     #   # #   #   #     #             # 
# # # # ##### ### ##### ##### ### ### # ######### ##### ##### # 
# # #   #     #       # #S#       # #   #   #   #     #   #   # 
# # ####### ### ####### # # ####### ##### # # # # ### ### # ### 
# #         #   #       # #     #   #     #   # #   #   # #     
# ########### ### ####### ##### # ### ######### ### ### # ######
# #   #         # #   #       # #   # #   #     #   #   #   #   
# # # # # ##### # ### ####### # ### ### # # ##### ### ### # # # 
#   # # # #   # #   #     #   #   #     #   #       # # # # # # 
##### # ### # # ### ##### # ##### # ######### ####### # # # ### 
#     #     # #                               #       #   #     
