################################################################
                   #                                     #     #
 # ### ########### # ########### ##### # ######### ####### ### #
 #   #   #      S  #   #       # #   # #   #     #     #   # # #
 ####### # ########### # ##### ### # ##### ##### ##### # ### # #
 #     # #         #   # #   # #   #     #   #         #     # #
 # ### # ##### ##### ### # # # # ########### ######### ####### #
 # # # # #   # #     #   # #   #           #   #           #   #
 # # # # # ### # ##### ### ############### ### # ########### ###
 # #   # #   #       #   # #        G  #   #   #   #           #
 # ##### ### ### ### ### # # ######### # ### ##### # ###########
 # #   #     #   #   #   # # # #     # #     #     # #     #   #
## # # ####### ### # # ##### # # ### # ### ######### # ##### # #
   # # #     # #   # #       #     # #   # #   #   # # #   # # #
 ### # # ##### # ### ############# ##### # # # # # # # # # # ###
 #   # #       # # # #         #   #     # # #   #     # # #   #
 ### # ######### # # # ####### # # # ####### ########### # ### #
     #         # #     #         #         # #           #   # #
############## # ####### ##### ######### # # # ############# # #
   #   # #   # #   #   # #   # #   #   # #   # #   #       #   #
 ### # # # # # ### # # # # # ### # # # # ##### # # # ##### #####
     #   # #   #   # # # # #   # # # # # #     # #   #         #
 ######### ##### ##### # # ### ### # # # # ##### ##### ####### #
 #         #       #   # # #   #   # #   #     # #   # #     # #
 # ######### ##### # ### # # ### ### # ####### # # # ### ### # #
 # #   #     #     # #   # #   #     #   # #   # # # #   # #   #
 # ### # # ### ##### # ### ### ####### # # # ### # # # ### ### #
 # #   # # #   #       #   # #       # #   #   # # # # # # #   #
 # # ### ### ### # ##### ### ####### # ####### ### ### # # # ###
   #     #   #   # #     #   #     # #   #   #   #   # # #     #
 ####### # ####### # ##### # # ### # ### ### ### ### # # # ### #
     #   # # #     # #     # #   # #   #   #   # #   # # # #   #
#### ##### # # ### # ### ### ### # ### ### # ### # ### # # # # #
   # #   # # # #   #   # # # #   #   # #     #   #     #   # # #
 ### # # # # # # # ### # # # # ##### # # ##### ############# # #
   # # #   #   # # #   #   # #     # # # #   #     #         # #
 # # # ########### # ####### ##### ### # # # ##### # ######### #
 #   # #         # #       #           #   #     # #     #     #
 ##### # ####### # ####### ########### # ####### # ##### # ### #
   #   #   #   #   #     #       #   # #   #   # # #   # # # # #
## # ##### # # ### # ### # ##### # # # ### # # ### # # ### # # #
 #   #     # #     # # # #     #   # #   #   #   #   #   # #   #
 ##### ##### ##### # # # ### ####### ### ####### ####### ### # #
       #   #     # # # #   #       #   #               #     # #
 ####### # ##### # # # ### ######### # ########### ### ####### #
     #   #       # #   # #         # # #         # # #         #
#### # ########### ##### ######### ### # ####### # # ######### #
   # # #   #   #   #         # #   #   #     #     #           #
 # # # # # ### ### # ### # # # # ### ####### ################# #
 # # #   #     #   #   # # #   #     #     #     #         #   #
 # # ########### ### ### # ########### ####### # # ######### # #
 # #   #   #       # #   #           # #     # # # #   #     # #
 # ### # # # ##### # # ##### ##### # # # ### ### # # # # ### # #
 #   #   # # #   # # # #   #     # #   # #   #   #   #   #   # #
 ######### # # # # # # # # ##### # ##### # ### ############### #
         # #   # #   # # #       #     # #     #               #
######## # # ### ##### # ############# # ######### ########### #
   #   #   #   # #   # # #       #     #         # #         # #
 # # ######### # ### # # # ##### # ############# # ### ##### # #
 # #           # #   # # #   #   # #             # #   #   # # #
 # ### ######### # ### ##### # ##### ############# # ##### # # #
 # #   #   #   #     #     # #     # #     #       #   #   # # #
 # ##### # # # ########### # ##### # # ##### ######### # ### # #
 #       #   #             #     #   #       #         #       #
