################################################################
#   #       #                 #               #             #   
### # ##### # ############### ##### # ####### # ######### ### ##
#   #   #   # #             #     # # #     # #   #     #   #   
# ##### # ##### ########### ##### # # # ##### ### # ####### ### 
# #   # #     # #   #   # # #   # # # # # #   #   # #   #     # 
# # ### ##### # # # ### # # # # # # # # # # ### ### # # # ##### 
#       #   #   # #   #   #   #   # # # #   # #   #   #   # #   
# ##### ### ##### ### ### ######### # # # ### ### ######### # ##
# #   # #         # # #   # #   #   #   #               #   #   
### # # # ######### # ### # # ### # ################### # # ### 
#   # #   #         #   #         #   #         #       # # #   
# ### ##### ##### ##### ####### ##### # ####### # ##### # # # ##
#   #     # #   #       #   #   #     #   #     # #   #   # #   
# ####### # # # ######### # ##### ######### ####### # # ####### 
# #       # # #   #       #     # #     #   #       # #       # 
# # ####### ##### # ########### # # ##### ### ####### # ### ### 
# # #     #   #   #   #       # #   #     #       #   #   #   # 
# # # ### ### # ##### # ####### ##### ##### ####### ##### ### # 
# # #   #     #     #   #       #     #     #       #   # #   # 
# # ### # ##### ####### # ####### ##### ##### ####### ### # ### 
# # #   #       #     # # #     # #   # #   # #     #     #     
# ### ### # # ### ### # # # ### # # # # ### # # ### ##### ######
#     #   # #     # #   #   # # # # # #   #   #   #     #S  #   
########### # ##### ######### # # # # ### ####### ##### ### ### 
#       #   #   #       # #   # # # #   #   #     #   # #       
# ##### # ### # ####### # # ### # # ####### # ##### ### ####### 
#     # #   # #         # #   #   # #     # #     #       #   # 
##### # ### # ########### ### ##### ### # # ##### ####### # # # 
# #   #     #                 #         #       #       # # #   
# # ######### ################# ############### # ##### # ##### 
# # #   #                     #   #       #     # #     #     # 
# # ### ### # ### ##### ##### ### # ##### ##### ### ######### # 
# #   # #   #   #     #     # #   # #   #     #     #       #   
# ### # # ########### # # # # ##### # # # ### ##### # ##### ### 
# #   #   # #     #   # # # #   #   # # #   # #     #   # #   # 
# # ####### # ### # ### # ##### # ##### # # # ### # ### # ### # 
# # #     #   # # #   # #     #   #     # # #   # #   # #   # # 
# # # ######### # ### # ##### ##### ##### # ### ####### ### # # 
# # # #     #   #     #     #     #   # # #   #       #   #   # 
# # # # ### # ######### # ####### ### # # ### ####### ### # ### 
# # #   # #   #   #     #     #   #   # # #   #   #   #   # # # 
# # ### # ##### # # ######### # ### ### # # ### ### ### ### # # 
# #   #   #   # # #         # # # # #   # # #   #   #     # #   
# ### ### # # # # ##### # ### # # # ### # # # ### ####### # ### 
#   #   #   #   # #     # #   #   #   #   #     # #       #     
### ### ##### ##### ####### ######### ########### # ########### 
#   # # #   #       #     # #   #   #   #         #     # #     
# ### # # # ######### ### # ### # # ### # ########### # # # ### 
#     #   #             # #     # #   # # #         # # # #   # 
##### ################# # ##### # ### # # ######### ### # ##### 
# #   #         #   #   #     #   #   # #     #   # #   #   #   
# # ### ####### # # ####### # ##### # # # ### ### # # ### ### # 
# # #     #   # # #   #   # # #     # # #   #   #   #     #   # 
# # # ### # # # # ### # # ### # ##### # ####### # ######### ### 
# # # #   # #   # # #   #   # # #     # #       #        G  #   
# # ### ### ##### # ####### # # # # ### # ################### ##
#   #   #       #   #     #   # # #   # # #   #     # #     # # 
# ### ######### ##### ### ##### # ### # # # # ##### # # # ### # 
#   #         # #   # # #   #   #   # #   # #       #   # #   # 
### ######### # # ### # ##### ##### # ##### ####### ##### # ### 
#   #     #   #     #   #     #     #     #   #   #       #     
# ### ### ######### ### ### ### # ##### ### # # # ############# 
#     #                     #   #     #     #   #               
