################################################################
################################################################
#     #             #   #             #   #           #       # 
# ##### ##### ### ### # # ####### # # # # # ######### # ##### # 
# #         # #   #   #   #   #   # # # # #       # #     #   # 
# # ######### # # # ####### # # ### # # # ####### # ####### ### 
#   #       # # # #   #     # # #   #   #   #     #   #     #   
# ######### # # ##### # ####### ### ### ### # ##### ### ##### ##
# #       #   #               #   #   # # #   #       #   #   # 
# # ##### ##### ##### ####### ### ### # # ##### ### # ### # ### 
# #     #     # #   #     #   #   #   #         #   #   #   #   
# ##### ##### ### # ##### # ### ##### ######### # ##### ##### # 
#     # #   #   # #   #   # #   #   # #       # # #   #       # 
# ### # # # ### # ### ##### # ### # ### ##### ### # # # ####### 
# #   #   #   #   # #     # #   # # #   #   #   # # # # #   # # 
# # ######### ##### ##### ### ### # # ### # ### ### # ### # # # 
# #         #       #   #   # #   #   # # #   #   # # #   # #   
# ### ##### ######### # ### ### ####### # # # ### # # # ### ####
#   # #             # #     #   #       # # # #   # # # # #     
### # # ### # ### # # ##### # ### ##### # # ### ### # # # ##### 
#   # # #   # #   #   #   # # #   #     # #   #     # #   #   # 
# ##### # ### # ##### # # # # # # ####### ### ####### ### # ### 
#   #   # #   #   #   # #     # #       #   #   #   #     # #   
### # ##### ##### # ### ##### # ####### ### # ### ######### # ##
#   #     #     # #   # #       #     #   # #   # #     # # # # 
# ####### ##### # ##### ### # ### ### # ### ### # # ### # # # # 
# #     #   #   #     #   # #   #   # #   # #   # #   #   #   # 
# # ### # ### # ##### ### ##### # ### # # # # ### ### ######### 
#   #   # #   #     #   #     # # #   # #   #     #   #       # 
##### ### # ### ### # ####### ### # ### ######### # ### # ##### 
#   # #   # #     # #       #     #   #   #     # # #   #       
# # ### ### # ### ####### ########### ##### ### ### # ##########
# #   # #   #   #   #   #   #       #       #   #   #       #   
# ### ### ##### ### # ##### ### ############# ### ##### ##### # 
# # # #   #       # #     #   #       #   #   #   #     #   # # 
# # # # ### ### ### ##### ### ### # # ### # ### ### ##### # # # 
#   # # #     # #       #     #   # #   # #   # #   #     # # # 
##### # ### # ### ##### ########### ### # ### # # ### ##### # ##
#   #   #   #   #    S#     #       #   #   #   # #   #   # #   
### ##### ##### ##### # # # ######### ### ####### # ### # ##### 
#   #         # #     # # #       #   # #           #   #   #   
# ############# # ####### # ### ### ### # ##### # ### ##### # ##
# #       #     #   #     #   #     #     #   # #         # # # 
# # # ### # ####### # # ### # ####### # # # # # ####### # # # # 
# # # # # #     #   # # #   #         # # # # # #     # # #   # 
# ### # # ##### # ### # # ######### ### # # # # # ### # # ##### 
#  G  # #     # # # # # #       # #   # # # # # # # # # #     # 
####### ##### # # # # # # ### # # ### # # # ### # # # # # ### # 
#   #   #     # # # # # # #   #   #   # # #     # #   # #   # # 
# # # ### ####### # # # ### ####### ### # ####### ######### # # 
# # # #   # #     #   #   # # #     #   # #       #   #     #   
# # # # ### # # ##### ### # # # ####### # # ######### # ##### ##
# #   # #   # # #   # #   #   #   #     # #   #   #   #   #     
##### # # ### # ### # # ######### ####### ### # ### ##### ######
#     # #     #   #   #       # # #     #   # #   #     # #     
# ### # ##### ### ########### # # # ### ##### ### ##### # # ### 
# #   #     # #   #   #       # # #   #       #     #   #     # 
# # ####### ### ### # # ####### # ### ######### ### # ######### 
# # #   # #     #   #   #   #   #     #           # #   #       
# # # # # ####### ####### # ### ######### ######### ### # ##### 
# #   #           #   #   #   #           #           # # #   # 
# ######### ##### ### # ##### # # ######### ######### # # # ### 
#         #     #     #     #   #         #         #     #     
################################################################
