                                                               #
 ######### ########### ############# ###########################
         #       #   # #       #   #     #       # #       #   #
 ####### ####### # # # # ### # # # ##### ####### # # # ##### # #
       #   #   #   # # # # # # # # #   # #   #   #   #       # #
#### ##### # # # ### # # # # # # # # # # # # # ### ########### #
     #     # # # #   #     # #   #   # #   #   #         #     #
 ##### ####### ### ######### # ####### ######### ####### # #####
 #   # #   #S  #   # #       #       #   #   # #       # # #   #
 # # # ### # ### ### # ####### # ### ### # # # # ##### # # # ###
 # # # #   #     # # # #   #   #   #   # # # # #     # # # #   #
 ### # # ######### # # ### # ### # ##### # # # ##### # ### ### #
     # #     #     # #   #   #   #   #   # # #       #  G#     #
 ##### ##### # ### # ### # ######### # ### # # ######### #######
   #   #     # #   #     # #       # # #   #   #   #   #       #
#### ### ####### ######### # ##### # # # ##### # # # # ####### #
   # #   #   #   #         #   # # # # # #   # # #   # #   #   #
 # # # ### # # # # ####### ### # # ### # # ### # ####### # #####
 # # #   # #   # # #   #     # #       #   #   #   #   # #     #
 # # ### # ##### # # # # ### # ############# # ### # # # ##### #
 # # #   #   #   # # # #   # #   #   #       #       #   #   # #
 ### # ####### ### # # ### # ### # # ### # ### ######### # # ###
 #   # #       #   # # #   # #   # #     # #   #       #   #   #
 # ### ####### # ### ### ### # ########### # ### ##### ####### #
   # # #       # # #   # # # # #   # #     # #       #   #   # #
#### # # ####### # ### # # # # # # # # ##### # ######### # # # #
     # #   #     #       # # # # # #   #   # # # #       # #   #
 ### # ### # ############# # # # # ##### # ### # # ########### #
   # # # # # #       #   #   #   # #     #     # # # #       # #
## # # # # # # ##### ### ### ##### # ########### # # # ##### # #
   # #     #   #   # #       #     #   #   #   # # # #     # # #
 ##### ##### ### # # # ##### # ####### # # ### # # # ##### # # #
       #   # #   # # #     # #         # #     #   #       #   #
 ####### # # ##### # ##### # ########### ##################### #
 #       # # #     #   #   #                   #         #   # #
 # ####### # # ####### # ####### # ########### # ### ### # # # #
 #   #   # #   #       #     #   # #   #     #   # #   # # # # #
 ### # # # ##### ########### # ##### # # ### # ### ### ### # # #
 #   # # #     #     # #     #     # #   #   #       #   # # # #
 # ##### ##### ##### # # ######### # ######### ### ##### # # # #
 #           #   #   #   #       # #       #     #   # # # # # #
 ########### ##### ############# # ####### # # # ### # # # # # #
   #   #   #     #   # #       # #     #   # # #   #   #   #   #
## # # # # ##### ### # # ##### # ##### # ### ### # #############
 # # # # #     #   # #   #   # #     #   #   #   #           # #
 # ### # ##### ### # ####### # ##### ######### ### ### ##### # #
 # #   # #   #   #   #       # #               #   #   #     # #
 # # ### # # # # ##### # # ### # ####### # ##### # # ### ##### #
 # #     # # # #   #   # # #   # #       #   #   # #   #     # #
 # ####### # ### # # ### ### ### # ##### ### # ### ### ##### # #
 #     #   #   # #     # #   #   #   # #   # #   # # #     # # #
 ##### # ##### ####### # # ######### # # ### ### # # ##### # # #
   #   #     #       # # #   #     # #   #   #   #       # #   #
 ### ####### ####### # # ### # ### # ### # ### ########### # ###
 #   #       # #       #   #   # #   #   # #   #   #   #   # # #
 # ### ####### # ############### ##### ### # # # ### # # ### # #
 #   #   #       #   #   #   #     #   #   # #   #   # #   # # #
 ### ### ##### ### # # # # ### # # ### # ######### ### ### # # #
   #   # #   #   # # # # #   # # #     # #       # # #   # # # #
 # ### ### # ### # ### ##### # # ####### # ##### # # ### # # # #
 #   #     # #   # #   #   #   # #     # #   # #   #     # #   #
 ### ####### # # # # ### # ### # # ### # ### # ########### # ###
   #           #         #     #   #   #     #             #   #
################################################################
