################################################################
################################################################
         #     #       #     #   #       #   #         #       #
 ######### ### # ####### ### # # ### ##### # # ####### # ##### #
 #       #   # #   #   #   #   #   #       # #   #     # #     #
 # ##### ##### ### # # ########### ######### ### # ##### # #####
 # #   #   #   #     # #         #   #   #   #   #     # #     #
 # # ##### # ##### ### # ####### ### ### # ### ####### # #######
 #     # # #     # # # # #     #     #   #   # # #     #   #   #
 ### # # # ##### # # # # # ########### ##### # # # ####### # # #
     #   #       # # #   #   #               #   # #     # # # #
#### ############# # ##### # # ################### ##### # # ###
   #           #     #     # # # #       #   #   #   # # #     #
 # ### # ##### # # # # # # # # # # ##### # # # # ### # # ##### #
 #     #     #   # #   # # #   # # #   #   #   #     # #   # # #
 ####### ######### ##### # ##### # # # ############### ### # # #
 #       #     # # # #   # #     # # #           #   # #   # # #
 ######### ### # # # # ### # ### # # ### # ##### # # # # ### # #
         # # # #   # #   # # # # # # #   #     # # # # # # #   #
######## # # # ##### ### # # # # # # # ##### # # ### # # # # ###
       #   #   #   # #   #   # #   # # #     # #     #   # # # #
 ##### ########### # # ### ### ##### # ### ### ####### ### # # #
 # #       #       # #   #         # #   # #   #     # #       #
 # # ####### ### ### ### # ### ##### ### # ### ##### # ####### #
 # # #       # #   #   # #   #  S    #   #   #   #   # #     # #
 # # # ####### ### ### # # # ####### # ##### ### # ### # ### # #
 # #   #   #   #   # #   # #       # #     # #   # # # #   #   #
 # ####### # ### ### ##### ####### # ##### # # ### # # ####### #
 # #         #   #       #       # #   #   # #     # #       # #
 # # ######### ### ##### ##### ### # ### ### # ##### ####### # #
 # # #         #   #   #   #   #   # #   # # #             #   #
 # # # ######### ### ##### ##### ### # ### # ### # ### ####### #
 #   #     #     # #     #     # # # #   #   #   # #   #     # #
 ### ##### # ##### ##### ##### # # # ### ##### ### ##### ### # #
   #     # # #   #   #   #   #   #   #   #     #   #   # # #   #
## # # # ### # # # # # ### # ######### ### ##### # # # # # #####
   # # #   # # #   # # #   # #       # #   #     # # #   #     #
 ##### ### # ####### # # ### # ##### # # ####### # # ##### ### #
 #     #   #   #     #   # # #   #   # #   #     # #       # # #
 ### ### ##### # ######### # ### # ### ### # ##### ######### # #
 #   # #       # #   #     #   # # #   #   #   # #     #       #
 # ### ######### # # # ### ### # # ### # ##### # # # # # #######
   #     # #   #   # # #   # #   #   # # #   # #   # # #       #
###### # # # # ### ### # ### ####### # # ### # ##### # ####### #
       # #   # #   #   #   #       #   # #   # #     #   #   # #
#### ### ##### # ### ##### ### ### ##### # ### ####### ### # # #
   #   #       # #   #   # #   #     # #   #   #   # #   # # # #
 # ### ####### # # ### ### # ### ### # ##### ### # # ### # # # #
 #     #     # # # #   #   #   # #   # #         # #     # #   #
 ####### ### # # # ### # ####### # ### # ### ##### ####### #####
 #   #   #  G# # # #   # # #     # #   #   #     #         #   #
 # # ### ##### # # # # # # # ##### # ##### ##### ########### ###
   #   #   # # # #   # #   #     # # #   #     #       #   #   #
#### # ### # # # ##### ##### ### # # # # ##### ####### # # # # #
   # # #       #     # #       # # #   # #     #     #   #   # #
## ### # ##### ### ### # ####### # ### # # ##### ### # ####### #
   #   # #       # #   # #     # #   # # #   #   # # # #       #
 ### ##### ##### # # ##### ### # ### # ##### # ### # # # ##### #
 #   #   #     # # # #     # # #   # #   #   # # #   # # #     #
 # ### # ##### # # # # ##### # ### # ### # ### # ####### # #####
 # #   # #     #   #   #     #     #     #     #         # #   #
 # # ### ######### ##### ############### ######### # ####### # #
   #   #                                           #         # #
################################################################
