################################################################
################################################################
#         #     #               #   #     #     #     #   #     
# ######### ### # ############# # # # ##### ### # ### # # # ### 
#     #     # # # #     #     # # # #   #   #   # # #   # #   # 
##### # ##### # # # ### ### # # # # ### # ### ### # ##### ##### 
#   # # #     # #   # #     # # # #     #   # #     #   #       
# # # # ##### # ##### ####### ### ##### ### # ####### # ####### 
# # # # #   # #       # #   #     #   # # # #     #   #       # 
### # # # # # ####### # # # ######### # # # ##### # ######### # 
#   #   # #   #     # #   # #         # # #   # # # #   #   # # 
# ####### ### # ### # ##### # ##### # # # ### # # # # # # # # # 
#         #   # #   #     #   # #   # #   # # # # # # #   # # # 
####### ##### # # ####### # ### # ####### # # # # # # ####### # 
#       #   # # # #     # # # #   #   #   # # # #   #         # 
# ####### # # ### # ### # # # ##### # # ### # # ##### ######### 
#     #   # #   #   #   # # #   #   #   #   #   #           #   
# ### # ####### ### ##### # ### # ####### ####### ### # ##### # 
#   #   # #   #     #   # # # # #       # #       #   #       # 
# ####### # # ##### # # # # # # ####### # # # ##### # # ####### 
#         # #     # # # # # #         # # # # #     # #   #     
### ### # # ##### # # ### # ### ##### # # # # # ##### ##### ####
# # #   # #   #   #   #   #     #     # #   # # #     #     #   
# # ##### ##### ### ### ######### ### # ##### # # ##### ### # ##
# #   #   # #   #     #           #   #       # #     #   # #   
# ### # ### # ####### ############# ########### ##### ### ##### 
# #   #     #     #     #     #   #           #   # #   #       
# # ### ######### # ### # ### # ##### # ##### # # # ### # ######
#   #   #     #     #   #   #         # #       #   #   # #   # 
##### # # ### ######### ### ### # ##### ####### ##### ### ### # 
#     # #   # #       #     #   #     #   #   # #   # #       # 
# ##### ### # # ##### ####### # ##### ### # # # # # # # # ##### 
# #   # #   #   #   #     #   # #   #   #   # # # #   # #       
# # ### # ##### # # ##### # ##### # ######### ### ######### # # 
# #   # #   #   # # #     #       #   #     #   #   #     # # # 
# ### # ### ##### # ### ### ####### # # ### ### ### ##### # # ##
#   # # #   #     #   #   # #       # # # #   # # #   #   # #   
### # # # # # ####### ### ### ####### # # ### # # ### ### ##### 
#   #   # # #     #   # # #   #     # # #   #   #   #   #       
# ##### # ######### ### # # # # ### ### # # ##### # ### ####### 
#   #   # #         #       # # # # #   # #       # # # #     # 
# # ##### # ######### ####### # # # # ### ######### # # ##### # 
# #     # #   #     # #     # # # #   #           # # # #   # # 
####### # ### # ### ### ### ### # ##### ######### # # # # # # # 
#   #   #   # #   #     # #     #   #     #       #   #   # # # 
# ### # # ### ### ####### ####### # # ### # # ############# # # 
#     # #   #   # #         #     #     # # # #     #       # # 
####### ### ### # # # ####### ### ####### # ### ### # ####### # 
#         # # #   # # #       # # #   #   #   #   #   #     #   
# ### ### # # ##### # # ####### # # # # ##### ### ##### ### ### 
#   # #   #   #   # # #         # # # #   #     #     # #   #   
### # # ######### # # ### ####### # # ### ##### ##### # # # # # 
#   # #           # #     #     # # #   #     # #   # # # #   # 
# ### ### # ####### ####### ### # # ### ##### # ### # ### ##### 
# #   #   #         #     #   # # #   #       #     #   #   #   
### # ####### ########### ### # # # # ######### ####### ### ####
#   # #     # #       #       #   # #   #     #       # #   #   
# ### # ### # # ##### ################# # ### # ####### # ### # 
# #   #   # # # #G#   #   #             # #   # #     # #   # # 
# ######### # # # # ### # ##### ######### ##### # ### # ##### # 
#   #       #   # #     #  S  # #   #   #   # # #   #   #   # # 
# # # ####### ### ########### ### # # # ### # # ### ##### # ### 
# #   #                     #     #   #     #     #       #     
################################################################
