################################################################
################################################################
#       #   #   #   #       #     #       #       #     #       
# ##### # # # # # # # ##### ##### # ### # ### # # ##### # ######
#     #   # # #   #   #     #     #   # #   # # #         #     
##### ##### # ### ##### # ### ####### # ### ### ### ##### # ### 
# #   #   #   #   #   # # #   #   #   #   #   # #   #     # # # 
# # ##### ### # # # ### ### ##### ####### ### # # ### ### # # # 
#   #         # # #   # #   #   #         # # # # #   #   #   # 
##### ##### ### # ### # # ##### ########### # # # # ### ##### # 
#   # #     #   #   # #   # #   #               # # # #     # # 
# # # # ### # ####### ##### # ### ##### ######### # # ### ### # 
# #   # #   #         #       #   #   # #     #   #   #   #   # 
# ##### # ################### # ### # ### ### ######### ### ####
#   #   #   #   #     #     # # #   #     #   #   #   #   # #   
### ### ##### # # # ### ### # # # ######### ### # # # ### # # # 
# #   #   #   #   #   # #   # # #   #     # #   # # #   #     # 
# ### # # # ######### ### ### ##### # # ### # ### ##### ####### 
#   # # #   #       #   # # #   # #   # #   #   #     #   #     
### # # ##### ##### ### # # ### # ##### # ##### ### ##### # ### 
#   # #   #       #   #   #     # #     #     #   #   #   #   # 
# ### # # # ##### ######### ##### # ####### ##### ### # ####### 
#     # # # #   #         # #   # #     # #       #   #   #     
####### ### ### ######### # # # # ##### # ######### ##### # ### 
#           #   #     # #   # #   #   #           #     # # # # 
### # # ##### ### ### # ##### ##### # ########### ##### # # # # 
#   # #   # # #   # # # #   #       #       #   # #   #   # #   
# ##### # # # # ### # # # # ######### ####### # # # # ####### ##
#     # #   # # #   # # # # #       # #   #   #   # #       # # 
# ### # ##### # # ### # # # # ##### # # ### ####### ####### # # 
#   # #     # # # #   #   # #   #   #   #   #       #     # #   
# # # ##### # # # # ####### ### # ##### # ### ######### ### ### 
# # #     # # # #   #         # #     # #     #     #   #   #   
# ##### # # # # ##### ####### ####### # ####### ##### ### ### ##
#   # # # #   #   #   #     #         #         #   #   # #     
# # # # # ####### # ### ### # ################# # # # ### ##### 
# #   # # #       #   # #   #     #   #       #   #   #   #   # 
# ##### # # ####### # # ##### ### # # # ##### # ####### ### # # 
#     # # #   #     #   #   #   #   #       # #       #     #   
# ##### # ### # # ####### # ### ########### # # ### ########### 
# #   # #       # #     # # #   #   #     # # #   #       #   # 
# # # # ######### # ### ### # ### # ##### ### # # ####### ### # 
# # #   #       # # # #     # #   #   #   #   # #       #     # 
### ### # ##### ### # ####### # ##### # ### ### ####### ### ### 
#   #   #   # #   #     #     #   # #   #   #         #   # #   
# ### ##### # ### ##### # ####### # ####### # ########### # # ##
#   #     # #   #   #   #       #   #       # #           # #   
### ####### # # # ### ### ##### ### ##### ### ############# ### 
# #   #     # # # #   #       # #   #   # #   #   #   #       # 
# ### # ##### ### # ##### ##### # ### # # # ### # # # ######### 
#   # # #   #   # #     #   #   #     #   #     #   #           
### # # ### ### # ##### ### # ############# ####################
#   #   #   #   #     # #   #       #       # #                 
# ####### ### ####### # ### ### ##### # # ### # ####### ########
# #     #   #   #S  # #   #   #       # # #   #   #   #   #     
# # ### # # ### ### # ### # ########### # # # ### ### ### # ### 
# #   # # #     #   #   # #           # #   #     #     #   # # 
# ### # # ####### # # # # ##### # ##### # ######### ### ##### # 
#   # #   #   #   # # # #   # # # #  G  #             #     #   
# # # ##### ### ### # ##### # # # # ################# # # ######
# # # #   #     #   #       # # # # #           # #   # #     # 
# # # # # ####### # ######### # # # ########### # # ### ### # # 
# #     #         #             # #             #   #   #   #   
################################################################
