################################################################
   #               #     #         #             #       #   # #
 # # # ########### # ### ######### # ##### # ### # ####### # # #
 # # #     #   # # #   #   #   #   # #   # #   # #   #     # # #
 # ##### # # # # # ### ### # # # ### ### ##### # ### # ##### # #
 # #   # #   # #     #   # # #         #       #   #   #   # # #
 # # # ####### ##### # # # # ####### # ################# ### # #
 # # # #   #   #   # # # #   #     # #         #         #   # #
 # # # # # ##### # # ### # ### ### ########### # ####### # ### #
 # # #   # #     # #     #     # # #           # #     #   #   #
 # ####### # ##### # ##### ##### # # ########### # ### ##### ###
 #       # #   #   # #   #   # # # # #   #       # # #         #
 ####### # ### # ##### # ### # # # # # # # ####### # ######### #
 #   #   #   # #       #   # # # # # # #   #     #   #     #   #
 ### # ##### # ########### # # # # # # ##### ### ### # ### # ###
   # #     #   #       #   #   # # # #     #   # #   #   # #   #
## # ##### ##### # ##### ##### # # ####### # ### # ##### # ### #
 #   #           #       #   # #   #     # #   # # #     #   # #
 ##### ########### ####### # # ##### # # # # # ### # ####### # #
   #   #         #   #   # # #       # # # # #     #     # # # #
 ### ### ####### ### ### ### # ####### ### # ##### ##### # # # #
       #       #   #                 #     # #   #     #   # # #
 ############# ### ########### ############# # # ######### # # #
 #           #   # #         #       #         #           # # #
 # ### # ####### # # ####### # ##### # ##### ##### ######### ###
   #   #       # #   #       # #   #   #   #     #     #   #   #
 ### ########### ##### ####### ### ##### # ##### # # # # # ### #
   #   #     #     #   #     #   # #     # #   # # # #   #   # #
 ##### # ### # ##### ### ### # # # # ##### # # # # ####### # # #
   #   # #   # #   #   #   # # # # # #   # # #   # #       # # #
 # # ### # ### # # ### ##### # # # # # ### # ##### # ### ##### #
 # # #   # #   # #   #       # #       #   #   # # # #   #     #
 # ### ### # ### ### ########### ####### ##### # # # ##### #####
 #     #   #   #   #           # #     #     # #   # #   #     #
 ####### ### ##### ########### ### ### # ##### ##### # # ##### #
       # #   #     #   #   #     #   # # #     # #   # # #     #
 ####### # ### ##### # # # ##### ### # ### ##### # # ### # #####
     #   # # #     # #   #     # # # #     #       #     # #   #
 ### # ### # ##### # ########### # # ####### # ####### ### # ###
 #   #     #   # #   #     #     # # #       # #     # #   #   #
 # ##### ##### # ##### ### # ##### # ######### # ### ### ##### #
 #     #         #     # #   #   # #   #       #   #     #   # #
 ##### ### # ##### ##### ##### # # ### # # ####### ####### # # #
 #     #   # #     #   #       # #   # # #   #   # # #   # # # #
 ########### # ####### # ########### # # ### # ### # # # ### # #
     #   #   # # #     #         # #   # #   #     # # #       #
#### # # # ### # # ############# # ####### # ####### # #########
  G    # #   # #     #     #   #           #         # # #     #
 ##### # ##### ##### # ### # # ##### # # ### # ##### # # # ### #
     # # #     #   #   # # # # #     # # #   #     #     #   # #
#### ### # ##### # ##### # # # # ##### # # # ##### ######### # #
   #   #   #     #     # # # # # #   # # # #     #   # #     # #
## ### ##### ######### # # # # # # ### # # ##### # # # # ##### #
   # # #   #   #   #   # #   #   # #   # #     # # #   # #   # #
 # # # # # ### # # # ### ######### # # # ##### # # ##### # # # #
 # # #   # # # # #   # #     #   #   # #     # # # #  S  # #   #
## # ##### # # # ##### # ### ### ##### ##### ### ### ##### #####
         # #   # #   #   #   #         #   #   #   #   # #     #
 ######### ##### # # # ### ### # ### # # # ### # # ### # ##### #
 #         #     # #     # #   #   # # # # #   # #   # # #     #
 # ######### ##### ##### ### # ### # # ### # ####### # # # #####
 #           #     #   #     # #   # #   # # #       # #   #   #
 ################### # ######### ### ### # # ######### ##### # #
                     #           #     #   #                 # #
