################################################################
# #   #     #   #         #   #     #   #   #     #       #     
# # # # ### ### # ####### # # ### # # # ### # ### ### # # # # # 
# # #   # # #   # # #   # # #   # #   # #   #   #   # # # # # # 
# # ##### # # ### # # # # # ### # ##### # # ### ### ### # # ### 
# # #     # # #   # # #   # #   #   #   # # #   #   #   #   #   
# # # ### # # # ### # ####### ####### ##### # ####### ####### ##
#   # # #   # #   # #           #     #     #         #         
##### # ##### ### # ########### # ####### ############### ##### 
#   # #       #   #   #       # #       # #     #       # #     
# ### ####### # ##### # ##### # ####### # # ### # ##### # # ### 
# #   #       #   #   # #     #     #   # #   # #   # # # # #   
# # ### ######### # ### ### ### ### # ### ##### ### # # # # # # 
# #   # #   #         #   #   # #   # #     #   #   #   # # # # 
# ### # # # # ########### ### # # ### # ##### ### ####### # ### 
#   # #   # #     #     #   # # # #     #     # # #   #   #G#   
# ### ##### ##### # ### ##### # # # ##### ##### # # # ### # # ##
#     #     #     # #   #     # # # #   #     # #   #   # # #   
# ##### ##### ##### # ### ####### # # # ##### # ####### # # # # 
# #   #       #     #   #       #   # # #   #     #     # # # # 
# # # # ####### ####### ####### ##### # ### ##### # ####### ### 
# # # #     #   #     #       #       # #   # #   # #     #   # 
# # # ##### # ### ### ################# # # # # ### ### # # # # 
# # # #     # # #   #                 #   #   #   #   # # # # # 
# # # # ##### # ### # # # ##### # ### ####### ### ### # # ### # 
#   #   #    S#     # # # #   # #   #     #     #   #   #     # 
### ##### ########### # ### # ##### ### # # ### ### ########### 
#   #   #     #       # #   # #     #   #   #   #             # 
# ### # ##### # # ##### # ##### ##### ####### # # # ######### # 
#     #     # # # #   # # #   # #     #   #   # # # #       #   
# ########### # # # ### # # # # # ##### # # ### # # ####### ####
#   # #       # # # #   # # #   #   # # # # #     #       #     
### # # ####### # # # ### # ####### # # # # ##### ### ### ##### 
# # # #     #   #   #   # # #     #   # #   #   # #   #   #     
# # # ##### # ######### # # # ### ##### ### # # ### ####### ####
# #   #   # # #   #   # #   #   #     # #   # #     #       #   
# ### ### # ### # # # # ####### ### ### # ### ####### ####### # 
#       # # #   # # # #           # #   # #   #       # #     # 
# ##### # # # ### # # # ##### ##### # ### # ### ####### # ##### 
# #   #   #   # #   #   #   # #     # #   #     #   #   # #     
# # # # ####### ######### # ### ### # ############# # ### # ####
# # # # #       #     #   # #   #   #       #     #     # #   # 
# # # ### ####### ##### ### # ### ######### # ### ##### # ### # 
# # #     #     #       #   # # # #       # #   # #   # #   #   
# # ####### ### ######### ### # # # # ### # ### # # # # ####### 
# # #     # # #         #     # #   #   # #     # # # # #     # 
# # # ### # # ################# ####### # ####### ### # # ### # 
#   #   #   #   #           # #         #       #     # # # #   
# ##### ##### # # # ####### # ########### # ########### # # ####
# #   #       # # # # #     #             #   #     #     #     
# # # ######### ### # # ######### ### # # ##### ### # ######### 
# # #     #   #     # # #       # #   # #       # #   #   # #   
# # ### ### ######### # ### ### ### # # ######### ####### # # ##
# # # #     #   #     #   # # #     # #   #   #   #   #   #     
# # # ####### # # ### ### # # ####### ### # # ### # # # ####### 
# # # # #     # # #     #   #   #   # #   # #   # # #   #     # 
# # # # # ##### # # ### ##### ### ### # ### ### # # ######### # 
#   #   # # #   # # #       #         #   # # #   #   #   #   # 
# ##### # # # ##### # ##### # # ######### # # ####### # # # ### 
#       #   #       #   # # # #   #     # # #       #   # # #   
####### ########### ### # # ##### # ### # # # # ######### # # # 
#       #         #   # #       # #   #   # # # #         # # # 
# ############# # ### # ####### # ### ##### # ### ######### # # 
#               #     #       #     #                         # 
