################################################################
################################################################
   #         #         #     #     #   #               #   #   #
 ### ######### ####### ### # # ### # ### ############# # ### # #
               #   #     # # # # # #     # #     #   # #     # #
#### ########### # ##### # # # # # ####### # # ### ### # ##### #
 #   #     #     #     #   # # #   #         # #   #   #   # # #
 # # # ### # ######### ### ### ##### ######### # ### ##### # # #
   # # #   #     #     #       #     #       # # # # #   #   # #
#### # ######### # ####### ######### # ##### # # # # # # ### # #
     #   #       # #   #   #   #   #   #   # #   # #   # #   # #
 ####### # ####### # ### # # # # # ##### ### ##### ##### # ### #
   #   #   #     # #     # # #   #   # #     #     #   # # #   #
 # # # ##### ### # ####### # ####### # # ######### # # # # #####
 # # # # #   #   #   #         #   # #   #         # #   #     #
 # ### # # # ####### # ####### # ### ### # ####### # ######### #
 #     #   # #     # # #       #   #   # #     #   # #         #
 ####### ##### # ### # # ### ##### ### # ##### # ### # ####### #
               # #   # # #   #   #     #       #   # #   #   # #
## # ### ####### # ### # # ### # ################# # ### ### # #
   #   # #   #   # #   # #   # #   #     # #   # # #   # #   # #
 ####### # # # # # ##### ### ##### ##### # # # # # ### # # # # #
 #     # # # # # # #   #   #     # #   # #   #           # #   #
 ##### # # # # # # # # ### ##### # # # # ########### ######### #
       # # # # # #   #     #   # #   # #             #         #
######## ### # # ########### ### ##### ######### ##### ####### #
           #   #           #   #       #         #   # #   #   #
 # ####### ##### # # # ### ### ######### ### ### # # ### # ### #
 # #       #     # # #   #   #   #     #   # #   # #   # #     #
## # ####### ####### ### ### ### # ### ### ### # # ### # ##### #
   #   # #   #   #   #   #     # # #       #   # # # #   #   # #
 # ### # # ### ### ####### ##### # # ####### ##### # ### # # # #
 # #   # # # #   #       #       # #   #   #     # #     # #   #
 ### ### # # ### ####### ##### ### ##### # ##### # ##### # ### #
   #   #   #   #       # #   #   #       # #     #     # # #   #
 # ### ##### # ####### # # # # # ### ####### ### ##### ### # # #
 #   # #   # # #     # #   # # #   # #     # #     #   #   # # #
## # # # # # # # ### # # ### # ### ### ### # ####### ### ### # #
   # #   # # #     # # # #   #   #     # # # #     #   #   # # #
 ### ##### # ##### ### ### ### # ####### # ### ### ### ##### # #
 #       # # #   #   #     #   #   #   # # #   #   #   #  S# # #
 ##### # # ### # ### ####### ### # ### # # # ### ### ### # ### #
   #   # #     # #           #   #     # # # # # #   #   # #   #
## # ########### # ##### ### ##### ##### # # # # ##### ### # ###
 # # #   #       # #   #   #   #       # # #   # #     #   # # #
 # # ### # ####### # ######### # ####### # # ### # ##### ### # #
   #     #   #   # # #       # # #     # #   #   #     # #   # #
#### ####### # # # # # ##### # # # ### # ##### ######### # ### #
     #     #   # #   # #   #   # # # # # #     #     #   # #   #
#### # ######### # ### ### ##### # # # # # ##### ##### ### # ###
     # #     #   # #   #     #       # #   #         #         #
 ##### # ### # ### # ### ### # ##### # ##### # # # # # ####### #
   #   # #   # #   # #   # #   #   # #       # # # #   #     # #
## # ### # ### # # # ### # ##### # ########### # ####### ### ###
   # #   #     # # #   #   #     #   #   #   # #           #   #
 ### # ######### # ### ##### ####### # # ### # ####### ####### #
 #   # #       # #   # #   # # #     # #   # # #     #   #   # #
 # ### # ##### # # # # # # # # # ##### ### # # ##### # ### # # #
 # #   # #     # # # #   #   # # #      G# # #   # # # #   # # #
 # # ### # ##### # # ######### # # ####### # ### # # # # ### # #
 # # # # #       # # #   #     # #   # #   #   # #   # #   #   #
 # # # # ######### # ### # ##### ### # # ##### # # ####### ### #
 #   #   #         #           #     #   #       #         #   #
################################################################
