################################################################
################################################################
#           #         #     #       #     #         #     #     
# ### ####### ######### ### ####### # ### # # ##### # # ### ####
#   # #     # #       # #   #       # #     # #   # # # #   #   
### # # ### # # ##### ### ### ####### ####### # # ### # # ### # 
# # #   # #   # #   #     # #     #     #     # #     #     # # 
# # ##### ##### # # ####### ##### ##### # ##### ############# # 
#   #     #   # # #     #   #     #   # # #   # #       #     # 
# ### ### # # # ####### # ### ##### # # # ### # # ####### ##### 
# #   #   # # #       # # #   #     #   #     #       #   #     
# ##### # # ######### # # # ### # ########### ### ##### ### ### 
#       #     #   #   #   # #   # #   #       #   #     # # #   
##### ####### ### # ##### # ##### ### # ####### ### ##### # ### 
#   # #     #           # #     #   # #   #   #   # #   # #   # 
# # # # ### # ### # ### # ##### ### # ### ### ### # # # # ### ##
# # # # # # # #   # #   # #   #     #         #   #   #     #   
# ### # # # # # ### # ### # # ####### ######### ####### ####### 
#     # # # # # #   #   #   # #   #   #         #     # #     # 
### ### # # ### ####### # ##### # # ### ######### ##### # ### # 
#   #   #       #       # #     #   #           # #   # #   # # 
##### ########### ####### # ######### # ####### # # # # ### # # 
#     #   #     # #     # # #         # #  S# # # # # # # # # # 
# ##### # # ### # # ### # # ### ####### # # # # # # # # # # # ##
# #     # #   #   # #   # #   # #       # # # # # # #   # # #   
# # ##### ### # ### # ### ### # ### ##### # # # # # ##### # ### 
# #     # #   # #   #   #   # #   # #   # # #   # # #     # #   
# ##### # # ### # ##### ### # ### # # # # # ### # # # ##### # ##
#   #   # # #   #     #   #       #   # # #   # # #       # #   
# ### ### # # # ##### ### ######### ##### ### # # ### ##### ### 
#     #   # # #     #   #     #   # #     # # # # #   #     #   
# ##### ### ########### ##### # # # # ##### # # # # ### ########
#   # #   #       #     #   # # # # # #     # #       #       # 
# # # ### ####### # ####### # # # # # # ##### ####### ####### # 
# #   #   #   # #   #     # # # #   # #     #    G#     #   #   
# ##### ### # # ######### # # ####### # ### ##### # ### # # ### 
# #   #   # # #       # #   #         #   # #     #   # # #   # 
# # ##### # # ####### # ### ############# # # ##### # # ##### # 
#   #   # # #         # #   # #     #     # # #     # #         
# ### # # # ########### # ### # ### # ####### # # ### ######### 
# #   #   # #     #     #     # # #     #     # #   #       #   
# # ####### # ### ##### ##### # # ####### ##### ############# # 
# #       # # #   #       #   # #     #   #       #     #   # # 
# ####### # # # ### ##### # ### ##### # ### # ##### ### # # ### 
# #   #   # # #     # #   # #   #     # #   # #   # #   # # #   
# # # # # # # ####### # ### # ### ##### ####### # # # ##### # # 
#   # # # # # # #   # #   # # #   #   #       # #   # # #   # # 
##### # ### # # # # # ### # # # ##### ####### ####### # # ##### 
#   # # #   # #   #           # # #   #     #       # # # #     
# ### # # ### # ########### ### # # ### ### ##### ### # # # ####
#     #   #   # #     #   # #     # #     # #   #   # #   #     
##### ######### # ### # # # # # # # # ##### # # ### # # ####### 
#     #       # #   #   # #   # #     #   # # #   #   #     #   
# # # ####### ########### # ### ####### # ### # # ######### ### 
# # #       #     #       #   #   #     #     # #   #     #     
# # ##### ####### # ####### # ### # ########### # # # ### ##### 
# # #   #       # # #       #   # #       #   # # #     #       
# ### # ##### ### # # # # ##### ######### # # # ####### ########
#   # #     #   # # # # # #   #         # # # # #     #   #     
### # # ####### # # # # ### # ######### # # # # # ### ### # ### 
#   # #       # # #   # #   #       #   # # #   #   #   #   #   
# ### ####### # # # ##### ######### # ### # ####### ### # ### ##
#     #       #           #         #     #         #   #   #   
################################################################
