################################################################
       #   #   #               #   #   #   #   #   #       #   #
###### # # # # # ##### # ##### ### # # ### # # # # # ##### # # #
       # #   # # #     # # #   #   # #   # # #   #   #   # # # #
 ####### ##### # ##### # # # ### ### ### # # ####### # ### # # #
 #     #   #     #   # # #     #     # # # #       # #   #   # #
 ### # ### ####### # ### ##### # ##### # # # ##### # ### ##### #
     #   # #       #   #     # #       #     # #   #       #   #
######## # # ######### ##### # ####### ####### # ### ##### # # #
   #       # #       # #     # #         #   #   #   #   # # # #
 # ######### # # ### # # ##### # ######### # ##### ### # ### # #
 #       #   # # #   #   #     #   #       # #     #   #     # #
 ####### # ### # # ####### ##### # # ####### # ##### ######### #
 #     #   #   # #               #   #   #   # #   #   #       #
 ### # ##### # # ### ### ############# # # ### # # ### # #######
   # #       # #   # #   #     #     # #   #   # #   # #       #
## ##### ########### # ### ### # ### # ##### # # ##### # ##### #
 #   #   #         # # #   #   #   # #     # #   #   # # #     #
 ### ##### ####### ### ##### ### # # ##### # ##### # # ### #####
   #     # #     #   # #   # #   # #       #     # # #   # #   #
 ####### # # ### ### # # # # ##### ######### ##### # ### ### # #
       #   # #   #   #   # #   #   #         #     #   #     # #
 ##### ##### # ### ####### ### # ### # ##### # ####### # ##### #
 #   # #   # # # # #   #   #   # #   # #     # #     # #   #   #
 ### # # # # # # # ### # ### ### # ### # ### # ##### # ##### # #
 #   #   #   #   # #   # #   #   # #   #   # #     # #       # #
 # # ############# # ### # ### ##### ### # ####### # ######### #
 # #   #     #     # # #   #   #   # #   # #     # # #         #
 # ### # ### # ##### # ##### ##### # ### # # ### # # # ####### #
   #   #   # #       #     #       # #   #   #   # #   # #     #
#### ##### # ############# ######### # ########### ##### # # ###
     #     #       #           #     #     # #   #   #     #   #
 ##### ######### # # ######### # ######### # # # ### ######### #
     # #   #   # # # #     # #   #         # # #     #         #
 ### # ### # ### ### # ### # ##### # # ##### # ####### ####### #
 #   #   # #     #   # # #   #     # # #     # #     # #     # #
 # ##### # ####### ### # ### # # # ### # ##### # ### # # ### # #
 #   #   #   #     #   #   #   # #   #   #   # # # # # # #     #
 ### # ### ### ########### ### ##### ##### # # # # # # # #######
   #   #   #   #     #   #     #     #     #   #   #   #     # #
## ##### ### ####### ### ##### # ### # ####### ######### ### # #
   #   #   #     #   #   #     # #   # #       #   #   #   #   #
 ### # ### ##### # ### ####### # # ### # # # # # # # ##### #####
 #   # #       # # #           # #   # # # # # # # #       #   #
 ##### ##### ### # ############# # ### # ### ### # ### ##### # #
     #     #   # #       #       # #   # #   #   #   # #     # #
#### ##### ### # ####### # ####### # ##### ### ##### # # ##### #
 #  G#     #   #     #   #   #     #     #   #   #   # #   # # #
 # ####### # ####### # ##### # ### ##### ##### ### ##### # # # #
 #   #   #   #   # # #       #   # #   #       #   #   # # #   #
 ### # # ### # # # # ######### ### # ########### ##### ### # ###
 # #   # #   # #   # #         #   #           #     #     #   #
 # ##### # ### ##### # ### # ### ####### ### # ##### ######### #
   #   #   #   #    S# #   # #   #     #   # #     #         # #
## # # ### # ### ##### # ### # # ##### # # # # ####### ####### #
 #   #       #   #   # # #   # # #     # # # #       #       # #
 ##### ##### # ##### # # ### # ### ##### # # ####### ####### # #
   #   #   # #       # #   # # #   #     # #   #   #     #   # #
## # ### # # ######### ### ### # ### ##### ### # ### # ### ### #
   #   # # #     #     # #   #   #   #   # # # #   # # #   #   #
 ##### # ### ### # # # # ### ##### ### # # # # ### ### # ### ###
       #   #   # # # #   # # #     # # #   #     #     # #   # #
###### ### ### # ### ##### # # ##### # ######### ####### # ### #
         #     #           #       #   #               #       #
