################################################################
################################################################
       #   #                     #         #         #         #
 ####### # ### ################# ##### ### # ##### # # ####### #
     #   #   # # #           #   #   #   # # #     #   #     # #
#### # ##### # # # ######### # ### # ### # # # ######### ### # #
     #     # # # #   #   #   #     # # # # # #     #   #   #   #
 ######### # # # ### # # ########### # # ### ##### # ##### #####
         # #   #   #   # #     #     # #     # #   #   # #     #
 ####### # ##### # ##### # # ### ##### ##### # # ##### # ##### #
 #   #   #   #   #         # #   #   #       # #   #   #       #
 # # ####### # # ######### # # ### # # ####### ### # ######### #
   # #       # #   #     # # #     # #           #     #     # #
 ### # ############# ### # ######### ########### ####### ### # #
 #   #G  #   #   #   #   #       #   #         # #     # #   # #
 ####### # ### # # ######### ##### ### ####### ### ### # # ### #
 #       #     # #     #     #     #   # #     #   # # # # #   #
 # ### ######### ##### # ##### ##### ### # ##### # # # # # # # #
 #   # #       #   #   #   #   #         #   #   # # # # #   # #
 ### # # ### ##### # ### ### ### ########### # ##### # ####### #
 #   # #   #   #   # #   #   #     #   #   # #       #       # #
 # ### # ##### # ### # ### ######### # ### # ### ########### # #
 #   # # #   #   #   #   #       #   # #   #   # #         #   #
 ### ### # # ##### ##### ####### # ### # # ### # # ####### ### #
   #     # # #   #     #   #   # # #   # #   # # # #     # # # #
 ######### ### # ##### ### ### # # # ### ### # ### # ### # # # #
 #   #   #   # #     # #       # # #   #   # # #   # #   # # # #
 # ### # ### # ##### # # ####### # ### ##### # # ##### ### # # #
   #   #   # #   #   #   #   #   # # # #   # #   #     #   # # #
 ### ##### # ### # ##### # # # ### # # # # # ##### ### # ### # #
 #   #     #     #  S# # # # # # #   # # #   #     #       # # #
 # ################# # # # ### # ##### ##### # ########### # # #
     #       #     # #         #       #   #   #   #     # #   #
#### # ##### # ### # ####### ######### # # ##### # # ### # # ###
   # # #   #   # # # #     #         #   # #     #   # # # # # #
 # # # # ####### # # # ### ######### ##### # ######### # # # # #
 # # # #   #       # # # #       # #     #   # #   #   # # #   #
## # # ### # ####### # # ##### # # ##### ##### # # # ### # ### #
   # #   # #   #   #   # #     # #   # #     #   #   # # #     #
 ### # # # ### # ####### # ### # ### # ##### # ####### # ##### #
 #   # # #   # #       #   #   #   #   #     # #       #       #
 # # # ##### # # ##### ### # ##### # ### ##### ##### ##### #####
   # #       # # #         #     #   #   #             #   #   #
#### ######### ### ##### # ##### ##### ### ######### # # ### # #
   # #       #   # #     #     #       #   #       # # #   # # #
 # # # ### ##### ### ####### # ############# ##### # # ### # # #
 #   #   #     # #   #     # # #   #       #     # # # #   # # #
 ####### ### # # # ### # # # # # ### ##### ####### # # # ### # #
 #   #   #   # # # #   # #   # #     #   #   #   #   # # #   # #
 # # # ##### ### # ##### ##### ####### ##### # # # ##### # #####
 # #   #   # #   #   #   #       #   #     # # #   #     #     #
 # ##### # # # ##### # ##### # # ### # ##### # ##### ######### #
     #   # # #       #     # # #       #   # #     #         # #
#### # ### ########### ### ### ######### # # ##### # ##### ### #
     # # #     # #   #   #   #           # # #   #   #   # #   #
 ### # # ##### # # ### # ### # ########### # # # # ### # # # ###
   # #       #   #   # #   # #           #   # # # #   # # #   #
## # ####### ####### # ### # ####### ##### ##### # # ### # ### #
   #   #   #   #     # #   #     #   #   #           #   # #   #
 ##### # # ### # ##### ### ##### ##### # ### ######### ##### ###
 #     # #     # #   #   #     #     # #   # #     #   #   # # #
 # ### # ####### # # ### ##### ##### # ### ### ### ##### # # # #
 #   #             #     #         #     #       #       #     #
################################################################
