################################################################
   #             #             #   #         #     #   #       #
 # ##### ####### # ####### # # # # # ##### # # ### ### # ##### #
 #   #   #     # # #   #   # #   # # # #   # #   #   # # #   # #
#### # # # ### # # ### # ### ####### # # ####### ### # # ### # #
   #   # #   # # # #   #   #     #   # #   #       # # #   #   #
 # ##### ### # ### # ##### ####### ### ### # ##### # # ### #####
 # #         #   # #     #         # #   # # #   # # #         #
 # # ##### ##### # ##### ########### ### # # # # # # ######### #
 #   #   # #   #   #                 #   #   # # # # #       # #
 ##### # # ### ######### ######### # # ### ### # ### # ##### # #
 # #   # #   #   #     # #     #   # #   # #   #     # #     # #
 # # ### ### # # # ### # # ### # ### ### ### ######### ####### #
   # # #   #   #   #   # # #   # #     #     #     #   #   #   #
#### # ### ######### ##### # ### # ### ####### ### # ### # # # #
     #   # #   # #   #     # #   # #     #     #   #     #   # #
 ####### # # # # # ######### # # # # ### ### ### ############# #
       # # # # #   # #     #   # # #   #     #   #       #     #
###### # # ### # ### # ### ####### ########### ### ##### ##### #
   #   # #     #   #     # #         #   #   # #   #     #     #
 ### ### ######### ##### ### ####### # # # ### # ### ##### ### #
 #   #   #     #   #   #     #     # # # #   # # #   #   # #   #
 # ### ##### # # ### # ####### ### ### # # # # # # ### # # ### #
 # # # #     # #     #       # # #   # # # # #   # #   #   #   #
 # # # # ##### ############# # # ### # # # # ##### ### ##### # #
 # # #   #   # #       #       #   #   # # # #   #   # #     # #
 # # ##### # # # ##### ######### ####### # ### ##### ### ##### #
   # #     #   #     #     #           # #         #   # #   # #
 ### # ############# ##### ##### ####### ######### ### ### # # #
 #   # #       #   #   # #     #                 #     #   # # #
 ### # ####### # # ### # ##### ################# ### ### ### # #
   #         #   #           # #       # #     #   # # # # #   #
## ######### ### ####### # ### # ##### # # ### ### # # # # #####
 #     #   #   #       # # #   # #           # #   # #         #
 ##### # # ### # ##### ### # ##### ##### ##### # ### # #########
   #   # #       #   # #   # #   #     #     # # # # # # #     #
 # # ### ######### # # # ### ### # ### ##### # # # # # # # ### #
 # #   #   #     # #   #   #     # # #     # #       #   # # # #
## ### ### # ### ####### # ####### # ##### # ##### ### ### # # #
     # #   # #   #   #   #   #           # #     #         # # #
 ### # # ### ##### # ####### # ### # ### # ##### ### # ### # # #
   # # #   #       # #     #     # # # # #     #   # #   # #   #
#### # ### ######### # ### # ##### # # # ##### ### # ### ##### #
     # #       #   #   # # #   #   # #   #     #   #   #   #   #
 ##### # ##### # # ##### # ##### ### ##### ######### # ### ### #
       #     #   # #   # #   #   #   #   # #     #   # # #   # #
 ########### # ##### # # ### # ####### # # # ### ##### # ### ###
 #         # # #     #     # #   #   # #   # # #   #   #   #   #
 ### ### # ### # ########### ##### # ####### # # # ### # ##### #
   # #   #     #   #     #   #   # # #       # # #   #   #   # #
## ### ####### ### # ### # ### # # # # ####### # ### ##### ### #
   #   #   # #   # # #   #     # # # #     #   #   # #   # #   #
 ### ##### # ### # # ########### # ### # ### ####### # # # # # #
     #   #     # #           #   #     # #   #       # #   # # #
 ##### # ##### # ### ####### # ######### # ### # ##### ##### ###
 #   # # #           #       #           # #   #   # #     #   #
## # # # ####### ### # ##### ### # ### # # ####### # ##### # # #
   #   #       # #   # #   #     # #   # #     #   #       # # #
 # ########### # # ### ### ### ### # ### ##### # ######### ### #
 # #   #       # #   #   #     #   #   #   #   # #       #   # #
 # # # # ##### ######### ##### # # ####### # ### # ##### ### # #
 # # # # #   #  G    #   #   # # # #S      #     # #   # # # # #
 ### # ### # ####### ##### # ### # # ############# # ### # # # #
     #     #       #       #     # #               #     #     #
