################################################################
################################################################
#       #   #         #             #     #   #   #   #         
# ##### # # ### ##### # # ### # ### ##### # # # # ### # ##### ##
# #   #   #     #S    # # #   #   #     #   #   #   # #     #   
# # # ######### ##### # # # ### ####### ########### # ##### ### 
#   #       #   #     # # #   # #     #             #     # #   
# ######### ##### ### # # ### # # # # ################### # ####
# #   #   #   #   #   # # # # #   # #     #   #   #     # # #   
# # # # # ### # ### ### # # # ##### # # # # # ### ### # # # # # 
#   # # # #   #   #   # # #   #     # # #   #   #   # #   #   # 
####### # ####### # ### # ##### # ##### ####### ### ##### ##### 
#       #         # #   #   #   # #   #     #     #   # #     # 
# ################# # ##### # ### # # ##### # ####### # ##### # 
#           #   #   #     # # #   # #   #   #       #         # 
############# # # ####### # # ##### ### ########### # ######### 
#         #   #   #     # # # #     # #     #     # # #   #   # 
# ####### # ####### # ### # ### ##### ##### # ### # # # # # # # 
# #   # # #       # # #   #   # #     #     # #   # # # #   # # 
# ### # # ##### # ### # ##### # # ##### ##### # ### # # ##### # 
#     # #     # #     #     #   #     #       # #   # #     # # 
####### ##### # ########### ######### ######### ### # ##### # # 
#           # #   #         #         #     # # #   # #   # # # 
# ### ##### # ### # ####### ######### # ### # # # # # # ### # # 
# # # #   # #   #   #     # #       # # # # #   # # # # #   #   
# # # ### # ### # ### ### # # ##### # # # # ##### ### # # ######
# #   #   #   # # #   # # #   #   # # # # # #           #       
# ##### ### ### # # ### # ##### ### # # # # ################### 
#   #       #   # # #   #   #   #   # # #   #     #   #         
# # ######### ### # ### ### # # # ### # ##### ### # # # ########
# #       #   #   #   # #   # # #   #       #   # # #   #       
# ####### # ######### # # ### # ### # ##### ### # # ##### # # # 
# #     # # #       # # #   # # #     #   # # # #   #   # # # # 
# # ### # # ### ### # # ### # # ### ### # # # # ##### # # # ### 
# # #   #G# #   # #   # #   # #     #   #     #     # #   #   # 
# # # ### # # ### ##### # ####### ### ### ######### # ####### # 
# # #   #   #   # #     # # #   # #   # # #   #     #   #     # 
# # ### ##### # # # ### # # # # # # ### # # # # ##### # ####### 
# # #       # # # #   # # #   # # #     # # # # # #   #   #     
# # # ### # ### # ### ### ##### # ####### # # # # # ##### ### ##
# # # #   #     #     #   #     #   #   # # # # # #     #   #   
# # # # ######### ##### ### ######### # # # ### # ##### ### ####
# # # #       #         # #           # #   #   #         #     
# # # ####### # ##### ### ##### ####### ### # ### ##### ####### 
# # #       # # #   # #         #     #               #     #   
# ### ####### ### # # ### ### ### ### ####### ####### ### ### ##
#   # #     # #   # # #   #   #   # # #     # #     #   #   #   
### ### ### # # ##### # ### ### ### # # ### # # ### # # ### ####
#   #   #   #   #     #   #   # #   # #   #   #   # # #   # #   
# ### ### ####### ####### ### # # ### ##### ##### # ### # ### # 
# #   #   #   # #       #   # #   # #   #   #   # #   # #     # 
# # ### ##### # ####### ### # ##### ### # ### # # ### ######### 
#   #                 # #   # #       # #   # # #   # #   # #   
##### ### # ########### # ### ####### # ### # # ### # # # # # # 
#     #   #   #         #   #         #       # #   # # # #   # 
# # ### ### ### ########### ############# ### ### ### ### ##### 
# # # # #   #   #   #     #   #         # #   #   # #   # #     
# # # # ##### ### # ##### ### # ####### ### # # ### ### # ### ##
# #   #     #   # # #     #   #   #   #   # # #   #   # # #   # 
# ######### ### # # # ########### # ##### ### ### ### # # # ### 
#         #     # # #         #   #       #   #   #   #   #   # 
# ####### ####### # ######### # ########### ### ### # ##### # # 
#       #         #                             #   #       #   
################################################################
