################################################################
           #   #       #         #           #                 #
 ########### # # # ### # # ##### # ########### ######### ##### #
           # # # #   #   #   #   # #     #   #     #   # #   # #
########## # # # ########### ### # ### # # # ##### # # ### # # #
     #   #   # #   #       #G#   #     # # #     # # # #   #   #
 ##### ####### ### # ##### ### # ####### # ##### # # # # #######
     #       # #   #     # #   # #     #   #       # # #       #
 ### ##### ### ######### ### ### ##### ### # ### ### # #########
 # #       #   #   #   #     # #   #       # # # #   # #       #
 # ######### ### # # ######### ### # # ##### # # # ### # ##### #
 #         #     # # #       #   #   # #   #   # # #   #     # #
 # ### ### ####### # # # ### # ##### ### # ##### # ######### # #
 # #   #   #   #   #   # # # #       #   #     #     #       # #
 # # ### ##### # ####### # # ### ### # ####### ##### # ####### #
 # # # #     # # # #   #   #     #   #     #   #     # # #   # #
 # # # ##### # # # # # # ######### ####### # ### # ### # # ### #
 # #   #     # # #   # #   #       #   #   # #   # #   # #     #
 ######### ### # # ### ##### ####### # # ### ### # # ### #######
 #       # #   # # #   #   #       # # # #   #   #   #         #
 # ##### # # # # # # ### # ####### # ### # ### ##### ### ##### #
   # #   #   # #   #   # # #       #     #     #   #   # #   # #
#### # ####### ### ### # # ############# ####### # ### # # # ###
     #   #   #       #   #   #       # # #     # #   #   # #   #
#### ### # # # # # # ####### # ##### # # # ### ##### # ### ### #
     #     # # # # #       # #   #   #   # # # #       #   #   #
 ##### ##### ### # ######### ### # ##### # # # # ####### ### ###
 #     #   #   # # #   #   # #   #   #   # # # # #   #   #     #
 # # ### # ### # # # # # # # # ##### ##### # # # # # # ####### #
   # #   # #   # # # #   #   # #   # #     # #     # #       # #
#### # ### # ##### # ######### ### # # ##### # ############### #
 #   #   # #   #   #     #   #     # # #   #   #       #       #
 # ##### # ### # # ##### ### ####### # # # ### # ### ### #######
   #     #   #   #     #   #     #   # # #   # # # #   #   #   #
## # ####### ######### ### ##### # ### # ### # # # ### ### # # #
 # #   #   #     #   #   #   #   #     # # # #     # #     # # #
 # ### # # ##### # # ####### # # ### ### # # ##### # ####### # #
     #   #   # #   # #       # # #   #   # # #   #       #   # #
## # ####### # ##### # ####### # ### # # # # # # ####### ##### #
   #   #   # #   #   #   #     #   # # # # #   # #   # #       #
 ##### # ### ### # ##### ##### ### # # ### ##### # # # # ##### #
 #     #   # #   #     # #     #   # #     # #   # # #   #   # #
 # ####### # ### ##### # # ##### ### ####### # ### # # ### # ###
 #   #     #   # #     # # #   #     #     #   #   #   #   #   #
 ### # ####### # # ##### # ### ##### # ### ### ####### # ##### #
 #   # #     #   # #     #     #     #   #   #         #   # # #
 ##### # ### ### ### ########### # ######### # ##### ##### # # #
       # #   # #     #   #   # # #   #   #   # #   # #   # # # #
 ######### ### ####### ### # # # ##### # # ##### # # # ### # # #
           # #         #   # #     #   # #     # # # # #   #   #
 ##### # ### # ### # ### ### ####### ### ##### # # # # # #######
 #     #   #   # # # #   #   #       # #   #   # #     #     # #
 # ##### # # ### # ### ### ### ####### ### # ##### ######### # #
 #     # #   #   #   # #   #   #       #   #       #         # #
###### ### ### ##### ### ### # # # ##### ######### # ######### #
     #   #       #   #   #   # # #       #     #   #   #     # #
 ####### ### # ### # # ####### # ############# # ##### # ### # #
 #       #   # #   # # # #     # #   #  S#     # #       #   # #
 # ####### ### # ##### # # ##### # # ### # ##### # ####### ### #
   # #   #   # # #     #   #   #   #   # # #       #     #   # #
#### # # ### ### # ######### ######### # # ##### ### ### ### # #
       #   # #   # #                 # # #     # #     # #   # #
 ########### # ### # ############# ### # ##### # # ##### # ### #
             #                   #                 #     #     #
