################################################################
   #     #   #     #                     #         #   # #     #
 ### ### # # ### # # ### # # ########### # # ##### ### # # ### #
   #   # # #     #   #   # # #     #   #   #     #   #   #   # #
## ### ### ########### ### # # ### # # ############# ### # ### #
       #   #     #     #   # # # #   # #     #     #   # # #   #
 ##### # # # ### # ##### ### # # ##### # ### # ### ### # # # # #
 #   #   # # #     #   #   # # #   # # # # # #  G# #       # #S#
## # ##### # ##### # # ##### # # # # # # # # ##### # ##### # ###
   #     # #   # # # #     # # # #   #   # # #     # #   # #   #
 ####### ##### # # # ##### # # # ### ##### # ### ### # # ### # #
     # #     # #   #     # # # # # # #     #   #   # # #   # # #
#### # ##### # ########### ### # # # # ####### ### # # ### # # #
     #         #         # #   #   # #       #   #   #   # # # #
 ####### # ##### ####### # # ####### ####### ### ### ##### ### #
   #     # #     #     # #   #     # #   #     # #   #     #   #
## # # ### # ##### ##### ##### # # # # ### ##### # ### ##### # #
 # # #   # #     # #   #   # # # #       # #   # # #   #     # #
 # ####### ##### # # # ### # # # ####### # # # # # # ######### #
 #   #     #   # # # # #   #   #   #   #   # # # # #         # #
 ### # ####### # # # # # ##### ##### # ### # # # # ### ##### # #
     # #   #   # # # # #   #     #   #   # # #   #     #   # # #
###### # # # ### # # # ### # ##### ##### # # ##### # ### # # # #
         #   #   #   #   # # #   # #   #           #     # # # #
 ##### ####### ######### # ### # # ### ### ####### ######### # #
 #   # #     # #   #   # #     # #     #   #     #   #   #   # #
 # # # # # # # # # # # # ####### ######### # ### ##### # # ### #
 # # #   # # # # #   #   #     # #         #   #       # #   # #
 ### # ### ### # ####### # # ### ######### ### ######### ### # #
     # #   #   # # #   # # #   #       #   # # #       #     # #
######## # # ### # # # # # ### ####### # # # # # ##### ####### #
 #       # #   #   # # # # # # #   #   # #   # # # #   #   #   #
 # ####### ### ### # # # # # # # # # ### ##### # # # ### # # # #
 #     #     #   # # # # # # #   #   #   # #   # # # #   # # # #
 # ### ######### ### # # # # ######### # # # ### # # # ### # # #
 #   #         #     # # #   #         # # # #   #   #   # # # #
 ############# ####### # ### ##### ### # # # ### ####### # # # #
               #   #   #   # #   # #   # # #   #         #   # #
## ############# # # ### # # # # # # ##### ### ##### ######### #
 # #       #   # #   # # #   # # # #     # #   #     #   #   # #
 # # ##### # # # ##### # ##### # # ##### # # ##### # # # # # # #
   # #   #   # #     # # #     # #     # # #     # # # #   # # #
## # # # ##### # ### # # ##### # ####### # ##### # # # ##### # #
   # # #   # # #   # # #       #     #   #   #   # # # #       #
 ### # ### # # ##### # ############# # ### ### ##### # #########
   #   #   # #     # #       #   #   #     #   #     # #     # #
 ####### ### ##### # # ####### # # ######### ### ### # # ### # #
 #     # #       #   #     #   # #           #   # # #   # #   #
 # ### # # ##### ######### # ### ############# ### # ##### #####
 # # #   # #       #     #   # #     #     #   # #         #   #
## # ##### # ##### # ### ##### ##### # # # ### # ### # ### # # #
   #       # #   #   #         #   # # # #   # #   # # # # # # #
 ##### ### # # # # ######### ### # # # # ### # # # # # # # ### #
   #   #   # # # #   #     # #   # # # # #   # # #   #   #   # #
## # ### ### # # ##### ### ### ### # # # # ### # ######### # # #
   #   #   # # #         #   # # # # # # #     #   #     # #   #
 ### ##### # # ############# # # # # ### ####### # ##### #######
   # #   # #       # #   #   #   # #   # #     # #     #       #
## ### # # ####### # # # # ##### # ### # # ### # ##### ####### #
 # #   #   #   #     # # # #     #     # #   #       #     #   #
 # # ####### # # # ### # ### ########### # # ######### # ### ###
 # # #   #   # # # #   #     #         # # #   #     # # #   # #
 # # # # # ### # # # ########### ##### # # ### # ### # ### ### #
   #   # #   #   #               #       #   #   #   #         #
