################################################################
   #     #   #   #             #                               #
## # ##### # # # # ########### # ##### # # ######### ######### #
   # #     #   # # #     #     #     # # #         #       #   #
 ### # # ### ##### ### # # ######### # ######### # # ##### #####
     # # #   #   # #G  # #           #     #   # # # #   # #   #
 ####### # ### # # # ### ################# # # ### ### # ### # #
 #       # #   # #   # #   #   #         #   #   #     # #   # #
 # ####### # ######### ### # # # ####### ####### # ####### ### #
 # #   #           #       # # # #             # # #       #   #
 # # # # ######### # ####### # # # ### ##### ### ### ##### # ###
   # # # #   #   # #       # #   #   # #   #   # #   #   # # # #
#### # # # # ### # ####### # ####### ### # ### # # ### # ### # #
 #   #   # #   # # #       #   #   # #   # #   #   # # #     # #
 # ####### ### # # # ######### # # ### ### # ####### # ####### #
   #     # #   #   #         # # #   #   # # #     # # #     # #
## # ### # # ### ########### ### ### ### # # # ##### # # ### # #
   # # #   #   #     #   # # #   # #   # # #   #   # # #   #   #
 # # # ####### ##### # # # # # ### ### # # ### # # # # ### #####
 # #   # #   #   #   # #   #   #     # # #   #   #   #     #   #
 ####### # # ### # ### ########### ### # ### # ############# ###
   #     # #   # #                 #   # #   #   #   #     #   #
## # # ### # # # ############### ### ### # ##### # # # ### ### #
 #   # #   # # # #     #     #   #   #   # #   # # # #   # #   #
 # ### # ### ### # ### # ### # # # ### ### # # # # ##### # # ###
 #   #   #   #   # # # #   # # # # #   #   # # # # #   # #     #
 ######### # # ### # # ### # ### # # ####### ### # # # # #######
           # #     #   #   #     # #                 #     #   #
########## ######### ### ####### # ####### ##### ########### # #
           #   #     #   #   #   # #     # #   #     #     # # #
###### # # # # # ##### ### # # ### # ### # # # ### # # ### # # #
     # # # # # #   #     # #     # # # # #   #   # #   #   # # #
 ### ### # # # ### ##### ####### # # # # # ##### ####### # # ###
   # #   # # #     #   #   #   # # # #   #     #       # # #   #
## ### # ### ####### # ### # # # # ### ### ### ####### # ##### #
 #   # # #   #     # #   # # # #     #   #   #   #     #     # #
 ### # # # ### ### # ### ### # ##### ### ### ### ####### ### # #
       # #     #   # # #   # #   # # #   #   #   #   #   #   # #
################ ### # ### # ### # # # ### ####### # # ### ### #
         #     # #   #     # # #                 # # #   #   # #
 ####### ##### # # ##### ### # # ##### ######### ### ####### # #
       #   #   # #     #   # #   #   #         #     #     # # #
###### ### # ### ##### ### ### ### # ######### ####### ### # # #
 #   # #   #   #     #   #   # #   #   #     # #     # #   # # #
 # # # # ### ####### ### ### # # ##### # ##### # ### # # ##### #
   # # #     #     # #   # # # #   # # #       #   # # #     # #
 ##### ####### ### # # ### # # ### # # ##### ##### # # ##### # #
     #       # #   # #   # #     #   # #   # #     #   # #   # #
#### ####### # # ### # # # # ######### # # # # ######### # ### #
     #     # # #     # #   # #     #   # #   # #   # #   #   # #
 ######### # # ############# # ##### ### ##### # # # # ##### # #
     #     # #   #     #           # #     #   # #   #   # # # #
#### # ##### ### # ### # ### ##### # ####### ### ### ### # # # #
   # #     #   #S  # #   #   #   # #   #     #   #   #   # # # #
## # ##### ### ##### ##### # # # # ### # ####### # ### ### # # #
   # #     # #         #   # # # #     #       # #         #   #
 ### # ### # ######### # ### # # ##### ####### # ##### #########
   #   # # # # #     # # #   # #       # #   # #   # #         #
 # ##### # # # # ### # ### # # ####### # # # # ### # ##### ### #
 #       # #       # #     # # #     #     # #   #       #   # #
 ######### ####### ######### # # ####### ####### ########### # #
 #   #   #       #           # # #     #       # #   #   #   # #
 # # ### ####### ########### # # # ### ##### # # # # # # # ### #
   #                         #   #   #       #     #   #   #   #
