################################################################
################################################################
   # #           #     #             #               #   #     #
 # # # ##### # # # # ### ### ##### ### # ### # # # # ### ##### #
 #   #     # # # # #   #   # #   # #   # #   # # # #   #   # # #
 ######### # # # # ### ### # # # ### ### ##### # # # # ### # # #
 #       # # # #     #   # # # # #     #   #   # # # #         #
 # ##### # # ####### ##### # # # # ####### # ### # ##### #######
   #   # # # #     #   #   #   #   #       #   # #     # #     #
#### ### # # # ### # ### ########### ######### ####### ### ### #
           # #   # #   #   #   #   # #     #   #   #   #   #   #
 ######### ####### ### ### # # # # # # ### ##### ### ### #######
 #   #   #   #     # #   # # # # # # # # #     #     #   #     #
## # # # ### # ##### # # # ### ### # # # ##### ####### ### ### #
   # # # #   # #   #   # # #   #   #   #     #   #   #   # #   #
 ##### # ### # # # ##### # # ### ####### # ##### # # ### # # ###
       # #   #   # #     # # #     #     # #     # #     # # # #
######## # # ##### ####### # ### ### ####### ##### ####### # # #
       #   #   #   #       #   #   # #     # #   #     #   # # #
#### # ####### # ### ######### # # # # ### # # ####### # ### # #
     #   #     # #   #           #   #   # #   #       # # #   #
 ####### # ##### # ### # # ############# # ##### # # ### # #####
   #     # #     # # # # # #           # #       # #     #   # #
#### ##### # ##### # # # ### ########### ######### ######### # #
   # #     # #     #   #     #       #   #   #     #   #     # #
 # # # ##### # ####### ####### ##### # ### # # # # # # # ##### #
 # #     #   # #       #       #       #   # # # # # #   #     #
 # ### ### ### # ##### # ####### ########### # # # # ##### #####
 #     #   #   # #     #       #   #       # # # #   #   # #   #
 ##### # ### ##### ########### ##### ##### # # # ####### # # # #
   # # # #   #   # #         #         #   # # #         #   # #
 # # # # # ##### # # ################### ### # ##### # ####### #
 #   #   # # #   #   #         #         #   #     # #       # #
 ####### # # # ### ### ####### # ######### ##### # # ##### # # #
 #       # # #   # #   # #   # # #         # #   # # #     # # #
 # ##### # # ### # # ### # # ### # ######### # ##### ####### # #
 #     #   #           # # #   # # #       # #   #   #     # # #
 ######### ########### # # ### # # ### ### # ### # ### ### ### #
   # #   #   #G  #   #   # #   #   #   #   # #   #S    # #     #
 # # # # ### # # # # # ### # ####### ### ### # # ####### #######
 # # # # #     #   #   #   #     #   #   # # # #         #   # #
 # # # # # ####### ### # ##### ### ### ### # # ### # # ### # # #
 #   # # #   #   # #   #   #   #   # #     #   #   # #     #   #
 ##### # ### # # ### # ##### ### ### ##### ##### ### # #########
   #   # #   # #     # # #   # #     #     #     #   # #   #   #
## # ### # ### ####### # # ### ####### ##### ### ### # # # ### #
   # # # #   #     #     # #         #   #   #   #   #   #     #
 ### # # ### ##### # ##### # ### ####### ### # ### ########### #
 # #   # #   # #   #   #   # # # #   # #   # # #             # #
 # ##### # ### # ### ### ### # # # # # ### ### # # ######### ###
   # #   #     #   # #   #   #   # # #   #     # #         #   #
 ### # ############# # ##### ##### # # # ############### # ### #
 #   # #   #       #   #   #     # # # # #               #   # #
 # ### # # # ##### # ### # ##### # ### # # # # ##### ######### #
 #   #   #   #   # # #   #   #   #     #   # #     # #     #   #
 ### ######### ### # # ##### ### ##### ##### ##### ### ### # ###
     # #     #     #   #   # #         #     #   # #   #   #   #
 ##### # ### # ########### # # ##### # # ##### # ### ### ##### #
     #   #   # # #   #         #     # # #   # # #   # #     # #
 # # ##### ### # # # # ############# # # # ### # # ### ##### # #
 # # #     # # #   #   #           # # # # #   # # # #     #   #
 # ### ##### # ######### ######### ### # # # ##### # ##### ### #
 #           #           #             #   #       #           #
################################################################
