################################################################
#       # #   #           #       # #   #     #           #   # 
# ##### # # # # ########### ### # # # ### ### ### ##### # # # # 
#   # # # # # # # #         #   #   #   # #   #   #   # #   #   
# # # # # # ### # # ######### ######### # # ### ### # ##### ### 
# # # #   #   # # #         # #       #   #   # #   #     #   # 
### # ### ### # # ######### # # ##### ####### ### ####### # # # 
#   #         #   #     #   # #   #   #           #         # # 
# ####### ##### ### # ### ### ### # ############### ##### ### # 
#   #   #       #   #     # #   # #       #   #     #  G    # # 
##### # ### ##### ##### ### ##### ####### # # # ##### ##### # ##
#     #   #   #   #   # #   #   #     # # # #   #     #     #   
# ####### ### # ### # # # ### # ##### # # # ####### ### ####### 
# #       #   # #   # #   #   #       # #   #       #   #     # 
### ####### ### # ### ##### ########### ##### ####### # # ##### 
#         #   # #   #     #         # #         #   # # #       
# ##### # ### # ### ##### ######### # # ####### # ### # ########
# #   # # #   # # #     #           #   #     # #   # # #       
# # # # ### ### # ##### ############### # ### # ### # # ### ### 
#   # #     #   #     #     #   #     # # #   # #     # #   #   
# ### ####### ### ### ##### # # # ### ### # ### # ##### # ### ##
# # #   #   # #     #   # # # # #   #   # #     # #     #   #   
# # ### # # # # ####### # # ### ### ### # ####### # ########### 
# #   # # # # #   #   #   # #   # #   #   #   #   # #         # 
# # # # # # # ### # # # ### # ### ### ####### # # # # ####### # 
#   # #   # # # # # # #   # #   #   # #     # # # #   # #     # 
##### ##### # # # # # ##### ### ### # # ### # # # ##### # ##### 
#     #   #       # #     # # #     # # # #   # #     #   #     
# ##### # # ####### ##### # # ##### # # # ##### ##### ##### ### 
# #     # #   #     #   #   #     # #   #         # #     # # # 
# # ##### ### # ####### ##### ### # ##### # ##### # # ### # # # 
# #     #   # # #       #     #           #     #   # #   #   # 
# ######### ### # ##### # # ####### ########### ##### ####### # 
#     #     #   # #   #   #       #   #         #   #   #     # 
##### # ##### ### # ##### ########### # ######### ##### # ##### 
# #       # # #   #         #     # # # #     #   #   #   #   # 
# # ##### # # ####### ##### # ### # # # # ### # ### ######### # 
#   #       #   #     #   # # #   #   #     # # # #     #   # # 
##### ### ##### # ##### # # # ### ########### # # ##### # # # # 
#   #   # #     # #   # #   #   # #           #           #   # 
# # ##### # ##### ### # ### ### # # # ################# ####### 
# #   #   # #   # #   # #   # # #   # #   #             #     # 
##### # ### # # # # ### ### # # ####### # # ########### # ### # 
#         # # #   # #   #   # #   #     # # #   #       #   # # 
# ######### ####### # ### ### ### # ##### ### # # ######### ### 
#     #   #       # # #   #   # #   #   #     # # #   #   # #   
# ### # # ####### # # # # # ### ##### ######### # # # # ### # ##
# #   # #       #S# # # #   #   #   #   #     # # # # #   #   # 
# ##### ####### # # # # ####### # # ### # ##### # # # ### ##### 
# #     #         #   #   #   # # #     # #   # # # # # #     # 
# # ######### ########### # # # # ##### # # # # # # # # ##### # 
# #         #   #       #   # #   #     #   #   #   #         # 
# ######### ##### ##### # ### ##### ####################### ### 
#       # #           # #   # #   #     #   #     #       #     
# ##### # ########### # ### # # # ### ### ### ### # ##### ##### 
# #   #   #   #     # # # # # # #   #   #     # #   #   # #     
# # # ####### # ### # # # # # ##### # # ####### ##### ### # ####
# # # # #     # # # # # # # #   #   # #   #   #           #     
# # # # # ##### # # ### # # ### # ### # # # # # ############### 
#   # #   #   #   #     # #   #   #   # #   # # #   #   #     # 
##### # ### # ########### ### ##### ### ### ### # # # # # # ### 
#     #     #           #           # #   # #   # # # #   #   # 
# ########### # ####### ##### ####### ### ### ### # # ####### # 
#             #       #                 #         #         #   
