################################################################
     #     #               #     #                 #           #
 ### # # # ######### # ### # ### ####### ####### # # ###########
 #   # # #   #       # #   #   # #       #     # #     #   #   #
 ### # # ### # # ##### # ####### # ####### ### # ##### # # # # #
   # # #   #   # #   # # #     # #       # #   #     #   # # # #
 # # ##### ### ### # # # # ### # ######### # ### ### ####### # #
 # #     #   # #   #   #   # # #     #     # #     # #     # # #
## ##### ### # # ########### # ##### # ##### # ### # # ### ### #
   #     #   # # #       #     #   # # #     # #   #     #     #
 ### ##### ##### # ##### # ####### # # ### ### # ########### ###
   #     # #   # #     # #       #   #   # #   #           #   #
## ##### ### # ######### ####### ### ### # # # ##### ##### #####
   #     #   #   #     #       #   #     #   #     #     # #   #
#### ##### ##### # ### ####### ### ####### ####### # # ### # # #
     #   # #     # #   #   #   # #   #   # #   #   # # #   # # #
 ##### # # # ####### ##### # ### ### # # # # # ##### # # ##### #
     # #   #     #         # #       # #   # #   #   # #       #
#### # ######### # ### ##### # ######### ### ### # ### #########
   #   #     # # #   #       #           #   #   #   #         #
 # ##### ### # # # # ### ##### ########### ### ##### # ####### #
 #   #   # #   # # #   #                   # # #   # #   #     #
 ### ##### ### # # ### ####### ############# # # # # ##### #####
 # #     #       #   #       # # #   #   #   #   # # #     #   #
 # ##### ####### ### ####### # # # ### # # # ##### # # ##### # #
     # #       # #   #       # #       # # # #   # # #       # #
#### # ####### # # ### ####### ##### ##### # # # # # ######### #
   # #         # # #   #     # #   # #     #   # # #         # #
 ### ########### # ####### ### # # # # ######### # ### ##### ###
   # #         # #   #   # #   # # # #     #     #   #     #   #
## # ######### # # # # # # # ##### # # ##### ####### # ####### #
   #   #       # # #   # #   #       # #     #     # #   #     #
 ##### # ####### # ##### ##### ####### # ##### ##### # # # #####
 #   # #   #   # #     #   #   #       # #     #     # # #     #
 # # # # # # # # ##### ### # ### ####### # ##### ##### # ##### #
   # # # # # #   #   #   # #   # #   #   # #     #     #   #   #
#### # # # # ##### ##### # ### # # # ##### ### # # # ##### # # #
     # # #               #   #     #     #   # # # # #   # # # #
 ##### # ####### ########### ########### ### ### # # ### # # ###
 #   #   #     # # #       #       #       #     # #     # #   #
 # ### ### ### # # # ##### ####### # ### # ####### ####### ### #
 #   # #   #   #   #   #   # #   # #   # #G    #   # #     #   #
 ### # # ### ######### # ### # ### ### # ##### # # # # ##### ###
       #   # #         #   # #   # #   # #       # # # #     # #
###### ### # ### ######### # ### # # # # # ####### # # # # ### #
     #   # #     #   #   # #   #   # # # #   #   #   # # # #   #
 ### # ### ####### ### # # ### ##### ### ##### # ##### # # # ###
 #   # #   #       #   # # # #       #   #     #       # # #   #
 ##### # ### ####### ### # # ####### # ### ########### # ##### #
   #   #     #     #   #   #       # # # # #           #   #   #
## ### ####### # ##### ##### # ### # # # # # ##### # # ### # ###
 #       #     # #     #   # #   #   #   # # #     # # # # # # #
 ####### # ### # # ##### # # ####### ##### ### ####### # # # # #
     #   # #   #     #   # # #     # #   #   # #     # # #   # #
#### # ##### ### # # # ### ### ### # # # ### # # ### # # ##### #
   # #       # # # # #   #     # # # # #     # # #   # # #   # #
 ### ######### # # ##### ####### # # # ######### # ### # # # # #
     #  S#   #   #       #   #   # # #       #   #   #     # # #
 ##### # ### ### ######### # # ### # ####### # ##### ####### # #
     # #   #           #   # #   # #       # #     #       #   #
#### # ### ####### # # ##### ### # # ####### ##### ####### #####
   #   # #   #     # #       # # # # #     #     #     # # #   #
 # ##### ### # ##### # ####### # # # # ### ##### ##### # # # # #
 #             #     #         #   #   #       #         #   # #
