################################################################
#     #                   #   #   #               #           # 
# ##### ################# # # # # # ####### ### ### ######### # 
#   #   #              S#   # # # # #     #   # #   #       # # 
# ### ### # ######### ####### # # # # # ##### ### ### ### ### # 
# #   #   # #   #     #       # # # # # #   #   #   #   #     # 
# # ### ##### # ##### # ####### # # # # # ##### ### ### ####### 
# #   #       # #   # # #   #   # # # # # #   #   #   #     # # 
# ### # ####### # # ### ### # ##### # ### # # # # ######### # # 
#           #   # #   #     #       #   # # #   #   #     # # # 
# ######### # ### ### ####### ####### # # # # ##### # ### # # # 
#     #   # #   #   # #       #   #   # # # # #   # # # #   # # 
##### # # ##### ##### # ####### ### ### # # ### # ### # ##### # 
#     # #     # #     # #         #   #   # #   #     # #     # 
##### # ##### # # ##### # ####### ### ##### # ######### ##### # 
#     # #   # #   #   # #     # #   #   #   # #       #     #   
# ### # # # # # ##### # ##### # # ##### # ### ### ######### # ##
# #   # # #   #           #   # #       #   #   #           #   
### ### # ############### # ### ########### ### # ############# 
#   # # # # #       #   #                 #                   # 
# ### # # # # ##### # # ################# ########### ##### # # 
#     # #   #   #   # #         #       #   #       # #   # #   
### ### ####### ##### ######### # ##### # # # ##### # # # # ####
#   #   #     #   #       #   #   #   # # # # # #   #   # #     
# ### ### ####### # ##### ### ####### # # ### # # ############# 
#   # #   # #     #   #   #   #       # # #   #   #       #     
# # # # ### # ##### ### ### ### ####### # # ####### ##### # ####
# # # #     # # #   #   #   #   # #     # # #     # # #   # #   
# # # ##### # # # # # ### ### ### # ##### # # ### # # # ### # # 
# #   #   # # #   # #   #         # #   # # # # #   # # #     # 
# ##### ### # ##### ### ### ##### # # # ### # # ##### # ####### 
# #   #   # # #   #   #   # #     # # # #   # #   #   #   #   # 
# # # ### # # # # ####### # # ### # # # # ### # ### # ### # ### 
# # #   # # #   #       # # #   # # # #   #   # #   #   # #     
# # ### # # ########### # # ### # # # ##### ### # ####### ######
# #   #   # #   #     #   # #   #                 # #   #       
# ### ##### # ### ### ####### ### ### ####### ##### # # ####### 
#     #   # # #   # # #     # #   #   #     #       # #         
# ##### # # # # ### # # ### # ### # # # ### ### ##### ######### 
# #   # #   #   # # # #   #   #   # # #   #   # #   #     #     
# # # # ######### # # # # ##### ### # ### ### ### # ##### ######
# # # #   #   # #   # # #   #   #   #       # #   #     #       
# # ##### # # # # ### ##### ##### ### ### # ### ####### ####### 
# #       # # # # #         #   # #   #   #     #     #   #     
# ### ### # # # # # # ####### # # # ############# ### # # # ### 
#     #   # # # #   # #     # #   #       #   #   # # # # # #   
####### # # # # ##### # ### ####### ##### # ### ### # ### # ####
#     # # # #   # #   #   #   #   # #     #   # #         # #   
# ### ### # ### # # # ### ### # # ### ####### # ########### # # 
# # #     # # # #   #   #   # # #     #   #   #       #   #   # 
# # ##### # # # ##### # ##### # ####### # # ######### # ### ### 
# #   #   #   #       # #     #   # #   # # #         #     #   
# ### # ############### # ####### # # # ### # ############### ##
#  G#     #             #         # # #   #   # #     #       # 
### ##### # # ### ################# # ### ##### # ##### ####### 
#   #   #   # #   #   #   #         #   #       #   #   #     # 
# ### # ##### # ### # ### # ### # # ### ### # ##### # ##### ### 
#     #   # # # #   #   # # #   # #     # # #     #   # #   #   
######### # # # # ##### # # # ### # ##### # # ######### # ### ##
#       # #   # # #   #   # # #   #     #   #           # #   # 
# ##### # ### # # # ####### # # ####################### # # ### 
# #   #   #   # # #     # # # #   #                   #   #   # 
# ### ####### # # ##### # # # ##### ################# ####### # 
#     #       #             #                       #           
