################################################################
################################################################
       #     #   #    S#             #   #   #             #   #
 # ##### ##### # # ##### # ######### ### ### # ##### ### # ### #
 #     # #     # #       #         #   # #     #   # # # #     #
 ##### # # ##### ######### ####### ### # # # ### # # # # # #####
 #   # # #     #       #         #   #   # # #   # # #   # #   #
 # # ### ##### ####### # # ### ### ######### # ### # ##### ### #
   # #   #   # #       # #   #   #     #     # #   # #     #   #
 ### # ### # # ############# ### ### # # # ### # ### ### # # ###
 # #   # # # #             #   #   # #   #     #   #   # #     #
 # ##### # ############### ### # # # # ########### ### #########
         #   #   #   #   #     # # # #   #   #   # #   #       #
#### ####### # # # # # ######### # # ##### # # # # # ### ##### #
   # #     #   #   #             # # #     # # #   #         # #
 # # # ### ##### ####### # ####### # # ##### # ############### #
 # # # # #       #       #   #   # #   #     #   #   #       # #
 # # # # ### # # # ######### ### # ##### ####### # # # ##### ###
 # # #   #   # # #   #   # #   # # #   # #       # #   #   #   #
## # ####### # # ### # # # ### # # # # # # ####### ##### # ### #
   #       # # # #   # # #   # #   # #   #               #   # #
 ####### # # # ### ### # # ### ##### ##### ################### #
       # #   #   # #   # #   #     # #   # #     #         #   #
###### # ####### # ##### ### ##### # ### ### ### # ####### # # #
     #   #       #     # #   #   # #   #     #     #   # # # # #
 ####### # ########### # # ### # # ### ####### ####### # # # # #
         # #   #   # #   #     # # # #   #     #     #     # # #
######## # # # ### # ####### ##### # ### # # ### ### ### ### # #
   #     #   #     #       # # #   #   # # #   # # #   #     # #
## # ### ################# # # # ##### # ##### # # ### ### #####
   # #   #   #             #   # #   # #   #   #   # #   # #   #
 ### # ### # # ############### # # # # ### ####### # ### ### # #
 #   #     # # #   #           # # # # # #       #     #     # #
 # ######### # # # # ########### # # # # ####### ##### ####### #
 # #G        #   # #         #   # # #     #   # #     #   #   #
 # # ############# # ####### # ### # ##### # ### # ##### # # ###
 # # #   #   #       #   #   #     #       #   #   #   # # #   #
 # # # # ### # ##### # # ### ################# ##### # # # ### #
   #   # #   #     # # #   # #         #           # #   #   # #
## ##### # ### ### ### ### # # ##### # ########### # ####### # #
 # #   #   #     #     #   # # #     #     #   #   #     #   # #
 # # # ##### ### ####### ##### # ##### ### # # # ### ### # ### #
 #   #       #   #       #     # # #     #   #   #   # # # #   #
 ##### ##### # ########### ##### # # # # ######### ### # ### ###
       # #   #           # #   # #   # #             #   #   # #
######## # ### ######### # # ### ### # ##### ### ######### ### #
   #   # # #           #     #   #   #     #   #     #   #     #
## ### # # # # ### # ######### ########### # # ##### # # #######
   #   #   # # #   # #     #   #       # # # #     #   # #   # #
 ### # ##### # # ##### # # # ### ##### # # # ##### ##### # # # #
 #   #       # #       # # #   #   # #   # # #   # #     # #   #
 # ##### # ############# # ### ### # ##### # # ### # ### # ### #
   #     #           #   #   #   # #     # # # #   # #   # # # #
#### ### ############# ### ##### # # ### # # # # ### # ### # # #
   # #           #     #   #   # # #   #   # # #   # #   #   # #
 # # ######### # # ######### # # # # # ##### # ### # ### ##### #
 #   #   #     # #         # # # # # # #     #   # #   #     # #
 ##### # # ##### ######### # ### # ### # ### ### # ### # ##### #
 #   # # # #       #     # #   # #     # # #   # # # # # # #   #
 ### # # # # ### ### ##### ### # ####### # ### # # # # # # # ###
 #   # # # #   #   #       # # #   #   #   #   # #   # #   #   #
 # ### # # ### ### ######### # ### # # # ### ### ##### ####### #
   #   #   #     #           #     # #     #         #         #
################################################################
