################################################################
             #       # #     #           #       #   #   #   # #
## ######### ### ### # # ### # ### ### # # ####### # # # # # # #
   # #     #     #   # # # # # #   #   #     #     #   #   #   #
 ### # ### ####### ### # # # # ############### ############### #
     # # #     #   # #   #   # #             #     #         # #
###### # ### ### ### # ####### # ########### ##### # ### ##### #
 #     #   # #   #   #             #       # # #   # # #       #
 # ####### # # ### ### ######### # ####### # # # ### # #########
 # #       # # # #     #   #   # #       # #   # # #   #   #   #
 # ####### # # # # ##### # # # # # # ### # ##### # ### # # # ###
   #       #   #       # #   # # # # #   # #   # #   #   # #   #
 ### ##### ##### ##### # ##### # # # ##### # ### # # ##### # # #
   #   # #   #     #   #     # # # #     #   #   # #   #   # # #
## ### # ### # # # ########### # # ##### # ### ####### # ### ###
 #   # # #   # # #             # # #   #   #   #   #       #   #
 ### # # # ### # ############### # # # ##### ### # ####### ### #
 #   #   #   # #           #     # # # #   #     #   #   #   # #
 # ####### # # ########### # ####### # # # ######### # ##### # #
 #S#     # #   #     #   # #     #   #   #         #   #     # #
 # ##### # ##### ### # # # # ### # ############### ##### ##### #
           #     # # # #   # #   #     #       # #   #   #     #
 ########### ##### # # ##### # ####### ####### # # ### ####### #
       #     #     # # #     #       #     #   # #     #       #
 ##### # ##### ### # # ### # ############# ### # ####### #######
     # # #   # #   # #   # # # #     #   #  G# #   #   # #     #
 ### # # # # ### ### # # ### # # ### # # ### # # # # # # ##### #
   # # #   #   # #   # #   #   #   #   #   # # # # # #   #     #
## # ######### # # ##### # ####### ######### # # # # ##### #####
   # #   #     # #     # #       # #     #   #   # #   #       #
 ##### ### ##### ##### # ####### # # ### # ### ####### # ##### #
     #   #   #   #     # #     #   # #   # #   #       #     # #
#### ### ### # ### ##### ##### ##### # ### # # # ######### # # #
   # #   #   # #   # #         #   # # # # # #           # # # #
## # # ### ### # ### # ########### # # # # ############# # # # #
         #   # #   # #     #       # #   #         #     # # # #
 ####### ### # ### # ### # # ####### ############# # ##### # # #
 #       # #   #   #   # # # # #           #     # #   #   # # #
 # ##### # ### # ##### # # # # # ########### ### # ### # ### ###
 #     #     # # #   #   #       #           #   #   # #   #   #
 ##### ##### # ### # ############# ########### ##### # # ##### #
 #   #     # # #   #         #     #         #   #         #   #
## # ##### # # # ########### # ##### # ######### # ####### #####
   #   #   #   #   #   #   # # #     # #       #   #     #     #
 ##### ####### ### ### # ### # # ##### # ##### ##### ### # ### #
 #     #     #   # #   #     # # #   # # #   #         # #   # #
 # ##### ### # # # # # ####### # # # ### # ############# ### # #
 #     # #   # #     #   #     #   # #     #       #   #   # # #
 ##### # ##### ### ##### # ######### # ##### ##### # # ### ### #
 #   # #       #   #   # #             #     #   #   #     #   #
 # # # ######### # # # # ##### ##### ######### # ########### # #
 # #   #   #     # # #   #   # #   #     #     #     #     # # #
 ####### ### ### ### ### # # # # # ### # ##### # ### # ### # # #
       #     #   #   # #   #   # #   # # #     # #   # # #   # #
###### ####### ### ### ####### # ### ### # ####### # # # ##### #
   #   #       #   #           #   #     #       # # #   #   # #
 # # ####### # # ### # ####### ### # ########### # # ##### ### #
 # #       # # # #   #       #   # # #         # # #     #     #
 # ####### # ### # # ########### # ### ####### ### ##### ##### #
 #   #   # # #   # #       #     # #   # #   #   # #   #   #   #
 ### # # # ### ### ##### # # ##### # ### # # ### # # # ### ### #
   # # # # #   #   # #   # #     #   #   # #   # # # #   # #   #
## ### # # # ### ### # ######### ##### ### ### # # # ### # # # #
       #     #       #         #         #   #   #   #   #   # #
