################################################################
################################################################
             #   #   #                             #         # #
## # ####### # ### # # ######### # # ######### # # # ####### # #
   # #     # #   # # #   #     # # #     #     # #   #     # # #
 ##### ### # ### # ##### # ### ### ####### ### # ##### ##### # #
 # #   # # #             #   #     #   #   # # # #     #     # #
 # # ### # ####### ######### ####### # # ### # # # ####### ### #
   #   # #         #     # #   #     # #   #   #   #     #     #
 ##### # ######### # ### # ### # ##### # # ######### ### ##### #
     # # # #   #   # #   # #   #   #   # # #     #   # #       #
#### # # # # # ### # ### # # # ##### ### # # # # # ### ####### #
   # # # # # #     #   # # # # #     #   #   # # #S#   #   #   #
 # # # # # # ### ##### # # # ### ############# ### # ### ### ###
 #   #   # # #   #     # #   #   #     #     #   # #           #
 ######### # ##### ##### ##### ##### # # ### ### # ########### #
   #     # # #     #   #   #   #   # # #   #     #   #     #   #
## # ### # # # ##### ##### # ### # ### ### ##### ### # ### # ###
   # # # #   # # #   #     # #   # #   #   #       #   #   #   #
 # # # # ### # # # # # ##### # ### # ### ### # # # ########### #
 # # # #   # # # # #       #   # # #     #   # # # #   #     # #
 # # # ### ### # # ####### ##### # ########### # # ### # ### # #
 # #   # #     # # #     #     # # #     #     # #     # # # # #
 ####### ####### # # ### ### # # # # ### # ##### ####### # # # #
         #   #     # # # #   #   # #   # # #   #       #   # # #
## # # ### # # ##### # # # ### ### ### # # ### ### ### ##### # #
   # #     # # #   #   # #   # #   #   # #     #   # #   #   # #
 ### ######### # # ### # ### # # ### ########### ### # # # ### #
 # #   #       # #   # # #   # # #     #   #     # #   # # #   #
 # ### # ####### ### # # ####### ##### # # ##### # ### ### # ###
G#     #       #   #   #         #   #   #       #     #   #   #
 ########### ##### ############### # ################# # ##### #
       #   # #     #   #       #   #   #     #         # #     #
 ##### # # # # ##### ### # ### # ##### # ### ##### # ### ##### #
     # # # # #         # #   # #     # #   # #   # #   #     # #
###### # ### # ### # # # ### # ##### # ##### # # ########### # #
       # #   #   # # #   # # #   #   #       # #       #     # #
 ####### # ##### # ### ### # ##### ########### ####### # ##### #
   #   # #     # #   #     #       #   #       # #   #   #   # #
 # # # # ##### ##### # # ############# # ####### # # ##### # # #
 #   # # #   #   #   # #     #         #           #     # # # #
 ##### # # # ### # ### ##### # ##### ##### ######### ### # # # #
     # # # #   #   # # #   # # #   #       #   #     #   # #   #
 ##### # # ### ##### # # ### # # # ##### ### # # ##### ### #####
   #   # # # # #     # # #   #   #     # #   # # #         #   #
## # ### # # # # ##### # # ### ####### ### ### # ####### ### # #
   #   # # #   #   #   #   #         #   #   # #       #     # #
 ##### # # # ##### # # ##### ####### ### ### # ### ### #########
 #   # # # # #   #   #         #   # #   #   #   # # #     #   #
 # # # # # # # # ##### ####### # # # # ### ##### # # ##### # # #
   # #   # # # #     #       # # # # #   #   #   #   #   #   # #
#### ####### # ##### ######### # # # ### ### # ### ### # # ### #
 #           #     #     #     # #   #     # # #     # # #   # #
 # # # ########### ##### # ##### ### # ##### # ####### # # ### #
   # #     #   #   #   # # #     #   #       # #   #   # # #   #
#### ##### # ### ### # # # # ### # ########### # # # ### ### ###
         # # #   #   # #   #   # #   #   #   #   #     #   #   #
######## # # # ####### ####### # ##### # ### ############# #####
     #   #   # #       #       #   #   #     # #     #   # #   #
 ### # # ##### # ####### # ####### # ######### # ##### # # # # #
 #   # # # #   # #       # #     # # #     #   # #   # # #   # #
 ##### # # # ### # ####### # ### # # # ##### # # # # # # ##### #
       #   #     #       #   #   #           # #   #   #       #
################################################################
