################################################################
         #   #       #     #                       #           #
 ######### # # ### ### ### ####################### # # ##### # #
   #   #   # #   #   # # #     #     #   #       #   # #   # # #
 # # # # ### ### ### # # ##### # ### # # # ##### ####### # ### #
 #   #   # #     # # # #   #   #   # # # # #   #         #   # #
 ######### ####### # ### # # ##### # # # ### # ############# # #
   #             # #   # #   #     #   # #   # # #         # # #
## # ####### # ### ### # ############### # ### # # # ### # # # #
   #   #   # #     # #   #             # #   # # # #   # # #   #
 ##### # ### # ##### ##### ####### ### # ### # # # ### # ##### #
 #     #   # #             #     #   # #     # #   # # #   #   #
 ### ##### # ### # ############# ### # ####### # ### # ### # ###
   # #     # # # #               #   # # #   # # # # # #   # # #
## # # ##### # # # ##### ### ##### ### # # # # # # # # ##### # #
 # # #       #   #     # #   #     #     # #   # #   #       # #
 # # ####### ########### ### # ########### ##### # ########### #
   # #S    # #         #   # #           # #     #         #   #
 ### # ### ### ####### ### # ########### # # ############# ### #
     #   # #   #   #   #   #     #     #   #   #     #      G# #
#### ##### # ##### # ### ##### # ##### ####### # ### ####### # #
     #   # #     # # # # # #   #       #   #   # # #     #   # #
#### # # # ##### # # # # # # ### ####### ### ### # ##### ### # #
   # # # # #     # # # # # # # #       #     # #   #   #   #   #
 # # # # # # ##### # # # # # # ### # # # ##### ####### ### # ###
 #   # #   # #   #   #   #   #   # # # # #     #       #   #   #
#### # ##### ### ############### # # # # # # ### # ##### ### # #
   # #   # # #   #       # #   # # # #     #     #     # # # # #
 # # ### # # # # # ##### # # # # # # ##### ########### # # # # #
 # #   #   #   # # # #   #   #     # #   #           #   #   # #
 # ### ### ##### # # # # ############# # ##### # ######### ### #
 #           #   # # # # #     #     # #     # #         # # # #
 ########### # ### # # ### ### # ### # ##### # # ### ### # # # #
 #                   #     # #   # #   #     # #   #   #   #   #
 # ########### ############# ##### ##### ##### ####### #########
 #         #   #     #     # #         # #     #     #     #   #
 ########### ### ### ##### # ### ### ### # # ### ######### # # #
     #     #       # #     #     #   #   # # #   #       #   # #
 ### # ### ##### ### # ########### ### ##### ### # ##### ##### #
 #   #   #     # #   #       #     #   #   #   # #   #         #
## ########### # # ######### ### ### ### # ### # ### # #########
   #   #       # # #     # #   #   #   # #     #     #   #     #
 ### # # ####### # ### # # ### ### ### # ##### ######### # ### #
 #   #   #       #   # #     #     # # # #     #   #     # # # #
 # ############# ### # ########### # # # ####### # ##### # # # #
 # #           # #   #         # # # # # #     # #   #   # # # #
 # # ######### ### ##### ##### # # # # # # ### # ### # # # # # #
 #   #   #   # #   #     #   #   #   # #     #   #   # # #   # #
 ####### # ### # ####### # # ####### # ##### ##### ### # ##### #
             # # #     # # #       # # #   # # #   # # #     # #
 ##### ##### # # ### # # # ####### # # # # # # # ### # ##### # #
 #   # #     # #   # #   #   #   #   # # # #   #   # # #   # # #
 # # # ####### ### # ####### # # ##### # # ####### # # # # ### #
 # #   #     #     #     #   # # #   #   # #     # #   # #   # #
 ### ### ### ####### ### # ##### # # ##### # ### # ##### ### # #
   # #   #         #   # # # #   # #   #   #   #   #     #   # #
## ### ### ####### # # ### # # ### ### # ### # ##### ##### ### #
   #   # #   #   #   #       # #   #   #   # #     # #     #   #
 # # ### ### # # ######### ### # ### ##### ##### # # # # ### ###
 # #   # #   # #         #   # #   #   #   #   # # # # # #   # #
 ##### # # ### ######### ### # ### ### # ### # ### # # ### ### #
       # # #   #   #   # #   # #   #   #   # #   # # # #   #   #
 ####### # # ### ### # # # ### ##### ##### ##### # # # # ### ###
         #     #     #   #               #       #   #         #
