################################################################
#   #   #   #   #   #   #     #     #       #     #   # #   #   
# ### # # # # # # ### # # ##### ##### ##### ### # # # # # ### # 
#   # #   #   # #   # # #           #     # #   # # #         # 
# # # ##### ### ### # # ##### ##### ##### ### ### # # ######### 
# # # #   # #     # # #       #   #     #     # #   # #       # 
# ### # # ### ##### # ####### # # ### # ####### ##### # ##### # 
#     # #   #   #   #   #   # # #   # # # #   #       # #   # # 
# ##### ### # ### ##### # # # # ### # # # # ##### # ### ### # # 
# #       # # #       # # # # # #   # #   #   #   #   #   #   # 
# # ####### ### ##### # # # # # # ####### ### # # ### ### # ### 
#   #     # #   #   # # # #   # #     # #   # # #   # # # # #   
# ### ### # # ### # ### # ### # ##### # ### # ##### # # # # # # 
#   # # # #   #   # #   # #   #S  #   #   # #       #   # #   # 
### # # # ##### ### # ### ### ### ##### ### ####### ##### ##### 
# # # # #       #   # #     #   #     #             #     #     
# # # # ############# # # # ### ##### ### ### ####### ##### ####
#   #   #         #   # # #   #   # #   # #   #     # #     #   
# ##### # ####### ### # ##### # # # ### # # ### ### # # # ##### 
#     #   # #   #     #     # # #   # # # #     #   # # #       
##### ##### # ######### ##### # # ### # ######### ### ##########
#   #       #   #     #   #   # #   # #           # #           
# # # ######### # ##### # # ### # # # ############# ########### 
# # #       # # # #     # # #   # # # #         #       #   #   
# # # ##### # # # # ### ### ##### ### # ##### # # ### # # # # # 
# # # #     # # #   #   #   #   # #   # #   # #   #   #  G# # # 
### # # ##### # ##### ### ### # # # ### ### ### ### ### ##### # 
#     #       # #   # # #   # # #         #   #   # #     #   # 
# ### ####### # # # # # ### # # ### # ### ### ##### ### ### ### 
#   #   #   # #   # #     #   #   # #   #   #     #   # #   #   
# # # # # # ####### ############# # ####### ##### ### # # ######
# # # # # # #     # #       #     #       #   #       # # #     
# # ### # # # ### # # ##### # ########### ### ######### # # ### 
# #   # # #   #   #   # #   # #     #   # # #     #     #   # # 
# ### # # ##### ####### # ### # ### # ### # ##### # ######### # 
# #   # # #   #         #     # #   #     #       # #       #   
# ####### # ####### ########### ################### # # ### ####
#   #       #       #           #     #   #       #   #   # #   
# # # ####### ####### ####### # # ### # ### ##### ####### # ### 
# #   # #   # #   #   # #     # # #   #     #   #   #   # #     
# ##### # # ### # # ### # ####### ############# ### # # # # ####
#       # # #   # # # # #     #   #       #   #   # # #   #     
### ##### # # ### # # # ##### # ### ##### # # ### # # ######### 
#   #     #   # # # # #       #   # #   #   #     #   #       # 
# ### ######### # # # ########### # # # ######### ##### ##### # 
#   # #         #   # #         #   # # #       # #   # #   #   
### # ##### ### ##### ##### ######### # # ####### # # # ### ### 
#   #       # # #   #       #     #   #       #   # # #   # #   
# ########### # # # ####### # ##### ##### ##### ##### ### # ### 
#   # #   #     # #     #   #       #     #     # #     # # #   
### # # # # ##### ####### ########### ### # ##### # ### # # # # 
# # # # # # #   #       #             #   #   # #   # # # #   # 
# # # # ### # # ####### ### ########### # ### # ##### # # ##### 
#         # # #     #   #   #           # # # # #       #   # # 
### ##### # # ##### # ### ### ##### ##### # # # # ######### # # 
#   #     #   #   # #   # #   #     #   #   #             # # # 
##### ### ##### # # ### # # ### ##### # ### # ########### # # # 
#   # # #   #   # #   #   # #   #   # # #   # #       #   # #   
# # # # # ### ####### ##### # ### # # # # # # # ##### ##### ### 
# # #   # #     #   #   #   #   # #   # # #   #   # #       #   
### ##### # ##### # ### # ####### ##### # ### ### # ########### 
#   #     #   #   #   #   #     # # #   # #   # #   # #     #   
# ### ### ### # ######### # ### # # # ##### # # ##### # ##### # 
#     #                   #   #   #         #                 # 
