################################################################
################################################################
     #         #             #     #     #             #   #   #
## ### # ### ### ########### # ### # # # # ########### # # ### #
   #   #   #     #     #     # # # # # #     #     #   # #     #
 # # ##### ### ### # # # ##### # # # # ##### # ### ##### #######
 #       #   #   # # # # #   # # # # #     # #   #   #   #     #
######## ### # # # # ### # # # # # # ##### ##### ### # ### ### #
       # # # # # # # #   # #   # #   #   # #       #       #   #
 ##### # # # # # # ### # # ##### ####### # # ################# #
 #   # # #   # #   #   # #         #     # #     #       #   # #
 # ### # ######### # ############# ### # ####### # ##### # # ###
 # #   # #       # #           #   #   #         #     #   #   #
 # # ### # ##### ############# # ### ##### # ### ##### ####### #
   #     #   # #   #     #     #   # #   # # #     # #   #   # #
######## ### # ### # ### ##### ### # # # # ### ### # ### # # # #
     #     # #     # # #   #     #   # #   #   # #   #   # #   #
 ### # ##### ####### # ### ######### # ##### ### # ### ### #####
 #   #   #   # #     #           #   # # #   #     #   # # #   #
 ####### # ### # ############### # # # # # ####### # ### # ### #
       # # #   #   #         # #   # # # #     #     #   #   # #
###### # # # ##### # ####### # # ##### # ##### # ### # ##### # #
     #     # #   # # #   #   #   #   #     #   # #   #       # #
 ### ##### # # # # # # # # ##### # # ####### ### # ########### #
   #   #     # #   # # #   #     # # #       #   #             #
 # ### # # ### ### # # ######### # ### # ##### ############### #
 #   #   # #   # # # #     #S  # #   # # #   #   #   #       # #
 ### ##### # ### # # ##### # # # ### # ### # ### # ### ##### # #
   #   #   #   #   #     # # # #   #   #   #     #   # #   #   #
######## ##### ######### # # # # # ##### ########### # # # ### #
     #   #   #         # #   # # #     #           # #   # #   #
 ### # ### ########### # ##### # ##### ######### ### ##### ### #
 # # #       #   #   # #   # # #     # #   #   #     #   #   # #
 # # ####### # # # # # ### # # ### # # ### # # ######### ### # #
 # #     # # # # # # # #   #   #   # #   #   #     #       # # #
 # ##### # # # # # # # # ####### ####### ### ####### ### ### # #
 # #     #   # #   # # # #             #   #         #   #   # #
 # # ####### # ##### # # # ### ####### ### ######### # # # #####
 #     #     #   # # #   # #   #   #   # #       #   # # #     #
 ##### # ### ### # # ####### ### # # ### ####### ##### # ##### #
 #   #   #   # #   # #   #   #   # # #       #   #   # #   # # #
 # # # ### # # ### ### ### # # ### # ####### # ### # # ### # # #
   # # #   #         #     # #   # #   #   # # #   # # #   # # #
 ### ### ##### # ### ####### ### ##### # # # # ##### # # ### # #
   #   #     # # #           # #   #   # # # #       # #     # #
 ##### ####### # # ### ##### # ### # ##### # ########### ##### #
 #         #   # # # # #         #   # #   #       #   # #   # #
## ######### ### # # # ##### ######### # ### ####### # # # # # #
   #   #G  # # # #   #     # #           #       #   #   # #   #
 ### # # # # # # ######### # # # ##### ### ##### # ####### ### #
 #   #   # #   #         # # # #     #         #         # #   #
 # ####### ####### # ### # # # ##### # ####### ######### # # ###
     #   #   #   # # #   # # # # #   # #   #   #       # # #   #
#### # # # # # # # # # ### ### # # ##### # ##### ##### # # #####
   # # #   # # # # # #   #   #   #       # #   # #   # # #     #
 # ### ##### # # # ######### ### ##### ### # # # # ### # ##### #
 #     # #   # # #       #     # #   # # #   #     #   #   #   #
 ####### # # # # ####### # ##### # # # # ########### ### ### ###
   #   # # # # #       # #       # # # # # #   #   # # # #   # #
## # # # # ### ######### ######### # # # # # ### # # # # # ### #
 # # #   # #   #   #   #     #     # #       #   #   #   #     #
 # # ##### # ### # # # ##### # ##### ######### ######### #######
   #       #     #   #       #     #           #               #
################################################################
