################################################################
#           #       #   #   #   #   #         #   #   #     #   
### ######### ####### # ### ### # ### ######### # # # ### ### # 
#   #           #     #   # #     #   #         # # #   # #   # 
# ### ######### # ####### # # ##### ### ########### ### # # ### 
#       #     # #   #     #           #     #   #   #   #   #   
# ####### ### ##### # ##### ######### ##### # # # ########### ##
# #     # # #       # #     #   #   #     # # # # #     #       
# # ### # # ######### ### ### # # # ####### # # # ### # ### ### 
# #   #   #   #   # #     #   #   #         # # #     # #   #   
# ### ####### # # # ##### # ################# ######### # ### # 
#   #   #     # #   #   # #     #       #   #       #   # #   # 
# # ### ### ### ##### ### ##### # ##### ### # # ##### ##### ### 
# # # #   #   #     #   # #     #     #       #   #   #     #   
# # # ### ### ##### ### # # ##### ### ########### # ######### # 
# # #   #   #           # # #     #   #         # # #       # # 
# # # ##### ####### ### # # ##### ##### ####### # # # ##### ### 
# # # #   #     #   #           # #   #   #   # # # #   #       
# # # # ### ### # ### # ####### # # # # ### # # # # ### ####### 
# #   #   #   # #   # # #     # # # # # #   #   # #   # #   #   
# ### ### ### # # # # ### ### # # # # # # ########### # # # # # 
# #   #   #   # # # #   # # # #     #   #     #     # #   # # # 
### ### ####### # # ### # # # ### ########### # # ### ####### # 
#     #     #   # # #   #   #   # #   #     #   # #   #     # # 
# ######### # ##### # ######### # # # # ### ##### # ### ### ### 
#         #   #     #       #   # # # # #     # #G#   #   #   # 
# ####### ##### # ##### ##### ### # # ### ### # # ### ### ### # 
#   # #   #     # #     #     # #   #     # # # #     # #   # # 
### # # ####### ### ### # ##### ########### # # ####### ##### # 
#     # #       #   # # #   #               # # #   #       # # 
# ##### ######### ### # ### ##### # ### ##### # # # # ##### # # 
#   #   #         # #     #     # #   # #         #       #   # 
### # ### ######### ##### ##### ####### # ############### ##### 
#   # #   #     #             #       # # #     #       #       
# ##### ### ### # ########### ####### # # # ### # ##### ####### 
#       # #   #   #         #     # # #   # #   # #   #     #   
######### ### ############# ### # # # ### # ### # # # ##### # # 
#       #   #               #   #   #   # #   #   # # # #   # # 
# ### # ### ################# ### ##### # ### ####### # # ### # 
# #   #     #           #   #   #     # #   # #   #     # #   # 
# ########### ####### ### # ### # ### # ### # ### # ### # ##### 
#   #         #     # #   #     #   # #   # #     #   # #   # # 
### # ##### ### ### # # ########### # ### # ####### # ##### # # 
#   # #   #   #   # # #       #     #   # #       # #     # #   
# ### # # ######### ######### # ##### ### ####### # ##### # ### 
#     # # #         #   #     #   #   #   #       #     # # #   
# ##### # # ######### ### ##### # ### # ######### ### ### # # ##
#       # # #       #     #     #   # #       #     # #   # # # 
# ####### # # ### # ####### ####### # ####### # # # # # ### # # 
# #     # # #   # #     #   #   #   #   #   #S  # #   #   # #   
# # ### ### ### # ##### # ##### # ### # # # ##### ####### # # ##
# # # # #   #   # # #   #       # #   # # # #   #       #   #   
# # # # # ##### # # # ########### # ### ### ### ####### ########
#   #   # #   # # #           #   #   #   # #   #     #         
##### ### # # # # ########### # ####### # # # ##### # ######### 
#   # #   # # # #   # #     # #       # #   #     # #   #       
# # # # ### # ##### # # ### # ####### # ######### # # ### ##### 
# # # # #   #     # # # # #   #       #         #   # #   #   # 
# # # # ### ##### # # # # ##### ####### ####### # ##### ### # # 
# #   #     #   # # # #         #   #   #     # # #     #   # # 
# ########### # # # # ########### # # ### ### # # # ##### ### ##
#           # # #   # #         # # # #   # # #   #         #   
##### # ### # # ##### ####### # # # # # ### # ################# 
#     #   #   #               #   #   #     #                   
