################################################################
# #       #   #         #       # #     #     #   #         #   
# # ##### # # # # ##### # ##### # # ### # ### # # ### # ### # ##
#   #   #   # # # #   # #   # # # # #   #   # # #   # # #   #   
##### # ##### # # # # ##### # # # # # ####### # ### ### # ### # 
#   # #         #   #     #   # #   #   #     #   #   # #   # # 
# ### ####### ##### ########### ####### ### ##### ### ##### # ##
# #   #     # #   # #           #     #   #   #   # # #   # #   
# # ### ### ### # # # ########### ### ### ### # ### # # # # # # 
#   #   # # #   # # # #       #   # #   # # #   #   #   # # # # 
# ### ### # # ### # # # # ##### ### ### # # ##### ####### # # # 
#   #     #     # # # # # #     #   # #   #   #       #       # 
### ##### ####### ### # ### ####### # ##### # # ##### # ########
# #             # #   #     # #   #   #     # # #   # # #   #   
# # ##### ##### # # ### ##### # # ### # ##### # ### # # # # # # 
#   #   #   #   #     #     #   #   #   #   #       #   # #   # 
##### # ### # ####### ##### ####### # ### # ############# ##### 
#     #     #       #       #             #       #     #   # # 
# ##### ########### # ####### ########### ####### # ### ### # # 
#   #   #     #     #         #   #     #   #   #   # # #   # # 
##### ### ### ######### # # ### ### ### # # # ##### # # # ### # 
#   #   # #   #       # # #     #     # # #S  #   #   #   #   # 
# # ### # ##### ##### # # ####### ##### # ##### # ####### # ### 
# #     #     #   #   # #         #     #   #   #   #   # #   # 
# ##### ### ##### # ##### ######### ##### ### ##### # # # ### # 
# #   #     #   # #     # #       #   #   #   #   #   # #     # 
# # ####### # # # ##### # # # ### ### # # # ### ####### ####### 
#   #     # # # #     # #   #   #   # # # # #     #   #   #   # 
##### ### # # # ##### # ####### ##### ### # ##### # ##### # # # 
#   # # # # # # #     #       # #   #   # # #   #   #   # # # # 
# # # # # # # ### ########### ### # # # ### # # ### # # # ### # 
# #   #   # #   # #     #     #   # # #   # # #       # #     # 
# ######### ### # # ### # ### # ### ##### # # ##### ########### 
#   #   #   #   #   # # # #   #   # #     # #   #   #     #   # 
### # # # ### ####### # # ####### # # ##### ### # ### ### # # # 
#   # # #     #         # #       # #     # #   # #   # # # #   
# ### # ##### # ######### # ####### ##### # ##### # ### # # ####
#     # #   # #       # #   #       #     # #   # #   # # #     
####### # # # ####### # ##### ############# # # # ### # # ##### 
#     # # # #   #   # #     #     #         # # #   # # #     # 
# # ### # # ### ### # ##### ##### # ########### # ### # ##### ##
# # #   # #   #     #     #     # # #         # # #   #   # #   
### # ### ### ##### ##### # ### # # # ####### # # # ##### # ### 
#   #   #   #   #       # # #   #     #     #     #       # #   
# ##### ### ### ### ##### # # ######### ### ############### # ##
#     # #   # #     #     # #       #     # #     #           # 
# ### # # ### ##### # ##### ######### ##### # ### # ########### 
#   # # # # #       #   #   #       # #     # # # # #     #     
# # ### # # # ######### # ### ##### # # ##### # # # ### # ### # 
# # #   #   #       # # # #   #   #   # #       # # #   #   # # 
# # # ############# # # # # ##### ####### ####### # # ##### # # 
# # #         #   #   #   #   #  G#   #   #   #   # # # #   # # 
# ### ####### # # # ##### ### # ##### # ### # # ### # # # ### # 
# #   #     # # #   #   #   # #       #   # # #     # #       # 
# # ### ### # # ##### # ### # ### ####### ### ####### ######### 
# # # #   # #   #     #     #     #     #         #     #     # 
# # # ### # ##### ############# ### ### ######### ##### # ##### 
#   #   # #   #   #           # #   # #   #     # #     #     # 
# ### # # ### # ####### ##### # # ### ### # ### # # ######### # 
#     # # # #   #     #   #   # #     # #   # # #   #   #     # 
####### # # ##### ### ##### ### ####### ##### # ##### ### ##### 
# #     #   #     # #     #   #   #   # #     #   #       #   # 
# # ####### ##### # ##### ### ### # # # # ####### # ####### # # 
#                 #                 #                       #   
