################################################################
# #   #   #     #           #         #         #         # #   
# # # # ### ### ##### ####### ######### # ####### ##### # # # # 
#   # #   #   # #   #   #     #   #     #       # #     # #   # 
# ####### ### # # # ### # ##### # # ########### # # ##### ##### 
#             #   #     #   #   # #  G  #     #   #   #     #   
######### ####### ##### ### ### # ##### ##### ####### ### ### ##
#     #   #   #   #   #   # #   # #   #         #   #   #   # # 
# ### # # # # ##### # ### # # ### # # ######### # # ### ### # # 
#   # # # # #       #   # #   # # # #         # # #   #   #     
### ### # # # ######### # ##### # # ########### # ### ### ######
# # #   # # # #       #     # #     #    S  #   # #     #   #   
# # # ### # ### ##### ##### # # ##### ##### # ### ######### # # 
#   #   # #   # #     #   #   # #   # #     # #       #   #   # 
# ### # # ### # ####### # # ### # # # # ##### ##### ### ##### # 
# #   # # # # #   #     # # #   # # # # #   #   #   #   #   # # 
# ##### # # # ### ##### # # # ### # # # # # ### # ### ### # # # 
# #     #   #   #     # #       # #   # # # #   # #   # # # # # 
# # ### ############# # ####### # ##### # # # ### # ### # # ### 
# # # #       #       # #     #       #   # # # # #   # # #     
# # # # # ##### ####### # ### # ########### # # # ### # # ######
#   #   # #     #       #   #   #     #     # #   #   # #   #   
##### ##### ##### ######### ### # ### ####### ### # ### ### ### 
# #   #     #     #         #   # #         #       # #   #     
# # ### ######### # ####### # # # ######### ##### ### ### ######
# #   #   #   #   # #     # # # # #     # #         #         # 
# ### ### # # ##### # ##### # # # # ### # ### ##### ######### # 
# #   # #   #       #   #   # # #   #   #     #   # #     #     
# # # # ############### # ### # ##### ### # # # ### # ### ##### 
# # # # #   #     #   # #   # #     #   # # # #     #   #       
# # # # # # # # ### # # ### # ##### ### ### ################### 
#   # # # #   # #   # #     #   #     #   #         #         # 
##### # ### ##### ### ######### # ### ### ####### # # ####### # 
#     #   # #     #             # # #   #       # #   #     #   
# ####### # # ########### ##### # # ### ####### ### ####### ####
#   #     # #   #     #   #   # #   #     #   #   #       #   # 
# # # ##### ### # ### ##### # ######### # # ##### # # # ##### # 
# #   #   # #   # # #     # # #         # #       # # #     # # 
# ####### # # # # # ##### ### # ####### ############# # # ### # 
#   #   # # # # #       #     # #   #   #       #   # # #     # 
# # # # # # # ##### ####### ### # ### ### # ### # # # # ####### 
# #   #   # #   #   #     #   # # #   #   #   # # #   # #   # # 
# ######### ### # ### ### ##### # # ### ##### # # ##### ### # # 
#           # #   #   #       #   #   # #     # # #   #     #   
# # ##### # # ##### ######### ##### ### # ####### # # # ##### ##
# # #   # #       #     #   #           #     #   # # #     #   
# ### # ############### ### ####### ######### # ### # # ##### # 
#   # #   #           #     #     # #   #     # #   # #       # 
# # # ### # ##### # # ####### ### # ### # # ### # ### ######### 
# #   # #   #   # # #   #   #   # # #   # # #   # #   # #       
# ##### ####### # # ##### # ### # # # ### ### # # # ### # ##### 
#   #   #       # # #     # #   # #   #   #   # # #   #   #   # 
# # # ### # ##### # # ##### # ### ### # ### ##### ### ##### # # 
# #   #   # #   # # #     # # #   #   #   #     # #   #   # # # 
# ####### ### # # ####### # # # ### ##### ##### # # ### # # # # 
# #       #   #   #   #   # # #     #   # #     # #   # #   #   
# ####### # ####### # # ### # ##### # # ### ######### # ########
#         #   #     #   #   #     # # #   #           #     #   
# ########### # ################# # # ### ############# ### # ##
# #   #     #         #         # # # #   #       #     #   #   
# # # ### # ########### ####### # # # # ### ##### # ##### ##### 
# # #   # #     #     # #     # # # # #   # #   #   #     #     
# ##### ####### # ### # # ### # # # # ##### # # ### # ##### ####
#               #   #   #   #     #         # #     #           
