################################################################
################################################################
         #   #         #   #     #               #   # #       #
 ####### ### # ####### # # # # # # # ####### ### # # # # ##### #
     # #   # # #     #   # # # #   # #     # #   # # # #   # # #
#### # ### # # # ### # ##### # ##### # ### # # ### # # ### # # #
   #   # # #   #   #   #     #   #   # # # # # #   # # # # # # #
 # ### # # ##### ####### ####### ##### # # ### ##### # # # # # #
 # # # #   #   # #       #   # #     # # #   # #         #   # #
 # # # ##### # # # ######### # ##### # # ### # # ######### ### #
 # # #   #   #   # #     #   #     #       # #       #     #   #
## # ### # ####### ##### # ##### ######### # ##### ### ##### ###
     #   #   #   #   #           #       # #     # #       # # #
 ##### ##### # # ### ##### ##### # ##### ####### ### ####### # #
 #     #   # # #   #     # #     # # #   #     #     # #   # # #
 # ##### # # # ######### ### ### # # # ### ### # ##### # # # # #
 # #     #             #   # # # #   #     #   # #   #   # # # #
 # # ############# ####### # # # ### ####### ### ### ##### # # #
 # #       # #   #     #   # #   #   #     #   #   # #   #   # #
 # ####### # # # ##### # ##### ### ### ####### # # # # ####### #
 #       # # # # #   # #   #   #   #   #   #   # #   #   #     #
 ####### # # # # # # # ### # ### ### ### # ##### ####### # ### #
 #     # #   # #   # # #   #   #     #   #   #           #   # #
 # # # # ##### ##### # # ##### ##### # ##### # ##### # ##### # #
   # # #       #   # # #   #     #   #     # # #     #     # # #
 ### # ######### ### # ### ### # # ####### # ### ##### # # # # #
 #   #   # #     #   #         # #       # #   # #   # # #   # #
## ##### # # ##### ############# ####### # ### # # # ### ##### #
   #   # #   #   # #           #   #     # # # #   #   #   # # #
 ### ### # ### # # ### ####### ### # ##### # # ####### ### # # #
 #   #   # #   # #     #     #   # # #   # # # #   #   # # #   #
 # # # ### ### ######### ### ### # # # # # # # # ### ### # ### #
 # #     #   # #     #     #       #   #     # #     # #   #   #
## ##### ### # # ### ############# # ######### ####### ##### # #
   #   # #   # #   #             #   #         # #   #       # #
 # # # # # ### ### ############# ##### ######### # ### # # #####
 # # # #         # #     #   # # #     #   #     #     # # #   #
 # # # ### ####### # ##### # # # # ####### # ####### ### # # # #
 # # #   # #       #   #   #   #   #       #         #   # # # #
## # ### # # ####### # # ########### ########### # # # ##### ###
   # #   # # #     # #   #   #     #         #   # # #     #   #
 ### ####### # ### # ##### # # ### ######### # # # # ##### ### #
   #     #   #   #   # #   #   # # #           # # #     #   # #
## ##### # ##### ##### # ####### # ##### ######### ##### ### # #
       # # #           #   #     # #     #   #     #       #   #
 ##### # # # ######### ### # ##### # ### # # # ##### ##### #####
 # #   # # # #     #     #   #       #   # #   #   #     #     #
 # # ### # ### ### ### # ##### ####### ### ##### # ##### #######
   #     #     #   #   #       #     #   #   #   #     # #     #
######## ####### ### ####### ### ### ####### # ######### # ### #
       #       #   #   #   # #   # # #       # #   #   #   #   #
 ##### # ### ##### ### ### ### ### # # ####### # # # # ##### # #
 # #   # #   #   #   #     #   # # # #     #   # #   #       # #
 # # ##### # # # ### # ##### ### # # ##### # ### ############# #
 #       # # # #   # # #     #     # #     #   # # #   #       #
 ####### ### # ### # ### ##### ##### # # ##### # # # # # ##### #
   #   #         # #   #    G#   #   # # #   # # #   #   #     #
 # # # ######### ##### ####### # # ### ### # # # ########### # #
 #   #   #  S  #     #   #     #   #     # # #   #   #   #   # #
######## # ### ##### ### # ########### # ### ##### # # # # ### #
     #   #   #     #   #   #           #   #   #   #   # #   # #
 ### ####### ##### ### ########### # ##### ### # # ##### ### # #
   #         #                     #     #     # #     #     # #
################################################################
