################################################################
################################################################
#           #   #   #   #             #     #             #   # 
# ##### ### ### # # # # # ### # ### # # ### ### ##### ##### # # 
# #   #   #     # #   # #   # # #   # # # #   # #   # #     # # 
# # # # # ####### ##### ### # # ##### # # ### # # # # # ##### # 
#   # # #   #   #   # #   # # # #   # # #   # # # # #   #   # # 
# ### # # # # ##### # ### # # ### # ### # # # # # # # ### ### # 
# #   # # #   #   # #   # # # #   #   # # #     # # #   #     # 
# ##### # ##### # ### # # # # # ##### # ####### # # # # ####### 
# #   # #     # #     #     # # #     #     #   # # # # #       
# # # ####### # ############### # ######### # # ### # # # ######
# # #       #   #     #         #       #   # # #   # #         
# # ####### # ### # # # ################# ### # # ### ##### ####
# # # #   # #     # # # #       #         #   # #   # #   # #   
# # # # # # ####### ### ##### # # ######### ####### # # # ### # 
# #   # #   #       #   #   # # # #   #   # #       # # #     # 
# ### # ########### # ### # # ### # # ### # # ####### # ####### 
#   # #   # #   #   #     # #   # # #     #   # #     # #     # 
# ### ### # # # ########### # # # # ########### # ### # # ### ##
#     # # # # #           # # # # #   #   #   #   #   #   # #   
# ##### # # # ########### # # # # ### # ### # # ### ####### ### 
#   # # #   # #     #   # # # # #     #     # # #   #     #     
### # # ##### # ### # # ### # # ############# # # ### ### # ####
#   # #   #   # #     #   # # #   #       # #   # #   #   #   # 
# ### ### # ### ######### # # ##### ##### # ### # # ### ##### # 
#         #   # #         # #     #   #   #     #   # #       # 
# ########### # # ####### # ##### ### # ##### # ##### ######### 
# #             # #     # #     #   # #     # # #       #       
# # ######### ### # ### # ##### # ### ##### # # # # # # # # ####
# # #   #   # #   #   # #       # #   #     # #   # # # # # #   
# # # # ### # # ####### # ####### # ### ########### # # # # # # 
# #   #     # #   # #   #     #   # #   #       #   # #   #   # 
# ########### ### # # ### ### # ### ##### ### # # ### ######### 
# #           #   # # #     #   #   #   # #   #   #     #     # 
# # ### ##### # ### # # ### # ### ### # ### ####### # ### ##### 
# #   # #   # #     #   #   # #   #   #     #   #   #   #   #   
# ### ### # ########### ##### # ##### ####### # # ##### ### # ##
# #   #   #       #   # #   # # #     #   #   #   #   #   # # # 
# # ### ######### # # # # # ### ### ### # # ####### # ### # # # 
#   #   #     # # # #   # # #   #   # # # # #     # # #   #   # 
# ### ### ### # # # ### # # # ### ### # # # # ### ### # ####### 
# #   #   # # # #   #   # # #   # #   # # # #   #     #       # 
### ### ### # # ##### ### ##### # ### # # # ### ####### ### ### 
#   #   #   #     #   # # #   # # #   # #     # # #   #   #     
# ####### ### # # # ### # # ### # # # # ####### # # # # # ######
# #   #       # # #       #   #   # # #   #   # # # # # #       
### # ### ##### # ### ### ### ####### ### # # # # # # # ####### 
#   #   # #     #     #           #   #   # #   #   # #   #   # 
# ##### # # ########### # ####### # ### ### ######### # # # ### 
# # #   # #     #       # #           #     #   #   # # # #     
# # # ### ####### ####### # ##### ########### ### # # # # ######
# # # #   # #     #       # # #   #       #     # # #S# #       
# # # # ### # ##### ##### # # # # # # ### # ### # # # # # ##### 
# # # #     #   #   #   # #   # # # #   # # #   # # # # # #     
# # # # ####### ##### # ####### # # ### # # # ### # # ### # ####
#   # # #       #     #         # # #   # # # #   # #   # #     
### # ### ####### ######### ##### # # ##### ### ####### # ######
#   #   # #   #   #     #   #   # # #   #   #   #     # #       
# ##### # # ### ### # # # ### # # # ### # ### ### ### # # ##### 
#   #   #   #   #   # #   # # #   #   # # # #   # # # # # #     
### ######### ### ### ##### # ### ### ### # ### # # # # ### ### 
#             #     #       #   #                G#         #   
################################################################
