################################################################
#   #   #   #       #     #   #   #     # #   #       #         
# ### # ### # ##### # # ### ### # ##### # # # # ##### # ##### # 
#   # #   #   #   # # # #   #   # #     #   #   #     #     # # 
### # ### ##### # # # ### ### ### # ##### ####### ####### ### # 
#   #   # #   # #   #   # #   #   #   #     # #   #       #   # 
# ##### # ### # ####### # # ### ##### ##### # # ### ####### ### 
#   #  G#   # # #         #   #     #   #   #   # #S  #   #   # 
### # ##### # # ### ##### ### ### ##### # ####### ### # # ### ##
# #   #   # #       #   #   # # #   #   #           # # #   #   
# ##### ### ######### # ### # # ### # ### ##### ##### # # # ### 
#   #       #   #   # #   # # #   #   # #     #   #     # # #   
# # # ####### # # # ##### # # ### ##### # ### ### # ##### ### ##
# #           #   #   #     # # # # #   #   #   #   #   #   #   
# ################### ### ### # # # # ##### ### ##### # ### ### 
# # #         #     # #   #   #   #       # # #       #   #   # 
# # # ####### # ##### # # # ### ####### # # # ##### ##### # ### 
#   #   #     #       # # #   # #     # # #   #   # #   # # #   
# ##### # ########### # # ### # ### # # # ### # # # # # # # # # 
# #   # #           # # # # # #     # # # #   # # #   # # # # # 
# # ### ### ####### # ### # # ####### # # # ### # ####### # # ##
# # #   #   #     # #       #       # # # #   # #   #     # #   
# # # ##### # ### # # ############# # ### ### ##### # # ####### 
# #   #   # #   # # # #   #   #     #   #     #   #   # #     # 
# ##### # ### ### # # # # # # # ####### # ##### # ####### ### ##
# #   # #     #   #   # # # # #       # #       #           #   
### # # ####### ##### # # # # ####### # # ##################### 
#   #       #   #   # # # # #     # # #   #   #     #   #   #   
# ########### ### # # # # # ##### # # # ### # # ### # # # # # ##
# # #   #   #   # #   # #   #   #   # #     # # #   # #   # # # 
# # # ### # ### # ##### ##### # ##### # ####### # ### ##### # # 
# # #   # #     #       #     #       #       # #     #   # # # 
# # ### # ####### ####### ############# ##### # ####### # # # # 
# #   #   #     #       # #         #   #   # # #     # #   #   
# # ####### ### # ####### ##### ### ### # # ### # # ### ########
#         # # # # #     #     #   #   # # #     # #   #   #     
### ##### # # # # # ### ##### ### ### # # ####### ### ### # ### 
# # #   #     #   #   #     # # # # # # # #         #   #   #   
# # # # ############# ##### # # # # # # # # ########### ##### ##
#   # # #           # #   # # #   #   #   #   #             # # 
# ### # # ######### ### # # # ### ##### ##### # ####### # ### # 
#     #           #     #   #   # #           # #     # #   # # 
##### ########### ############# # # ### ####### # ### ##### # # 
#   #   #   #   #     #       # #   #   #       #   #     # # # 
# # ### # # # # ### # # ##### # ### ############### ##### # # # 
# #   #   #   #   # # # # #   # # # #     #     # # #   #   #   
# ### # ######### # # # # # ### # # # ### # ### # # ### ### ####
# #   #   #   #   # #     #   #     # # # #   #   #     #       
# ##### ### # # ############### ##### # # ### ########### # ### 
#           # # #             # #   #   #   #             #   # 
####### ##### # # ########### # # # ### ### ### ##### # # ##### 
#       #     # # #   #     # # # # #   # # #   #     # #   #   
# ##### # ##### # # ### ##### # # # # ### # # ### ### # # ### ##
#     # #     #   #     #     # # #   #   # #   # #   # # #   # 
##### ####### # ### ### # ##### # ##### ### # ### # ### # # ### 
#   #       # #       # #       # #     #   # #   # #   # #   # 
# ##### # # # ####### # ######### # # ### ##### # ### ### ### # 
# #   # # # #       # # #   #       # #   #     # #   #     # # 
# # # # # ######### # ### # # ######### ########### # ####### # 
#   #   #         # # #   # # #       # #         # # #     #   
######### ######### # # ### # # ##### # # ####### # ### ### ####
# #     #   # #     # # #   # # #   # #   #   #   #   # #   #   
# # ### # # # # ####### # ### # # # ####### # # ### # ### ##### 
#   #     #   #         #     #   #         #   #   #           
