################################################################
################################################################
     #       #   #       #       #             #     #   #     #
 ##### ##### # # ####### # ### ### ### ######### ### # ### #####
 # #   #   # # #   #         #     # #   #       # # # #   #   #
 # # ### ### # ### ####### # ### ### ### # ####### # # # ### # #
   #   #   # #   #       # #   #       #   #       # # # # # # #
 ##### ### # ### ####### # ### # ##### ##### ##### # # # # # ###
       #   #   #   #   # # #   #   #       #   #   # #     #   #
 ####### ######### # ### # ####### # ### # ##### ### # ####### #
             #   # #     # #   #   #   # #         # #       # #
#### ##### ### # # ####### # # ####### # ########### # ##### # #
   # #   # #   #   #         #     #   #         #   #     #   #
 ### # # ### ####### ### ######### ##### ####### # ####### #####
   # # # #             #         # #   #   #   # #   #   # #   #
## # # ### ### ####### ########### # # # ### # ##### # # # # # #
             # #     #   #       #   # # #   #     # # #   # # #
 ########### # # ### ### # ##### ##### # # ####### # # ##### # #
 #   #       #     #   #       # #     # #     # #   # #   # # #
## # # ####### ####### ######### # ##### ##### # ##### # # # ###
   #   #     #   #   #     #     #   #   #   # # #     # # #   #
 ####### ####### # # # ##### ####### # # # ### # # ##### # ### #
 #   #   #       # # # #     #       # # #     # #       #   # #
 ### # ##### # ### # ### ############# # ####### ########### # #
   # #   #   # #   #   #         #     #       #   #       # # #
## # ### # ### # ##### ### ##### ### ######### ### # ##### # # #
   # #   # # # # #   #   #     #   #   #     #   # #     # # # #
 ### # ### # # # ### ### ##### ### ### # ####### # # ### # # # #
 #         #   # #   #   #   #   # #   #      S  #     # # #   #
 # ############# # ### ### # ##### # ############# ### # ##### #
 # #     #   #   #     # # #   #   #                 # # #     #
 ### ### # # # ######### # ### # ### ####### ##### # # # # #####
     # #   # # #       # #   #   #         #     # # # # #   # #
###### ##### # # ##### # ### ########### # ##### # # ### ### # #
   #   #   #   #     #   #   #           #     # # #   #   # # #
 ### ### # ######### ##### ############# ##### # # ### # # # # #
 #   #   #         #   # #     #   #     #   # # # #   # # #   #
 # ####### ##### # ### # ##### # # ### ### # ### # ##### # ### #
   #   # # #   # #       #   #   #   # #   #     #   #   #   # #
 ### # # # # # ####### ### ######### # # ########### ### # ### #
   # # #   # #       #     #   #     # #           #   # #     #
## # # # ### ####### ####### # # ################# # # # #######
   # #   #   #     #   #   # # #   #     #         # # #       #
 ####### # ####### ### # # # ##### # ### # ########### # ##### #
         # #     # # #   # # #   # #   # # # #         #     # #
######## # ##### # # ##### # # # # ### # # # # ### # ##### # # #
  G    # #     # #     #   #   # #   # #   #   #   # # #   # # #
 ##### # ### ### ##### # ####### ### # ######### ### # # ### # #
 #   # #   # #   #   # #   #   #     # #   #     #   # # #   # #
 ### # # ### # ### # # ### # # ####### # # ##### # ### # # # # #
   # # # #   # #   # #   #   #         # #   #   # #   # # # # #
## # # # # ### # ### ### ### # ######### ### ### # ### # ### # #
   #   # #     #   #         #       #   #     # #   #   #   # #
 ##### # ######### ##### # # ####### # # ##### # ### ##### ### #
 #   #             # #   # #   # #   # #   # # #   #     # #   #
## # ##### ######### # # # ### # # ### ### # # ##### ### ### ###
   # #   # #   #     # # # #   # #   #   # # #     #   # #   # #
 ### # # # ### # ##### ### # ### ### ### # # ##### ##### # ### #
   #   # #   # # #     #   #   #   #   # #   #       #   #   # #
 # ##### ### # # # ##### ##### ### ### # ########### # ##### # #
 #   # #   # # # #   #   #   #   # #   # #         #   #     # #
 ### # ### # # # ### # ##### # ### # ##### ####### ##### # ### #
   #   #     #       #       #     #       #       #     #     #
################################################################
