################################################################
################################################################
#   #  G                      # #                     #       # 
# # ##### ##### ####### ##### # # ####### # ### # ##### ##### # 
# #   #   #     #       #   # # #   #   # #   # #     #     # # 
# ### ##### ### # ####### # # # # ### ### ### # ##### ##### # # 
#   #       #   #     #   # # #     #     # # #     #       # # 
# ########### ######### ### # ### # ####### # ##### ######### # 
# #   #     # #   #   # #   #   # # #   # #   #   # #       # # 
# # # # ### ### # # # # # ##### # ### # # ##### ### # ##### # # 
# # # # # #   # #   # # #         #   # #           #   # # # # 
# # # # # ### # ##### ### ##### # # ### ##### ######### # # # # 
# # #   #   # #   # # #   #   # # # # #     # #       # # # #   
# # ####### # ### # # # ### # # # # # ##### ### ### ### # # ### 
# # #       #   #   # #     # # #   # #   #       #       #   # 
# # ##### # ### ##### # ##### ### ### # # ################# # # 
# # #     #   #       #     #   #     # # #       #   #   # # # 
### # ##### ########### ### ### ##### # # # ##### # # # # ### # 
#   #   # # #       #   #   #   #   # # #   #   #   #   #     # 
# ##### # # # ##### # # # ### ### # ### ### # # ############### 
# #     #         # # # #   #     #   # #   # #     #     #   # 
# # ############# # # # ### ######### # ### # ##### # ### # ### 
# #   #     #   # #   #   # #     # # #   # #   # # # #   # #   
# ### # ### # # # ####### ### ### # # ### # ### # # # # ### # ##
# # # # #   # # #     # #     #   #   #   #   # # #   # # # #   
# # # # # ##### # ### # ####### ############# # # # ### # # ### 
# #   # #         #   #     # #   #         # # # #   # #   #   
# ##### # ### ##### ####### # ### # ####### ### # ##### # ### # 
#       #   #   # # #     # #   #   #     #   # #       # #   # 
######### # ### # # # ### # ### ######### ### # ######### # ### 
#         #   # #   # #   # #       #       #   #       #   #   
########### ### ####### ### ####### # ### ####### # # # ##### ##
#     #     #   #       #   #   #   #   # #   #   # # #     #   
# ### # ##### ### ##### # ### # # ####### # # # ### # ##### # # 
# #   # # #   #       # #     # #     #   # # #   # # #     # # 
### ### # # ########### ####### # ### # ### ##### # # ### ### # 
#   #   # #   #       #       # # #   # #   #     # #   # #   # 
# ### ### ### # ##### ####### # # ##### # ### ##### ### # ##### 
#   #       # # #   # #   #   # #   #   # #     #     # # #     
### ### ##### # ### # # # # ### ### # ### # ### ##### # # # ### 
# #   # #   #       # # #   #   #   #   # #   #   #   # #   #   
# ### ### # ### ##### # ##### ##### # ### # # ### # ### ##### # 
#   #     #   #   #   #     #     #   #   # #   # #   #     # # 
# # ######### ### # ####### ##### ### # ##### # # ### ##### # # 
# # #   #   # # # #   #     #   # #   # #     # #   #     # # # 
# # # # # # # # # ### # ####### # # # # # ######### ##### # ### 
# #   # # # # #   #   # #       #   # # # #   #     #   # #   # 
# ##### # # # ### # ### # ##### ##### # # # # # ##### # # ### ##
# #       # #   # #   #   #     #     # #   # # #   # # #   #   
# # ########### ##### ####### ### ##### # ##### # # # # ### ### 
# #     #     #     #       #       #   # # #   # #   #   # #   
####### # # ####### # ##### # ##### # ### # # ### ####### # # ##
#     # # #   #   # # #   # # #  S  # # #   #     #   #   # # # 
# # ### # ### ### # ### # # ### ### # # # ######### # # ### # # 
# #     #   #     #     #   #   # # # # #       #   #   #   #   
# ######### ################# ### # # # ### ##### ####### ######
#   #     # #                 #   # # #     #   # #     #   #   
# ### ### # ### ### ### ####### ### # ####### # # ##### # # # # 
# #   #   # #   #   #   #     #     #         # # #     # #   # 
# # ####### # ####### ####### # ############### # # ########### 
# #   #   # #   #     #     # #   #   #         # # #         # 
# ### # # # ### # ######### # ### # # # ######### # # ####### # 
#       #       #           #       #             #   #         
################################################################
