################################################################
################################################################
     # #           #     #   #     #     #   #           #     #
 ### # # ### ### # ### ### # ### ### ### ### # ######### # ### #
   # #   #   #   #     #   #   # #   # # #       #     #   #   #
## # ##### ### ####### # ##### # # ### # # ##### # ### ##### # #
   # #       # # #   # #     # # #   # #   #   #   #     #   # #
 ### # ##### # # # # # ### ### # ### # ##### # ########### #####
   # # #     # # # #   # # #   #       # #   #       #   # #   #
## # # # ##### # # ##### # # ######### # # ######### # # # # # #
   # # #   #   # # # #   # #   #   # # # # #   #     # # # # # #
#### # ##### # # # # # # # ### # # # # # # ### # ####### # # ###
     #   #   # # # #   # # #   # #       # #   #         # #   #
 ####### # ### # # ##### # ####### ####### # # ########### ### #
 #   #   #   # # #       #   #     #     #   #     #   #       #
 # # # ##### ### # ##### ### ##### # ### ####### ### # ####### #
 # #   #   #     # #   # #   #       #   #       #   # #     # #
 ####### # ####### # # # # ### ### ####### ####### ### # ### # #
   #     #   #     # # #       # # #     # #   #   #   # # # # #
## # ####### # ### # # # ####### # # ### # ### # ####### # # ###
   # #   #   # #   # #   #     #       #   #   #   #     # #   #
 ### # ### ##### # # ### # ### ####### ##### # ### # ##### ### #
 #   # #   #     # # #   # # #       #       #           #     #
 # ### # ##### ##### # ### # ####### ############# ########### #
   #     #     #     # #   #   # #   #   #         #       #   #
#### ########### ##### # ### # # # ### # # ####### # ##### #####
   #           #     # #     #   # #   #   #     # #     #     #
 ############# ##### # ######### ### ####### ### # ##### ##### #
 #   #       #   #   #         #   # #     #   #   #   #   #   #
 # ### # ####### # ############### # # ### ### ##### ##### #####
   #   # #     # # #       #       # #   # #   #   #     # #   #
 ### ### # ##### # ####### # ####### ##### # ### # ##### # # # #
   # # #   # #   #       # #   #     #   # # #   #       #   # #
## # # ##### # ### ##### # ### ### # # # # # # ############### #
 # # #       # #     #   # # #   # # # #   # #     #         # #
 # # ### # ### # ##### ### # ### ### # ##### ##### # ####### # #
 # #   # #   # #     #     #   #   # # #   #     #   #   #   # #
 # ### # ### # # ### ####### # ### # # # # ##### ### # # # ### #
     # #   # # #   #     #   #   #   # # # #   #     # #       #
 ### # ### ### ### ### ### # ##### ### # ### # # ##### # #######
   # #   #   # #   # #     # #   # #   #     # # #   # # #     #
 # ##### # # # # ### ######### # ### ######### ### # ### # ### #
 #         # # #          S#   # #   #       #   # #   # # # # #
 ########### # ############# ### # ######### ### # ### # # # # #
   #     #   #               #   #   #     #   #   # # # #   # #
## # ### ##################### ##### # ### ### ##### # # ##### #
   #   #                     #   #   #   #     #       #   #   #
 ##### ####### # ############### # ##### ####### ####### ### ###
     #     #   #     #           # #     #       # #     #   # #
## # ##### ##### ##### ########### # ##### ####### # # ### ### #
   #       #   #   #   #         #         #         #     #   #
 ######### # # ##### ### ### ### ### ####### ##### ### ##### ###
   #     # # #       #   #   #             #   # #   #         #
#### ### # # ########### ##### ### ####### # # # ### ### ##### #
     #     # #         #     #   # #     #   # #     #   #     #
 ######### # ####### # ##### ##### # ######### ####### ####### #
 #       # # #       #   # #   #   #   #       #   #   #     # #
 # ##### # # # ######### # ### # ##### # ####### # ### # ### # #
 # #   #   #   #     #   #   # #       #   #   # #   #   #   # #
 # # # ### ##### ### # ##### # ########### # # ##### ##### ### #
 # # #   #       # # # #   #         #   #   # #     #     #   #
 # # ### # ### ### # # # # ########### # ##### # ##### ####### #
 #   #   #   #     #     #             #       #      G#       #
################################################################
