################################################################
#     #     #     # #   #           #     #     #       #     # 
# ### # ### # ### # # ### ######### # # # ##### # ##### # ### # 
#   #     # #   # #   #   #         # # # #   #   #   # #   #   
### ####### ### # ### # ############# # # # # ##### # # ####### 
# #     #   # # #   # #   #   #       # # # #   #   #   #   #   
# ##### # ### # ### # ### # # # ####### # # ### # ####### # # ##
#       #     # #   #   # # #   #       # #   #   #     # #   # 
# ############# # ### # # # ### # ####### ### ####### # # ##### 
# #   #   #   # # # # # # # #   # #         # # #   # # # #     
# # # # # # # # # # # # # # ##### ####### # # # # # # # # ##### 
# # #   #   # # # #   #     #     #       #   #   # # # #       
# # ######### ### # ##### ### ##### ##### ######### # # ####### 
# #   # #     #   # #   # #   #     #           #   # #   #     
# ### # # ##### ### # # ### ### # ######### # # # ### ### # ####
#   #   #       #   # # #   #   # #   #   # # #         # # #   
# # ### ############# # # ##### # # # ### # # ### # # # ### ### 
# # #   #   #   #     #   #     # # #   #   #   # # # #   #   # 
# # # ### # # # # ########### # # # ### ####### # # # ### ### # 
# # # #   #   # # #           # #   #   #   #   # # #   #     # 
# # # # ####### # # ##### # ######### ##### # ### # ### ####### 
# # #   #   #   # # #   # #         # #   #   #   # # #         
# ####### ### ### # # # # ##### ### # # # ##### # # # # ### ### 
#       #   # #   # # # #   # # #   #   #   #   # # #   # #   # 
# ####### # # ### ### # # # # # ########### ##### # ##### # # # 
# #       # #   #   # #   # # #           #     # # #   # # # # 
# # ####### ### ### # ##### # ################# # # ### # # # # 
# # #     #     #   #   #   # #             #   # #   # # # # # 
# # ### # ####### ##### # ### # ########### # ####### # # ### # 
# # #   #         #     #     #   #   #     #     #   #       # 
# # # ### ### # # ############### # ### ##### ### # ########### 
# # # #   # # # #           #     #   # #     #   # #         # 
# # ### ### # # ########### # ####### # # ### # ##### ####### # 
#   #   #   # #   #   #   #   # #     # # #   #     #       # # 
# ### ### ### ### # # # # ##### # ##### ### ####### ##### ### # 
# # #       # # #   #   #   #     #   #   #       #   #   #   # 
# # # ####### # ######### ### ##### # ### ######### # # ### ### 
# #     # #   #   #     #   #   #   #     #     #   # #   #   # 
# ##### # # ##### ##### ### # ### ######### ### # ####### ### # 
# #   #   #     # #     #   # #   #     #   # #   #     # #   # 
# # # ### ##### # # ##### ### # ### # # ### # ### # ### # # ####
#   #   #     #   # #   #     # #   # #     #     # # #   #     
####### ### # ##### # # ####### # # # ####### ##### # ######### 
#     #   # #       # # # #     # # #       # #     #   #   #   
# ####### ######### # # # # ##### ######### ### ####### # # # ##
# #     #         #   #   #     #         #   # #       # #   # 
# # ### ######### # ########### ### ### # ### # ### ##### ##### 
# #   #       #   # #   #       #   #   #   # #     #     # #   
# ### ####### # ##### # # ####### ### ####### ### ### ##### # ##
# #   #     #   #     #   #       # #       #   # #   #     #   
# # ### ### ##### # ####### # ##### ####### ### # # ##### ##### 
#   #   # #     # #   #     # #   #         # #   # #   #   #   
# ### ### ##### ##### ### # # # # # ####### # ##### ### # ### ##
# #     #   #   #     #   #S# # # # #     #   #   #     #     # 
# ##### # # # ### ##### ##### # ### # ### ### # # ####### ##### 
# #  G  # # #   #     # #     # #   # # #   #   #       #     # 
# # ##### ##### ##### # # ##### # # # # ### ####### ######### # 
# # #   # #   #       # # #       # # # #   #   #   #   #     # 
# # # # # # # ######### # ### # ##### # # ##### # ### # # ##### 
#   # # #   #   #   #   #   # # #     # #     #   #   #   #   # 
##### # ##### # # ### # ### # ### ##### ##### ### # ####### ### 
#     #       # #     # #   # #   # #     # #   # #   #   #     
# ############# ####### # ##### ### # ### # ### ##### # ### ####
#             #         #               #     #                 
