################################################################
#   #   # #     #           #         #       #     #   #       
# ### # # # ### ########### # ####### # ##### ### # # # # ##### 
# #   #   #   #   #   #   # # #       #   #     # #   #   #   # 
# # ######### ### # # # # # # # ######### ##### # ########### # 
# # #     # #   # # #   # # # #   #       #   # #       # #   # 
# # # ### # ##### # ##### # # ##### ####### ### # ##### # # ### 
# # #   #   #     #     # # #     #         #   #   #   #   #   
# # ### ##### ######### ### ##### ########### ####### ### ### ##
#     #   # # #     #   #   #   # #   #   #   #       #     # # 
# ####### # # # ### # # # ### # # # ### # # ##### ##### ### # # 
#       #   # # #   # # #   # # #   #   # #   #   #G#     # # # 
# ####### ### # # ##### ### ### ### # ####### # ### # ##### # # 
# # #   # #   # # #       #   #     #       # #   #     #   #   
# # # # # # ### ### ##### ### ##### ####### # ### # ##### ##### 
# # # #   # # #     #       #     # #     # #   # # #   # #     
# # # ##### # ####### ##### ##### # # ##### ### # # ### # # ####
#   # #   # #   #       #       # #               #   #   #   # 
### # # # # ### # # ##### # ### # # ####### ######### ####### # 
#   # # # # #     # #     #   #   # #       #     # #   #   # # 
# ### # # # ####### # ########### ### # ##### ### # ### ### # # 
#   # # #   #       #   #   #   #     # #   # # # # #       #   
# # # # ##### ##### ### # # # # ####### # # # # # # # ######### 
# #   #   #     #   #   # #   #       # # #   # # #   #       # 
# ####### ##### # ### # # ########### ### ##### # # ### ### ### 
#       #   #S  #   # # #   #   #     #   #     # #   #   #     
# ######### ##### ### ##### # # # ##### ### ##### # ##### ######
#     #   #   #   #   #   # # # #       # #   #   #       #     
##### # # ### ##### ### # # # # ######### ### ### # ####### # # 
#     # #   #     # #   # #   #       # #   # #   # #       # # 
# ##### ######### ### ### ########### # ### # # ### # ####### # 
# # #   #       #     # #   #   #     #   # # # #         #   # 
# # # ### ### ######### ### # # # ##### ### # # # ##### # ##### 
#   #   # # #             # # # # #     #   #   # #   # #   #   
# ##### # # ############### # ### ### ### ####### # # ##### # ##
#   #   #   #         #     #   #   #   #   # #   # #   #   #   
# # # ##### # # # ### # ####### ### # ##### # # # # ### ########
# # #     # # # #   # # #     # #   # #   #   # # # #   #       
# # ##### # # ####### # ##### # # ### # # # ### # # # # # ##### 
# #       # # #     # #     #     #     #   #   # # # # #     # 
# ######### ### ### # ##### ### ####### ##### ##### # ### ##### 
#         #   # # #   #   #   #       #           # #     #   # 
### ##### ### # # # ### # ### ####### ########### # ####### # # 
#   #   #       #   #   # #   #     #         # # #     #   #   
# # # # ########### # ##### ### ### ######### # # ##### # ######
# # # # #         # # #           #       #   #         #   #   
# ### ### ####### # # # ######### # # ##### ##### ######### # ##
#   #     #   #   #       #   #   # #       #             # #   
### ######### # ### # ### # # ##### ############# ####### # ### 
#   #   #   # #   # # #     #     #       #       #   #   #     
# ##### # # # ### ### # ####### # ##### # # # ##### # # ########
# #     # #   # #     # #     # #     # # # #       # #   #     
# # ##### ### # ####### # ### ####### # # # ######### ##### ### 
# # #   # # # #   # #   #   # #   #   # # # #   #   #     # # # 
# # ### # # # ### # # ####### # # # ### # # # # # ####### # # # 
#   #   #   # #   # #         # # # #   #   # # #   #   #     # 
# ### ####### # ### ############# # # # ##### ##### # # ####### 
#             #   # #     #       # # #     #     # # # #   #   
# ##### ######### # # ### # ####### # ### ### ### # # ### # # ##
# #   #         # #   #   #   #     #   #   # # #   #     # # # 
# # # ### ##### # # ######### ### ### # ### # # ########### # # 
# # #   #     #   #         # #   #   #   # #       # #   # # # 
# ##### ### # ##### ####### # # ##### ### # ####### # # # # # # 
#       #   #       #       #   #     #   #             #   #   
