################################################################
#     #       #   #       #               #   #   #             
##### ### # ### # # ##### # ### ########### # # # # ##### ##### 
#   #     #     # #   # # #   #   #   #     # # #   #     #   # 
# # ####### ######### # # ### ### # # # ##### # ##### ####### # 
# #       # #       #   #   # # #   #   #     #   #   #       # 
# ####### # # ##### # ##### # # ####### # ####### # ##### ##### 
#   # #   #   #     # #   # # #       # # #       # #   #       
### # # ##### ####### # # ### ####### # # # ######### # ####### 
#   # #     #       # # #   # #     # # # # #         #     #   
# ### ##### # ##### # # ### # ##### # ### # # ############# # ##
#   #   #   #     #   #   # # #   # # #   # #S        #   # #   
### ### # ####### ####### # # # # # # # ### ######### # # # ####
#   #   # #             # # #   # # #   #   #       #   # #     
# ### ### # ##### ####### # ##### # ##### ####### # ##### ##### 
#   # #   # #   #       # #   #   #     #     #   #     #   #   
### # # ### # # ####### # ##### ##### # ##### # ####### ### # ##
#   #   #   # # #       # #     #     # #   # #   #   #     #   
# ### ### ### # ####### # # ##### ##### # ### ### # # ### ######
#   #   # #   #       #   #   #   #   # #     #   # #     #     
### ### ### ######### # ##### # ### # # ##### # # # ##### # ### 
# #   #     #   #   # # #   #   #   # # #   #   # # #     # # # 
# ### ######### # # # # # ####### ### # # # ####### # ##### # # 
#     #         # #   #         # # #   # #         #     #   # 
####### # ####### ########### # # # ##### ############### ##### 
#       #     #   #         # # #         #         #     #   # 
# ##### # ### # ### ####### # ################# ### # ##### # # 
# #     #   # # #   #   #   #                   #     #     # # 
# ########### # ### # # # ### # # # ####### ####### ### ##### # 
#   #       # #   #   # #   # # # #   #     #     # #   #       
### # ##### ##### ##### ### ### # ##### # ### ### # ##### # ### 
# # #   #       #     # # #   # #   #   # #   # # #       # #   
# # ### ####### ##### # # ### # # ### ### # ### # ######### # # 
# #   #       #     # # #       #   # #   # # #   #   #     # # 
# ### ####### ##### # # # ######### # ### # # ##### # ####### # 
#          G#   #   # # # #   #   # #   # # #       # #     # # 
# # ##### ####### ### # ### # # ### ### # # ######### # ### ### 
# #   #   #   #   #   #     # #     #   # # #   #     #   #     
####### # # ### ### ######### ####### # ### # # # ####### ##### 
#       # #   #   #     #     #       # #   # # # #     #     # 
# ####### ### ### ##### ####### ####### # ### ### # # # ####### 
# #     #       #   # #         # #   # # #   #   # # #       # 
# # ### ### ### ### # ########### # ### # # ### ##### ####### # 
# # #       #     # #           # #     # #   #     # #   #     
# # # # ##### ### # ##### # ### # ##### # ### ##### ### # ##### 
# # # # #     #   # #     #   #         # # #   # #   # # #     
# # ### # ##### ### # # ##### ### ##### # # ### # ### # # # ### 
# #   # # #   #   #   # #     #   #   # # #     # # #   # #   # 
# ### ### # # ### ### ### # ####### # ### # ##### # ##### ### # 
# # # #   # # #   #   #   # #       #   # #     # #     #   # # 
# # # # ### ### ### ### ### # ######### # ##### # ### ##### ### 
#   # # #       #   # # #   #   #       #   # # #   #     # #   
##### # # ##### # ### # # ####### ######### # # ### # ##### # ##
#     # # #   #   #   # # #   #     #   #   #     #   #   # # # 
# ##### ### # ##### ### ### # # ### # # # ####### # ### # # # # 
#     #     #       # # #   # #   #   # # #     #   #   # # # # 
# ### ############### # # ##### # # ### # ##### # ### ##### # # 
# # #   #     #   #   # #     # # #   #   #   # # #   #     #   
# # ### # ### # # # # # ##### ### # ####### # # # # ### ####### 
# # # #     #   #   # # #   #   # #         #   #     # #       
# # # ################# # # ### # ####### ### ### ### # # ######
# #   #   #     #     #   #   # # #     #   #   #   # # #   #   
# ### ### # ### # ### ##### # # # # ####### # ### # ### # ### # 
#         #   #   #         # #   #         #     #           # 
