################################################################
   #     #     #         #   #   #       #   #         #   #   #
## # # # # ### # ####### # # # # # ##### # # # ####### ### # # #
   # # # # #   #     #   # #   # #     #   #   #   # #     # # #
 ##### # ### ####### # ######### # ### ##### ### # # ######### #
 #     # #   #       #               #     #     #   #         #
 ####### # ### ##### ############# # ##### # ######### ### # ###
 #   #     #   #   #       #     # #   #   #           # # #   #
 # # # ##### ### # # ####### ### # ### # ############### # ### #
 # #   #     # # # #   #   # #   # #   # # #        S    #   # #
 # ##### ##### # # ##### # # # ### # ### # # ############### # #
               # # #     #   # #   #   # #   #   #           # #
## ############# # # ######### ######### ### # # ##### # ##### #
   #   #         #   #         #       #   #   # #   # # #     #
 ### # # ######### ### # ####### ##### # # ##### # # ### ##### #
   # #   #   #   #   # # #   #   #     # # #   #   #   #   # # #
## # ##### # # # ##### ### # ##### ##### # ### # ##### ### # # #
   # #     # # #     #   # #   #   #   # #   #   #   #   # #   #
 ### # ##### # ##### ### # ### # ### # ##### # ### # ### # ### #
     #     # # #         # #   #     #   #   # #   #   # # #   #
 ########### # # ######### # ########### # ##### ##### # # # ###
 #   #   #   # #   #       #     #     # #   #   # #   #   #   #
 # ### # # ### ### # ########### # ##### # # # ### # ####### # #
       # # # # #   #   #   # #   #     # # # #   # #       # # #
 ##### ### # # # ##### # # # # ####### # ### ### # ####### ### #
     # #   #   # #     # # # # #           #   # #       # #   #
 ### # # ######### ##### # # # ### ####### # ### # ####### # ###
 # # # #   #       #     #   #   # #     # #     #   #     #   #
 # # ##### # ####### ########### ### ### # # ##### ### ##### # #
   #       #   #         #     #   # #   # #         # #     # #
 ############# ######### # # ##### # # ### ##### # # # ### ### #
 #   #         #   #     # # #   #   #   #   #   # # #   # #   #
 # # # ######### # ##### # # # # ####### ### ####### ### # # ###
   # # #       # #     # # # # #   #   #   # #     #   # # # # #
 ##### # ##### # ##### # # # # ##### # ### # # ### ##### # # # #
 #     #   # #   #   # #   #   #   # #     #   # # #     # # # #
 # ####### # ####### # ####### # # # ########### # # ##### # # #
   #   #   #       # #       # # # # #           # #     # #   #
 ### # # ######### # ####### # # ### # # ### ##### # ### # #####
   # # #       #           # # # #   # #   # #     #   # #     #
## # # ####### # # ### ### # # # # ### ### ### ##### # # ### ###
   # #     # # # # #   #       # # #     #     #     # #   #   #
 ### ##### # # ### # ######### # # ##### ####### ####### # ### #
 # #   # # #   #   #     #   # # #   # #   # #   #     # # # # #
 # ### # # ##### ####### # # # # ### # ### # # ### ### ### # # #
   # # # #   #   #     # # #   #     #     # #   # # #     #   #
## # # # ### # # # ### ### ### ####### ##### ### # # ######### #
   # # #     # # # # #   #   #       #G  #       # # #         #
 ### # ####### # # # ### ### # ##### ### ######### # ### # ### #
 #   #   #     # # #         # #     # #           # #   # #   #
 # ##### ######### ########### # ### # ############# # ### # # #
         #       #       #     # # # #     #     #     #   # # #
## ####### ##### ####### ### ### # # # ### # ### ##### # ### # #
   #     #   # #       #   # #   # # #   # # # #   #   # #   # #
 # # ### ### # ########### # # ### # ##### # # ### ##### # ### #
 #     #   # #           # # #   #         #     #     # # #   #
 ##### ### # ##### # ### # ##### ####### ####### ##### ### ### #
     # #   #   #   #   #   #   #   #   # #       #     #   #   #
 ### ### ##### # ##### # ### ##### # # # # ############# ### ###
   # #   #   # #   #   # #   #     # # # #   #           # #   #
#### # ##### # ### # ### # ### ##### ### ### # ########### # # #
     # #   # #   # # #   #   # #     #   # # #   #   #   #   # #
 ##### # # # ### ### # ##### # # ### # ### # ### # ### # ##### #
     #   #   #       #     #   #   #             #     #       #
