################################################################
   #         #       #     #         #     #         #         #
## # ####### # ##### ##### ######### # ##### ####### # ####### #
   # #     #   #   #     # #       # # #     #     #   # #     #
 ### ### ####### # ##### # # ##### # # # ##### ### ##### # #####
 #     #       # #     # # # # #     #   #   #   #     #   #   #
 ##### # ####### ####### # # # # ######### # ### ### ### ##### #
       #   # #       #   #   # #   #     # #     # #   #   #   #
########## # # ####### ####### ### # ### # ####### ### ### # # #
     #   #   # #       #         # #   #   #         #     # # #
 ### # # ### # # ############### # ### ##### ### # # ####### # #
   #   #     # #   #           # #   # #     # # # #     #   # #
############ # ### ##### ##### # ### # ### ### # # ### # ##### #
             #   #   #   #     # #   #     # #   # # # #     # #
 ########### ### ### # ### ##### # ######### ##### # # # # ### #
     #     #   #   #   #   #   # #       #         # # # #   # #
#### ### ### ### ####### ### # # ### # # # # ### ### # # ### # #
   #   # #   #   #     # #   #       # # # # # # # # # # #   # #
 ##### # # ### ### ### # ########### # # ### # # # # # # # ### #
       #         #   # # #         # # #   #   # #     # #     #
######## ####### ### # # # ####### # # ### ### # ####### #######
         #     #   # # # # #     # # #   #   # #   #       #   #
 ##### # # ### ### # # # # ##### # # ### ### # ### # # # # # # #
   #   # #   # # # # # # # #   # # #   # # # # #   # # # # # # #
## # ######### # # # ### # # # # # ##### # # ### ### # # # # # #
   #   #   #   # # #   #   # #   #   #   # #     #   # # # # # #
 ##### # # # ### # ### ##### ####### # ### ####### ### # ### # #
 #   # # # # #       #     #     # # # #           #   #     # #
 # # # # ### # ##### ##### # ### # # # # # ### ### # ######### #
 # # # # #   # #   # # #   # # # # #   # #   # #   # #    S#   #
 # # # # # ##### # # # # ### # # # ##### ### # # ### # # ### # #
 # # #   #     # # # # # # # #   #       #   # # # #   #   # # #
 # # ######### # # # # # # # ####### ##### ### # # ####### # # #
   #   #     #   # #   #   # #       #     #   # #     #   # # #
###### ##### ##### ### ### # # ##### # ##### # # ### ### # # # #
     #       #   #   # #   # # #     #   #   # # #   #   # # # #
 ### # ####### # ### # # ### # # # # ### # ### # # ### ### # ###
 #   #         #   # # # # #   # # #   # # #   #   #   #   #   #
 # ##### ########### # # # ##### # ##### # ######### ### ##### #
 # #   #   #         #           # #     #         # #   #   # #
 # # ##### # ############# # # ### # ######### ##### ##### # # #
 # # #   # # #     #   #   # #   # #   #     # #     #   # #   #
## # # # # # # ### # # # ### ### ####### ### # # ##### # # #####
   # # #   #   # # # #   #     #   #     #   # #   #   # # #   #
 ### # ### ##### # ############### # ######### ### # ### # # # #
   # #   # #       #             # # #     #     # # #     # # #
## # ### ### ####### ########### # # # ### ##### # # ######### #
   #   #   #   #     #     #   #   #   # #       # # #       # #
 ##### ### ### ### ####### # ########### ######### # # ##### # #
     #   #   #   #   #   # # #         # #   #     #   #   #   #
#### ### # # ### ### # # # # # ####### # ### # ### ####### #####
     #G#   #   #     # #       #   # # #     #   #             #
 ##### ##### ######### ####### ### # # ##### ### # ### ### #####
     #   #             #     #   #   #     # # # #   #   #     #
#### ### # ############# ### ### ### ##### # # # ### ### ##### #
   #   # #     #         # #   #       # #     #   #   # #   # #
 # ### # ##### # ######### ### ####### # ######### ### # # # ###
 # #   #       # # #       # #       #       #     #   # # #   #
 ### ##### ##### # # ##### # ####### # ####### ##### ### # ### #
   # #     #     # #     # #     #   #   #     #   #   # #   # #
## # ##### # ##### ####### # ### # ####### ##### # # # ####### #
   #   #   # # #       #   # #   #         #   # # # #     #   #
 # ### ##### # # # ### # ##### # ########### # # # # ### ### ###
 #           #   #   #         #             #   #     #       #
