################################################################
################################################################
       #     #     #   #   #     #   #   #     #               #
 ##### # ### # ### # # ### ##### # ### # # ### # ###############
 #     # # # # # #S# #           # #   #   #   #     #         #
 ####### # # # # # ##### ######### # ####### ####### # ####### #
 #       # # #   #   #   #       #   # #   #       # #   #     #
 # ####### # ####### # ### ##### ##### # # ####### # # ### #####
 #   #   # # #   #   # # #   #   #   # # #   #   # #   #   #   #
 ### # # # # ### # ### # ##### ##### # # ##### # # # ### ### # #
  G  # #   # #   #   #   #     # #       #     # # # # #     # #
########## # # # ### ### # ##### # ####### ##### # # # ####### #
     #     #   #   # #   # #     # #       #   #   #     #     #
 ##### ########### # # ### # ##### # ####### ########### #######
 #                 # #   # #   #   # #   #     #   #   #   #   #
 # # ############# # # # # ### # ### # # ##### # ### # ### # # #
 # # #               # # #         # # #   #   # #   #   # # # #
 # # # ########### ### ####### ##### # ### # ### # ##### # # # #
 # # #     # #   #   #     # # #   #   # # # # #   #   #   # # #
 # ####### # # # ### # ### # # # # ##### # # # # ##### ##### # #
   #     # # # # # # # # #   # # # #     # # # # #     #   # # #
## # ### # # # # # # # # ##### # # # ##### # # # # ### # # # # #
   #   # #   # # #   #         # #       # # #     #   # #   # #
###### # ##### # ### ######### # ######### # ####### # # ##### #
     # # #     #   #         #   #   #     #         #     #   #
 ### ### # ####### ######### # ### ### ########### ####### # ###
   #     # #   # # #   #   # #   # #   #           #     # #   #
## ######### # # # # ### # # ### # # ######### ##### ### # #####
 # #         # #       # #   #   # #         # #     #   # #   #
 # # ##### ### # ##### # ##### ### ######### ### ##### ### # # #
 # # #     #   #     #                   #   #   # #   #     # #
 # ### # ##### # ### ### ####### ##### ### ### ### # ### ##### #
 #   # # #   # # # #   #     # #     # #   # # #   #   # #     #
 ### # ### # # # # ### ##### # ##### ### ### # # ##### # # #####
   # # #   #     #   # #     # #     #   # #   # #     # #     #
## # # # ##### # # ### ####### # ### # ### # ### ### ### ##### #
   #   #     # # #   #       # #   # # # # #   #     # # #   # #
 ############# # ### ####### # ### ### # # ### ####### # # # ###
     #   #   # #   # #       #     #   # # # # #   #     # #   #
## # ### # # # # # # # ############# ### # # # ### # # ### ### #
   #   # # # # # # # #     #         #   #   #   #   #   #   # #
 ##### # # ### # ### ##### # ########### ### ### # ##### ##### #
 #   #   #     #     #   # # #   #         # # # #     # #     #
 # # ### ####### ##### # # # # # # ### # ### # # ##### ### #####
 # #   #         #     # #   # # # #   # #   # # #       # #   #
 ##### ######### # ##### ##### ### # ##### ### # # ##### # ### #
     # #         # #   #         # #     #     # # #   # #   # #
## ### # ##### ### # # # ##### # # ##### # ##### ### # # ### # #
 #   # #     #     # # # #   # #   #     # #   # #   # #   #   #
 ### # # ### ######### # # # # ##### ##### # # # # ### # ##### #
   #   #   #           #   # #   #   #     # # #   #   #     # #
## ####### # # ############# ##### ### ##### # ##### ### ##### #
         # # #           #   #   #     #   # #       #   # #   #
 ##### # ### ### ####### # ### # ####### # # ######### ### # ###
 #     #   #   # #       #     #         #   #   #         #   #
 # ####### ### # # ########################### # # # ######### #
 #       #     # # #   #   #   #   # #   #     #   #   #     # #
 ####### ####### # ### # # # # # # # # # # # # ####### # # # # #
 #   #   #   #   #     # # # #   #   # #   # #       #   # # # #
 # # # ### # # # ######### ######### # ##### ############# ### #
 # # # #   # # #     #   #     #     #   #   #       #   # #   #
 # # # # ### # ##### # # ##### # ####### # ### ##### # # ### ###
   # #   #   #     #   #                 #         #   #       #
################################################################
