################################################################
# #         #                 #                 #   #   #   #   
# # ####### ##### ### # ##### # ################# # # # ### # # 
#   #       #     #   #     # #S      #         # # # #     # # 
# ########### ##### ######### ##### ### ####### ### # ####### ##
# #   #     #   #   #               #   #     #     # #     #   
# # # # ### # # ### # ####### ##### # ####### ####### ##### ### 
#   # # #   # # #   # #   #   #             #       #   #       
##### # # ##### # # # ### # # # ########### # ##### ### # ######
#   #   #       # # #     # # # #       # # #     # # # # # #   
# # ############# # ####### ### # ##### # # # ##### # # # # # # 
# # #   #         #       # #   # #   # #   # #   #   # #     # 
# ### # ##### ####### ##### # ### # # # # ### # # ##### ##### ##
#     #       #     # #   # # #   # #   # #   # #   #   #   #   
### ######### # ### ### # ### # ### ##### # ### ### # ### # # # 
#   #   #     # #       # #   #   # #     #   #   #   #   # # # 
# # # # ### ### ######### # ####### # ####### ### ######### # ##
# # # #   #   #   #         #       # #       #   #   #     #   
# # # ### ####### # # ####### ####### ### ##### ### # # ####### 
# # #   #   #     # # # #   #     #           # #   #   #       
# ##### ### # ####### # # # ##### ####### ### # # ####### ######
# #   # #     #     #   # # #           # # # # # #     # #     
# # ### # ##### ### ##### # ########### # # # # # # # ### # ### 
# #   # # #     # #       #     #     # # # # # # # # #   #   # 
# ### # # # ##### ############# ##### # # # # # # ### # ##### # 
#   #  G# # # #       #   #   #     #   #   #   #   # # #     # 
########### # # ### # # ### ####### # ##### ####### # # # # ### 
#           #   #   # #     #     # #     #   #   # # # # #   # 
# ############### ### ##### # ##### ##### ### ### # # # ####### 
#     #       #   # # #   # # #     # #   # #   #   #   #   #   
##### # ##### # ### # # # # # # ##### # ### ### # ##### # # # ##
#   # # #   # # # # # # # # #   # #   #   #   # #     # # # #   
# # # # # # # # # # # # # # ##### # # ### ### # ##### # ### # # 
# #   # # # #   # # #   #   #     # #   #   # # #   #         # 
# ##### ### ##### # ####### ### # # ### ### # # # ### ##########
# #   #   # #   #         #   # #     #     # # #     #         
# # # ### # # # ######### ### # ######### ### # # ##### ####### 
#   # #   #   #       #       #   #     # #     #           #   
##### # ############# # # ##### # # ### # # ##### ######### # ##
#     # #   #       # # #       #   #   #   #   # #       # # # 
# ##### # # # # ##### # # ##### ##### ### ### ### # ##### ### # 
#   #   # #   #     # # #     # #   #   #         #     #   # # 
### # ##### ####### # # ####### ### ### # ############# ### # # 
# #   #     #     # # #   #   #   #   # #   #         #   #   # 
# ##### ##### ### # # # # # # ### ### # ### # ####### # # ##### 
#   #   #     #   # # # # # #     # #   # # # #   #   # #       
### # # # ##### ### # ### # ####### ##### # # ### # ##### ######
# #   # # #   # #   # #   #     #   #     # #     #     #       
# ##### # ### # ##### # ### ### # # # ### # ##### ##### # # # ##
# # #   #     #     #   #   #   # # # #   # #     #   # # # #   
# # # ############# ######### ### # # # ### # ####### # # # ### 
#   #   #         #           #   # # #   #   #   #   # # #   # 
# ##### # # ### # ### # ####### ### ##### ##### # # ### # ### # 
# #   # # # #   #   # # #   #   # #   #       # # #     #   # # 
# # # # ### # ##### # # # ### ### ### # ##### # # ########### # 
# # #   #   #     # # # #   # #     # #     #   #       #   # # 
# # ##### # ##### # # # ### # # ##### ##### ########### # # # # 
# #     # #     # #   # #     #     # #     # #     #   # # # # 
# ##### # # # # # ##### ########### # # ##### # ### # ### ### # 
#     #   # # # # #   #         #   # # # #   # #   # # #     # 
# ### ##### # # # # ########### # ### # # # ### # # # # ####### 
#   # #     # # #   #       #   #   #   #       # # # #         
### ### ### # ####### ####### ##### ############# # # # # ######
#       #   #       #         #                   #     #       
