################################################################
################################################################
       #           #   # #   #   #           #               # #
 ##### # ######### # # # # ### # # ######### # ####### # ### # #
     # #       #   # # #   #   #   #   #   #     #   # #   #   #
#### # ######### ### # # ### ####### # # # ####### # # ### # ###
 #   #         # #   # #             #   # #     # # # # # #   #
 # ########### # ### # ############# ####### ### # # # # # # # #
 # #         #   #   #   #           #       #   # # #   # # # #
 # # # ##### ##### ##### # ######### # ####### ##### ##### ### #
   # # #   #       #   #   #       #   # #   #     #       #   #
 ##### # # ####### # # ##### ##### # ### # # ### # ######### # #
       # #   #     # # #     # #   #   # # #   # #   #       # #
######## ### # ### # # # ##### # ##### # # ### # ### # # ##### #
         #   # #   # #   #   #   #       # #   #   # # #   #   #
 # # # ##### # # ### ##### ######### ##### # ####### ##### #####
 # # #     #   #   # #             #   #   #   #   # #   #     #
 # # ##### ####### # ############# # ### ##### # # # # # # ### #
 # #   #   #       #         #   # # #   #   # # #   # # # #   #
## # ### ######### ######### # # # # # # # # # ####### # ### # #
   #   # #     #   #       # # #     # # # # #   #     #     # #
 ### # # ##### # ### ### # # ### ##### ### ##### ##### ####### #
 #   # #       # #     # # #   # #     #   #     #     #       #
 ##### ########### ##### # ### # # ##### ### ##### ##### # #####
     #       #     #     # #   # #       #   #       #   # #   #
 ### ### # ### ##### ##### # ### ######### ######### ##### # # #
 # # #   # #   # #   #  S# #   #     #   #     #   #     # # # #
 # # ##### # ### # ### # ##### # ##### # ##### # # # ### # # # #
 # #   #   # #   #     #       #     # #     # # # #   # # # # #
 # ### # ### ### ################### # ####### # # ##### ### # #
   #   # # #     #                               # #   # #   # #
#### ### # ##### ##### # ####################### ### # ### ### #
     #   #     #     # # #       #       #           #   #   # #
 ####### ##### ##### ### # ##### # ##### # ##### ####### # ### #
   #   #       #     #   # #     #     # #   # # #     #   #   #
 # # # ######### ##### ### ########### # ### # # # ### ### # ###
 #G# #   #   #   #     #   #   #       #     # # #   #   # #   #
 # # ### # # # ### # ### ### # # # # ######### # ### ### ### # #
 # # # # # # # #   # # # #   # # # # #   #             #   # # #
## # # # # # # # ### # # ### # # # ### # ####### ####### # ### #
   # # #   # # #   #   #   # # # # #   #       # #     # #   # #
 ### # ####### ### ####### # # ### # ######### # # ### ##### ###
   #       #   #   #   #     #   # # #   #     # #   #     #   #
 # ####### # ####### # ######### ### # # # ##### ### ##### ### #
 #     #   # #       #         #   # # # #       # # #   #   # #
 ##### # ### # # ############# ### # # # ##### ### # ### ### # #
     # # # # # #   #   #     # #   # # #     #   # # #   # #   #
## # # # # # ##### # # # # ### # ### # ##### # # # # # # # ### #
   # #     #   #   # #   #   # # #   # # #   # # #   # #       #
 ############# # ### ####### # # ##### # # ### # ##### ### # ###
 #   #   #     # #         #   #     # #       #   #   #   # # #
 # # # # # ##### ######### ######### ### ######### ####### # # #
 # # # # #   #     #   #   #       # #     #   # # #     # #   #
 # # # # ### # ### # # # ### ### # # # ##### # # # # ### ##### #
 # # # # #   # #   # # # #   #   # # #   #   # #   #   #     # #
 # # # # # ##### ### # # # ##### ### # ### ### ####### ##### # #
   # # # #     #   # #   # #   # #     #   #   #       #   # # #
 ### # ####### ### # ##### # # ### ##### ####### ######### # # #
   # #   #   #     #   #     #     #     #     #           # # #
 # # ### # # ######### ##### ####### ##### # ############### ###
 # #     # # #   #   # #     #       #   # # #       #     #   #
 ######### # # # ### # # ### # ####### # # # # ####### # ##### #
           #   #     #   #             #   #           #       #
################################################################
