################################################################
################################################################
     #   #   #     #           #           #     #     #     # #
 ##### # # # # ### # # ####### # ##### ### # ### # # ### ### # #
 #   # # # #   #   # # #     #   #     #   #   #   #     #   # #
 # # ### ####### ##### # ### ####### ######### ########### ### #
 # #     #       #     #   #       # #         #         #     #
 # ####### ####### ####### ####### ### ####### # ### ###########
   # #     #       #     #   #   #     #   #   # # #     #     #
 ### # ##### ##### # ### ### # # ####### # # # # # ##### # ### #
 #     #   #   #   # #   #   # # #       #   # # #   #   #   # #
 # ##### ##### # ##### ### ##### # ### # ####### # # ######### #
               #       # #   #   # #   #   #   #   #   #     # #
 ##### ############# ### ### # ### # ##### # # ####### # ### # #
 #   #   #     #   #       # # #   #   #   # #     #   #   # # #
 # # ### # ### # # ######### # # ##### # ### # ### # ####### # #
   #   # #   # # #     #     #   #   # #     #   # #     #   # #
 ##### # ### # # ##### # ######### ### ######### # ##### # ### #
   # # #   # # # #   # #   #     #             # #     # #   # #
## # # ### # # # # # # ### # ### ##### ####### # ####### ### # #
 # # # #   # # #   # #   #   # # #   # #     # #         # # # #
 # # # ##### ####### ### ##### # # # # ##### # ########### # # #
   #   #   #         # # #   #   # # #     # #     #         # #
 ####### # ########### # ### ##### # ##### # # # ### ######### #
 #     # #   #         # #   #   # #   #   #   #     #   #   # #
 # ### # ##### ####### # # # # # # ##### ####### ##### # ### # #
 #   # # #     #   #   # # # # # #     # #             #     # #
 ##### # # ##### # # ### ### # ####### # ##### # ### ##### ### #
     # #   #     #     #   # #   #     #     # # # #     #     #
#### # ####### ### ### ### # ### # ######### ### # ##### # #####
   #   #       #   #     # # #   #           #   #   #   #     #
 # ### ######### # # ### # # # ############### ##### # ### ### #
 # # #           # #   # #             #   #   #     #   #   # #
 # # ############# ##### ##### ### ### # # ### # ####### ### # #
 #   #             # #         #   #   # #   # #       # # # # #
 ### # ##### # # ### # ##### ### ### ### ### # ####### # # # # #
 #   #   #   # #     #     #   # #       #       #   # # #  S# #
 # ### # # ######### ##### ### # ################# # # # #######
 #   # # # #       #     #G  # # #           #     # # #       #
 ### ### # # ##### ######### # # # ######### # ##### # ####### #
 #     # # # #     #       # # #   #     # #   #     #     #   #
 ##### # # # ##### # ##### # # ##### ### # ##### ######### # ###
 #   #   # #     # # #       # #   #   # # #   #           # # #
## # ##### ##### # # # # ##### # # ### # # # # ############# # #
   # #       # # #   # # #     # #     # #   # #     #   #   # #
 ##### ### # # # ##### ### ############# # ##### ### # ### ### #
 #     #   #   # #   # #   #   #     #   #   #   #   #   #     #
 # ##### ####### # # # # ##### # ### # ### # # ### ##### #######
   #   #   #     # #   #     # # # #   #   #   #   #   # #     #
#### # ##### ##### ######### # # # ##### # ##### ### ### ##### #
   # #   #   #       #     # # #     # # #     # #   #   #     #
 # # ### # ##### ##### # ### # ##### # # ##### # # ### ### #####
 #   # #   #   # #     #   # #   #   # # #   # #   #   # #     #
 ##### ####### # # ####### # ### # ### # # # # ##### ### ##### #
 #   #         # #     #   #     #         # #   #   #   # #   #
 # # # ######### ##### # ######### ##### ####### # ### ### # ###
 # # #   #   #     #   # #             #   #     #   #     # # #
 # # ### # # ##### # ### # ####### ### ### # # ##### # ##### # #
   #   #   #       # #   #       # # # #   # # #     # #   #   #
 ##### ############# # ### ####### # # ##### ### ##### # # ### #
     # #     #       #     #     # # #     #     #   #   #     #
#### # # ### # ############# ### # # ##### # ##### # # #########
     #     #   #             #     #       #       #           #
################################################################
