################################################################
################################################################
#     #   #     #                 #     #               #       
# ### ### # ### # ####### ####### # ### # # ####### ### # ##### 
# # #     # #   #   #   # #       # # #   # #   #   #   # #   # 
# # ####### # ##### # # # ######### # ##### ### # ####### ### # 
# #     #   #     # # # #     #   # # #   #   # # #     #     # 
# # ### ### ##### # # ####### # # # # # ##### # # # ### ####### 
# #   #   #     # # # #     #   #   # # #     #   # # #         
# ### ### # ### # # # # ### ######### # # ####### # # ##########
#   #   # # #   # # #   #   #   #   #   #   #   # #       #     
### ##### # ####### # ### ##### # ### ##### # # # ####### # ### 
# #                 #   #       # #       #   # #     # # # #   
# # ####### ##### ### ### ####### # ########### # ### # # # # ##
#   #     # #   #       #   #   #   #       #   #   #   #   #   
### # ### # # # ####### ### # # # ### ##### ################### 
#   #   # # # #     # # #   # #     # #   # #     #             
# # ### # # # ##### # # # ### ####### # ### # ### # ##### # ####
# #   # # # #     # #   #         #   #   #   # #   #     #   # 
# # ### # # ##### # ############# # ### # ##### ##### # ##### # 
# # #   # #     # #             # # #   #   #       # # # #   # 
# # # ### ####### ############# ### # ##### # ##### # # # # ### 
# #   #   #     #       #     #     # #   # # #   #   #   #     
##### ##### ### ####### # ########### # # ### ### ### ##########
#   # #   # # #   #     #         # #   #   # #   #   # #   #   
# # # # # # # ### # ############# # ####### # # # ### # # # # # 
# # # # #   #     #   #   #   #   #   #     # # #   # #   #   # 
# # # # ############# # # # # # ### # # ##### # ### # ######### 
# #     #             # # # # # #   # # #     # # #       #   # 
### ##### ############### # ### # ### # # ##### # ### ### # ### 
#   #   # #   #       #   #   # # #   #   #     #       #   #   
# ### # # # # ### ##### ### # # # # ####### ####### # ####### ##
#   # #   # #   #           # # # #         #     # #       # # 
# # # ######### # ############# # ### # ### # ### ########### # 
# # #           #     #         #   # # # #   # #         #   # 
# # ############# ### # ########### # # # ##### ######### # ### 
# #     #     #     # # #          S# # #       #       #   #   
# ##### # # # # ### # # ### ######### # ####### # ##### ##### ##
# #     # # #   # # # # #   # #       #     #   #     # #   #   
# ####### # ### # # # # # ### # ##### # ### # ######### # # ### 
#     #   #   # #   # #   #   # # #   # #   # #       # # #     
##### # ##### # ########### ### # # # # # ### # ##### # # ##### 
# #   # #   # # #     #     #   #   # # # #   # #     #   #   # 
# # ### # # # # # ### # ##### ####### # ### ##### ######### # # 
# # # #   # # # #   # #   #   #   #   #     #     # #       #   
# # # # ### # ####### # ### ### # # ######### ##### # ##########
# # #   #   #       # # #   #   # #           #     #     #     
# # ### # ##### ### # # # ### ### ### # ####### ######### # ### 
#       # #   #   #   # #     #   # # #     #   #     #   # #   
####### ### # ##### ### ####### ### # # # ### # # ### # ### ####
#       #   # #   #         #   # #   # # #   #   # #   # #     
# ##### # ##### # # # ####### ### ##### # # ####### ##### # ### 
# #     #       # # #   #     #         # #G#   # # #   # #   # 
### ### ######### ##### # ##### ### # # # # ### # # # # # ### # 
#   #   #       # #   # # #   # #   # # #   #   # #   # #   # # 
# ### ####### # # # # ### # ### # ### # ##### ### ##### ### # ##
# # #       # # #   #     #     #   # #     # #     # # #   #   
# # ####### ### ############### ### # ### ### # ### # # # ##### 
#   #                     #     #   #   #     #   #   # #     # 
##### ################# # ##### # ############### ##### # ### # 
#     #     #           #       #       #       #     # #   # # 
# ##### ### # ################# ####### ####### # ##### ### # # 
#     #   #   #                       #                     #   
################################################################
