################################################################
################################################################
#       #       #                   #         #             #   
# ##### ####### # ######### ####### # ### ### # ####### ### # # 
# #     #   #   #   #     #       # #   #   # #   #     #   # # 
### ##### # # ##### # ### ####### ##### ### # ### # ##### # ### 
#   #     # # #     # # # #     #     # #   #     # #     # #   
# ######### # # ##### # # # ### ####### ########### # ### ### ##
# #   #       # #       #   # #     #   #         # # # #     # 
# # # ### ##### # ########### # ##### ### ######### # # ####### 
#   #   # #                 #   #     #   #         # # # #   # 
####### # # ######### ##### ##### ##### ### ######### # # # ### 
# #   #   # # #     #     #     #     #   # #         # #   #   
# # # ### # # # ### ### # ##### ##### ### # # ##### # # ### # ##
# # #   # # # # # # # # #     #   #   # #   # #   # # #   # #   
# # # ### # # # # # # # ### # ### # ### ##### # # # ##### # ### 
#   # #   #   # #   #   #   #   # # # # #       # #       #   # 
# ### # ### ### ######### ####### # # # # ####### ######### ### 
# #   # # # #   #       #   #     # #     #       #           # 
# # ### # # # ####### # ### # ##### ####### ##### ##### ##### # 
# #       # # #       #   # # #   # #       #   #       #   #   
# ######### # ########### ### # # # # ####### # ######### # ####
# #   #     #           #     # #   # #       # #         #     
# # # # ############### ####### ##### # ##### # # ############# 
# # # #   #     #       #       #     # #   # #   #       #   # 
# # # ### ##### # ####### ######### # # # # # ##### ####### # # 
#   #   #     # # #       #     #   # # # # #         #     # # 
# ### ####### # # ####### # ### # ### # # # ##### # ### ####### 
#   # #   #   # #       # # #   #   #   # #   #   # #   #   #   
### ### # # ### ####### # # # ##### ##### ### # ##### ##### # # 
#       # # #     #   #   # #     #   #   # # #       #   # # # 
####### # # # ### # ####### ##### # ### ### # ####### # # # # ##
#     # # # #   #   #     # #   #   #   #   #       #   #   #   
# ### # ### ### ##### ### # # # ### # ##### ####### ### ####### 
#   # #     # # #     #   # # # #   # #   #       #   # #     # 
# # # # ##### # # ######### # ### # # # # ##### ##### ### ### # 
# # # #     #   #       #   #   # # #   #     #         #   # # 
### # ##### # ######### ### ### # # ######### ######### ### # # 
#   # #         #     #     # # # #         #         #   # # # 
# ### ### ##### # ### ####### # # # ####### ######### ### # # # 
# # #   # #   # #   #   #     #   # #     # #   #   # #   # # # 
# # ### # # # ##### # # # ### ##### # ##### # # # # ### ### # # 
# #   # # # #   #   # # # # #   #   # #     # #   #     #   # # 
# # # # # # ### # ### ### # ### # # # # ##### ########### # # # 
# # #     #   # #   #   #   # #   # # # #   #   #     #   # # # 
### ######### # ### ### ##### ### # # # ### ### # ### ##### # # 
#     #   #   #   # # #   # #     # # #     # #   # #       #   
# ##### # # ##### # # ### # # ### # # ####### ##### ############
# #     #   #   # #   #   # # #   #   #           #   #         
# # ####### # ### # ### ### # # ####### # # ##### ### # ### ####
#   #     # # #   # #   #     #     #   # #     #   # #   # #   
# ### ### # # # ### # ############# # ### # ### ### # ### # # # 
# #   #   #   #     # #   #       #   #   #   #   # # # # #   # 
# ##### ############# # # # ##### ##### ##### ### ### # # ##### 
#     #               # # #     #       #   #   #     #   #   # 
##### ################# # # ### ######### # ### ####### ### ### 
#     #         #       # #   #   #   #   # #     #       # #   
# ##### # # ### ### ##### # # ### ### ### # # ### # ##### # # # 
# #     # # # #G    #   # # #   #   # #   #   #   #   #   #  S# 
# # ####### # ####### # # ####### # # # ####### ##### # ####### 
# # #   #   #       # # # #     # # # #   # #   #     #   #   # 
# ### # # ### ##### # ### # ### ### # ### # # # # ####### # ### 
#     #   #   #             #       #     #   #   #       #     
################################################################
