################################################################
################################################################
#             #   #       #             #     #   #     #   #   
##### ####### # # ####### # # ####### # # # ### # # ### ### # # 
#     #     #   # #     #   #   #   # # # #     # #   # #   # # 
# ##### ### ##### # ### ### ### # # # ### ########### # # ##### 
# #     # #     # # #     #   # # # #     #   #       #   # #   
# ##### # ####### # ##### ### ### # ####### # # ########### # ##
# #   #   #     # #     #     #   #         #   #     #         
# # # ### # ### # ### # ##### # ##################### # ########
# # #   #  S# # #   # #G  #   # #   #   #       #   # #   # #   
# # ### ##### # ### ####### ### ### # # # ##### # # # ### # # # 
# # # #   #   # #   #     #   #   # # # # #     # #   #     # # 
# # # ### # ### # ### ### ### ### # # # ### ##### ##### ##### # 
# #   # # #     # #   #     # #   #   #   #           # #     # 
# ##### # ### ### ### ##### # # ######### # ########### # ##### 
# #         #   #     #   #   #     #   # #             # #   # 
# # ####### ### ##### # # # # ##### # # # # ############# # # # 
# # #   # # #         # #   # #   # # # #           #   #   # # 
# ### # # # # ### ##### ##### # # # # # # ####### # # # ##### # 
#     # # # # #   #     #     # #   # #   #     # # # #   #   # 
# ##### # # # # ### ##### ##### ####### ### ### ### # ### # ### 
#   #   #   # # #   #     #     #   #   #   # #   # #   #   # # 
# ### ##### # # # ### ##### ##### ### ### ### ### ##### ##### # 
# #   #   # # # # #       # #   #   # #   #   # #   #   #   # # 
# # ### # # ### # ### ### # ### # # # # # # ### ### # ### # # # 
# #     # #     #   #   # # #   # # # # # # #     # # #   # #   
######### ##### ### ### # # # ### ### # ### ##### # # ### ######
#   #   # # #   #   #   #   #   #     #   #   #   # #     #     
# ### # # # # ### ### ######### ### ##### ### # ### ##### # ### 
#     # # #   #   #     #     #   # #   #     # #     #   #   # 
####### # ##### ### ### # ### ### # # # ####### # ##### ####### 
#     # #   #   #   #   # # # # # #   #           #       #   # 
##### # ### # ### ### ### # # # # ### ######### ### ####### # # 
#   #       # #     #     #   # # #   #   #   #     #       # # 
# # ### ##### # ### ########### # # ### # # # ##### # ####### # 
# #   # #     # # # # #   #   #   # #   #   #       #       #   
# ### ### ##### # # # # # # ### ##### ############# ####### ####
# # #     #       # #   #           #     #   #   #   #   #   # 
# # ####### ### ### ############### ####### # # # ### # ##### # 
#   # #     #     #     #     #   # #   #   # # #     # #     # 
##### # # ### ######### # ### # ### # # # ##### ##### # # ##### 
#   #   #   #   #     #     # #       # #       #   #     #   # 
# # # ##### ### # ### ####### ######### ######### # ### ### # # 
# #   #   # #   #   #   #   #     #   #           #   #     #   
####### # # # ##### ### # # ##### # # ############### ######### 
#   #   #   #     # #   # #     # # #     #         #       # # 
# # # ######### ### # ######### # # ### ### ##### ######### # # 
# #   #     #   #   #           # # # #     #   #         # # # 
# ##### ##### # # ############### # # ######### ##### ### # # # 
# #   #       # # #       #       # #   # #   #   # #   # # #   
# # ########### # ### ### ##### ### # # # # # ### # ### ### ### 
# #       #     #     #   #   #   #   # #   # #   #   #   #   # 
# # ##### # ### ####### ### # ### ##### # ### # ### ##### ### # 
# # #     # #         #     #   # #     # # #   #   #   #     # 
# # ####### # ### ############# # ### ### # ##### ### ######### 
# #   #     # #   #     #   #   #   #   # #   #     #   #       
# ### # ##### ##### # # ### # ##### ### # # # # ### ### # ##### 
# #     #   # #     # #     #   #   #       # # # #     # #   # 
# ### ### # ### ##### # ####### # ### ##### # # # ####### # # # 
#   # #   # #   #   # # #   # #   #       # # # #     #   # #   
# # ### ### # ##### # ### # # ##### ##### # # # ##### # ### ####
# #       #         #     #         #     # #             #     
################################################################
