################################################################
################################################################
           #   #   #   #   # #             #   #       #   #   #
 ######### # # # # ### # # # # ######### # # # # ### # # # # # #
     #   #   #   # #   # #   # #   #     # # # #   # # # #   # #
#### # # ######### # ### # ### # ### ##### # # ### # ### ##### #
   # # #           #     # #   #   #   #   # #     #   #   #   #
## # # ################### # ##### ### ### # ######### ### # ###
 #   # #       #           # #   #   #   # # #       #     #   #
 ##### # ##### # ########### # ### ##### # # # # ########### # #
 #     #   #   #     #   #   #     #     # # # # #     #   # # #
 # ######### ### ### # # # ### ##### ##### # ### # ##### # ### #
   # #     # # # # # # # # # # #   # #   # # #   #       #     #
 ### # ### # # # # # # # # # # # # # # # ### # #################
 #       #       # # # #   # # # # # # # #   #     #   #       #
 # # ### ##### ### # # ##### # # # # ### # ####### # # # ##### #
   #   # #   #     # #   #     # # #     #       #   #   #   # #
 ##### # # # # # ### ### # ####### ############# ######### ### #
     # # # # # #   #     # #   #   #   #       # #   # #   #   #
#### # ### # # ########### # ### ##### # ####### # # # # # # ###
     #     # #             #   # #   #   #     # # #     # # # #
 ########### # ### ### ##### # # ### ### # ### # ##### ##### # #
       #   # #   #   #       # #   #     # # #   #   # #     # #
 ##### ### # # ##### ####### # ### ### ### # ##### # # # ##### #
 #   #     # # #     #   # # #         #   #       #   # # #   #
 # # ####### ### ##### # # # # ######### ####### # ### # # # # #
   # # #   # #   #     # #   #     #   # #     # # # # # #   # #
 ### # # # # # ### ##### ### ####### # # # ### ### # # # ##### #
   #   # #   #   # #   # #   #     # # #   # # #   #         # #
 ##### # ##### ### ### # ##### ### # # ##### # # ##### ##### # #
 #   # #   # # #   #   #       # #   #       # # #     #   # # #
## # ##### # # # ### # ######### ##### # # # # # ####### # # # #
   #       #   # # # # #     #   #     # # # # # #     # # #   #
 ######### ##### # # # ### # ### # ####### # # # # ### # # ### #
       #   #     #   #   # #     # #       # # # # # #   #   # #
 ##### ##### ########### # ##### # ####### ### # # # ####### # #
   # #       #       #   # #  S# #   #   # #   # #   # #     # #
 # # ######### ##### # ##### # # ### # ### # ######### # ##### #
 #   #       # # #   #     # # #   # #     # #       #   #   # #
 ##### ##### # # # ####### ### ### # ####### # ##### # ### # # #
     #     #   #   #     #   #     #         # #   # #     # # #
 ### # ### # ####### # ##### # ############### # ### ####### # #
   #     # #         #         #       #     # #     # #   # # #
## ####### # ##### ########### # ##### # ### # ### ### # ### # #
 # #   #   #     #   #       #   #     #   # #   # #     #   # #
 # # ### ### ### ##### ##### # ### ####### # ### # ##### # ### #
   # #   #   # #       #     # #   #       #     #     #       #
#### # ### # # ######### ####### ##################### ### #####
   #   #   #       #   #   #     #   #               #   # #   #
 # ############# ### # ### # ##### # # ####### ######### # # # #
 #             # #   #     # #     # # # #   #   #       # # # #
 ############# ### ######### # ##### # # # ##### # ####### # # #
   #       #   #   #     #     #   # # #     #   # #         # #
 # # # # ### ### ### ### ##### # # # # ### # # ### # ######### #
 # # # # #   #   #   # #     #   # # #   # # #     #   #       #
## # # # # ##### # ### ##### ####### ### # # ######### #########
   # # #         #     #   #       #     # #   #     #       # #
 ##### ############### ### ####### # ##### ##### ########### # #
     #   #G    #     #       #   # #             #     #   #   #
 ### ### # ### # ### ####### # ### # ### ##### ### ### # # ### #
   #   # #   #   # #   #   # # #   #   # #   # #   # # # #   # #
## ### ##### ##### # ### # # # # ### # ### # ### ### # # # ### #
     #             #     #   #   #   #     #         #   #     #
################################################################
