################################################################
   #     #   #     #       #     #   #   #               #     #
## # ### # # # ### ####### # # # # ### # ######### ####### #####
   #   # # #   # #   #     # # # #     #         #   #     #   #
 ####### # ##### ### # ####### # ############### ### # ##### # #
 #       #   # # #   #       # # #   #   #   #   #   #       # #
 # ##### ### # # # ######### # # # # # # # # # ### # ######### #
 #     # #   #   # #   #   #   #   # # # # #       #           #
 ####### # ### ### # # # # ######### # # # ######### ######### #
         # #     #   # # # #   #   #   # #   #     # #       # #
#### ##### ##### ##### # # ### # ####### ### # ### # # ##### # #
   # #     #   #   #   # # #   #       # #   #   # # # #   #   #
 # # # ##### # ### # ##### # # ####### # # ##### # ### # ##### #
 #   #   #   #   # #     # # #   #     # # #     #     #   #   #
 ####### ####### # ##### # ##### # ##### ### ############# # ###
       #         # #   # # #       #   # #   #           # #   #
###### ########### # ### # # ##### # # # # ### ####### # # ### #
   #       #         #   #   #   # # #   # #     #   # #     # #
 # # ##### # ######### ####### # # # ##### ####### # ### ##### #
 # #     # #     #   # #     # #           #     # #   #       #
 ####### # # ### # # # ##### # ######### ### ### # ### # #######
         # #   #   # #   #     #   #   # #   # #   # # #   #   #
########## # # ######### ####### # # ### # ### ##### # ### # # #
   #       # # #       # #   #   # #   # #   # #   # #S  # # # #
 # # ####### # # ### ### # # # ### ### # ### # # # # ### # # # #
 #   #       # #   #   # # #   # #   #     #   # #   #   #   # #
 ##### ########### ### # # ##### ### ########### ##### ####### #
   #         #     # #   # #   # # #       #   #   #   #       #
## ### ####### ##### ##### # ### # ####### # # # # # ##### #####
       #       #   #             # #   #   # # # # # #   # #   #
###### # ######### # ##### ####### ### # ### # # ### # # # # # #
     # # #         #     # #   #       #   # #   #   # # #   # #
 ### # # # ######### ### # # # # # ####### ##### # ##### # #####
 #   # #         #     # #   #   #     #   #       #       #   #
 # ### # ####### # ### # ######### ### # ### ##### ### ##### # #
 # #     #     #   #   #     #   # #   #   # #   #   #   #   # #
 # # ##### ### ### ######### # # # # # ### ### # ### ### # ### #
 #   #   #   #   # #   #   #   # # # #   #   # #   #     #   # #
 ### # # ### ### # # # # ####### ### ### ### # ### ##### ##### #
 #   # #   #   # # # # #         #   #     #   # # #       #   #
## ### ### ### # ### # ########### ############# # # ####### ###
     # # #   # #     #     #   #     #       # #   #         # #
 ##### # ### # ########### # # # ### # ### # # ##### ######### #
           #   #         # # # #   #   #   #       #   #       #
 ############### ####### # # # ######### ##### ### ### # #######
 #     #    G  # #       # # #   #       #   #   #   # #   #   #
 # ### # ##### ### ##### # ##### # ######### # # ##### # # # # #
 # #   #   # #   #   # # #       #     #     # # #     # #   # #
 # # ##### # ### ### # # ############# # ##### # # ##### ##### #
   #   #   # #   #   # #     #       #   #     #   #     #   # #
###### # ### # ### ### ##### # ##### ##### # # ##### # ### # ###
 #     #   #   #   #           #   #   #   # # #   # #     #   #
 # ####### ########### ######### # # # # ### # # # # ######### #
   # #   #     #     # #     #   # # #   #   #   # # #   # #   #
 ### # # ##### # ### # # ### # ### ####### ####### # ### # # ###
 #   # # #   #   #   # # # #     #   #     #   #   #   # # # # #
 # # # ### # ##### ##### # ######### # ##### # # ##### # # # # #
 # # # #   # #   #     # #   # #   # # #     # #       #   # # #
 ### # # ### ### ##### # # # # # ### # # ##### ########### # # #
   #     # #     # #   #   #   #     # # #   # #   #       #   #
## ####### ##### # # ####### ######### ### # # # # # # #########
 #   #             # #       #   #   #     # #   # # # #   #   #
 ### ############# # # # ### # # ### # ##### ##### # ### # ### #
                       #   #   #     #     #             #     #
