################################################################
#                 #   #     # #   #         # #     #       #   
# ######### ### # # ### ### # # ### # ##### # # ### ##### # ### 
#   #       #   # #     #   # #     # #     # # # #   #   #     
### # ########### ####### ### ##### # ### ### # # ### # ##### ##
# # #           #     # # #         #   # #   #   # # # #     # 
# # ########### # ### # # # # ##### ### # ### ##### # # ##### # 
# #   #   #   # #   #   # # #     # #   #   #       # #     #   
# ### # # ### # ### ##### ####### # # ##### # ####### # ### ### 
#   # # #     # #   #     #     # # # #   # #     #   #   #   # 
### # ##### ### # ### ##### ### # # # ### # # ### # ### ##### # 
#   #   #   #   #   #     #   #   # #   #   # #   # #   #     # 
# # ### # # # ########### ######### ### # ### ##### ##### ##### 
# # # # # # #   #       #         # #   # #   #   #       #     
### # # # # ### # ############### ### ### # ### # ######### ### 
#   # #   #   #   #                   #   #   # #       #   # # 
# ### ####### ##### ################### ### ### # ##### # ### # 
# #     #   #       #           #     #   # #   # #   # # # # # 
# # ### ### ####### # ######### # ####### # # ##### # ### # # # 
# #   # #           #   #       #         # #   #   # #   # # # 
# ### # # # ########### # ############# ### ### # ### # ### # # 
#   # #   # #           #         #   #         # # #   #   #   
### # ####### ################### # # ### ####### # ##### ##### 
#   #   #     #     #   #      G#   # #   #       #     #       
# ##### # ##### ### # ### # # ####### # ### ########### ####### 
#       #   # # # # # #   # # #     # # #   #           #       
####### ### # # # # # # ### # # ### # # # ### ############# ### 
#   #   #   #   # # #   #   # # # #   # #     #   #         #   
# # ### # ### ### # # ####### # # ##### ####### # ### ####### # 
# #   # # #   # #   #       # #   # #     #     #   #       # # 
# ### ### # ### ##### ##### # ##### # # ### ####### ######### # 
#   #   #             #   # #       # # #   #   # #       #   # 
####### # ######### ### # # ### ### ### # ### # # ####### # ### 
#       # #       #   # # #   #   #     # #   #         #   #   
# ####### # ##### # # # ##### ### # ##### # ########### ####### 
#     #   # #     # #   #   # #   # #     #     #   # #       # 
##### # # # # ##### ##### # # # ##### ######### # # # ####### # 
#     # # # # #   #   #   #   # #   # #     #   # #     #   #   
##### # ### # ### ##### ####### # # # # ### # ######### # ##### 
#   # #     #     #     #     #   # # #   # #         #         
# # # # ########### # ### ### ##### # ##### # ####### ######### 
# # #       #   #   # #   #   #     #       #       #         # 
# # # ####### # # ##### ### ##################### # ######### # 
# #   #       # #       # #     #     #     #     #   #   # # # 
# # ### ####### ####### # ##### # ### # ### ####### # ### # # # 
# # #   #   #   #     # #       # #     # #     #   #       # # 
# # # ### # # ### ### ########### ####### ##### ######### ### ##
# # #     # # #   # # #   #     #     # #     #         #   #   
### ####### # # ### # # # # ### ##### # # ### ######### ### ### 
#   #   #   # # #   # # # # # #       #   # # #   #   #   #   # 
# # # ### ### # ### # ### # # ############# # # # # ##### ##### 
# # # #   #   #     #   # # #     #   # #   # # #   #   #       
# # # # ### # ##### ### # # ##### # # # # # # # ##### # ####### 
# #   #   # # #     #   # # #     # #S# # #   # #     #         
##### # ### ### ##### ### # # ##### # # # ##### # ############# 
#     # #   #   #   #     # # #   # #   # #     # #   #     #   
# ##### # ### ### # ####### # # # # ### # ### # # # # # ### ### 
# # #   #   #     # #     # # # #   # # # #   # #   # # # #   # 
# # # ############# # ### # # ####### # # # ### ##### # # ### # 
# # # #       #     #   # #   #   # # # # # #   #   #   #   # # 
# # # # ####### ####### # ##### # # # # # # # ### # ####### # # 
# # # #       #       # #   #   # #     # # # # # #   #   #   # 
# # # ####### ####### # ### # ### ##### # # # # # ##### ####### 
#                       #     #             #                   
