################################################################
#       #         #   #   #   #             #   #             # 
# # ### # ##### ### # # # # # # ####### # # ### # ######### # # 
# # # # # #   # #   # # #   #   #       # #     # #       # # # 
### # # # # # # # ### # ######### ####### ####### # ##### ### # 
#   # # # # #   # # # # #     # # #     #     #   #     #       
# ### # ### ##### # # # # ### # # # ##### ### ########### ######
#     #   #   #   #   #   #   # # #       #   #   #     #       
######### # ### ########### ### # ####### # ### # # ### # ##### 
# #       # #   #   #     #   # #     #   #   # #   #   #     # 
# # ####### # ##### ##### ### # ##### # # ### ####### ### ##### 
# #     #   #     #   # #     #     # # # # #         # # #     
# ##### # # ##### ### # # ######### # # # # ########### # # ####
# #       #   # #   # #   #       #   # #   #   #         #     
# ### ####### # ### # # ### ##### ##### ##### # # ############# 
#     #   #         #   #   #   # #   #       #   #           # 
### ### # # ##### ### ### ### # # # # # ##### ##### ##### ##### 
#   #   # # #   #     #     # # #   # #     #     #     # #     
# ### ### # # # # ##### ##### ####### ##### ##### # ### # # ####
#   # #   # # # # #     #     #   #   # #   #   #   #   # #     
##### ### ### # # # ##### ##### # # ### # ### # ##### ### ######
#   #   #     # # #     #       #   #   #     # #   # #   #     
# # ### ####### # ##### ############# ##### ### # ### # ### ### 
# # # # #     #     #   #       #   #     #   # #     #   # # # 
### # # # ######### # ##### ##### # ##### # ### # ######### # # 
#   #   #           # # #   #   # #   # # # #   # #       # #   
# ####### ##### ##### # # # # # ##### # # ### ##### ##### # ####
#   #     #   # #   # #   # # #   #   # #     #     #   #   #   
### ### ### # # ### # ##### # ### # ### ### ### ##### # ##### # 
#   #   #   # #     #     # #   #   #       #   #     #   #   # 
# ### ### ### ##### ##### # ### ##### ### ### ### ####### # ### 
# #   #   #   #     #  S#     # # #   #   # # #   #     #   #   
# ##### ### ### ##### ##### ### # # # # ### # ##### ### ##### ##
#     #   #   # #   # #   # #   #   # #   # # #   #   #     #   
##### ### ### # # # # # # # # ####### ### # # # # ####### # ### 
#   # #   # # #   #     #   # #         #   # # # #     # #     
# # # # ### # ######### ##### # ####### ##### # ### ### # ######
# # # # #         #     #     # # #   #     # #     # # # #   # 
# ### # ######### # ### # ##### # # # # ### # ####### # # ### # 
#     #         # # #   #   #   # # #   #   # #   #     # #     
# ##### ####### # ### ##### # # # # ######### # # # ##### # ####
# #     #       #   #       # #   #   #     # # #           #   
# ####### ######### ##### ############# ### # # ##### ### ### # 
#         #   #   #       #           # #   # #     #   #   # # 
########### # # # ####### # ######### # # ### # ### ### ##### # 
#         # #   #       # #   #     #   #       #   #   #     # 
# ######### ########### # ### # ### ####### # ### ### # # ##### 
#   #   #   #     #   # #   #   #   #     # #   #   # # #   # # 
### # # # ### # ### # ### ##### # ##### # # ### # # # ##### # # 
# #   # #     # #   #     #   # # #     #   #   # # #       #   
# ##### ### ### # ######### # ### # ############# # ########### 
# #   #     #   #       #   #   # #     #     #   #       #   # 
# ### ##### # # ### ##### ##### # ##### # ### ### ####### # # # 
#   #       # # #   #G    #   # #   #   # #   #         #   # # 
### # ####### # # ### ##### ### ### # ### # ### ############# # 
#   #   #     # #   #     #   #   # # # # # #               # # 
# ##### # ##### ### ##### ### ##### # # # # ####### ####### # ##
# #   # #   # # # # #   #         # # #   # #     #   #     #   
# # # # ### # # # # # ########### # # ##### # ### # ### # ##### 
#   #     #   #                 # # #   #   #   # # #   # #   # 
##### ####### ### # ####### ### # # ### # ##### # ### # ### # # 
#     #     # #   # #     # # # #   # #   #     #     # #   # # 
# ##### ### ### ### # ### # # # ##### ##### ########### # ### # 
#     #   #     #   #   #   #               #           #   #   
