################################################################
   #     #           #       #       #     #   #               #
## # ##### # # ####### ####### ### ### ### ### ### ##### ##### #
   #   #   # # #       #       # #       #   #     #     #     #
 ### # # ### # # ####### ####### ########### # ##### ##### #####
   # # # # # # # #       #       #     #   # # #     # #   #   #
## # ### # # ### # ####### ##### ##### # ### # # ##### # ### # #
   # #   # #     #   #     #     #     # #   # # #     # # # # #
 ### # ### ######### # ### # ##### ##### # ##### # ##### # # # #
 #               #   # #   #   #   # #   # #     # #     #   # #
 ##### ####### ### ##### ##### # ### # ### ### ### # ######### #
     #       # #   #     #     #   # # #     #   # # #       # #
#### # ##### ### ######### ####### # # ##### # # # # # ##### # #
     #     #     #   #     #       # #     # # #   #   #   # # #
 ######### ####### # # ##### ### ### ##### # ########### # # # #
   #     # #     # #       #   #     #   # # #     #     #     #
## # ### # # ### # ##### # # # ####### # # # # ### ########### #
   # # # # # #   # #   # #   #         # #   #   # #   #       #
 ### # # # # # ### # # ### ######### ### ######### # # # ##### #
 #   #   #   #     # #   # #       #   # #       #   # # # #   #
 # ### ########### # ### # # ##### ##### # # ### ##### # # # ###
 # # # #           #   # # #   # #       # # # # #     # #   # #
 # # # ### ############# # ### # ########### # # ##### # # ### #
   # #   # #             #   # #       #   # # #     #   #   # #
#### ### # # ############# # # ####### # # # # ##### ####### # #
   #   # # # #       #     # #     # # # #   #     # #     #   #
 # # ### # # # ### # # ### # ### # # # # ####### ### # ### ### #
 #           # #   #   # # #   # # # # # #     #         #     #
## ########### # ####### # ##### # # # ### ### # ############# #
     #     #   #       #     #   #   #   #   # # #   #   #   # #
 ### # ### # # ####### ##### # ######### ##### # # # # # # # # #
   #   #   # #   #   # #     #       #   # #   # # #   # # # # #
 # ####### ##### # # # # ########### # ### # ### # ##### ### # #
 # #     # #   #   # # #       #   #   #         #   # #     # #
## # ### # # # # ### # ######### # ##### ####### ### # ####### #
   # #   # # # #   # #     #     #         #   #   # #       # #
 ### # ##### # ### # ##### # ####### ##### # # ##### # ####### #
   # #       #   # # #   #   # #   # #  G#   #      S# #       #
## ############# # # # ####### # ### # # ############# # # ### #
 #     #         # # #   #       #   # #     #       # # # #   #
 ### ### ######### # ### # ### ### ### ##### # ##### # # # ### #
   #   # #   #   # #   # #   #   #     #   #   #     # # #   # #
## ### # # ### # # ### # ### ### ####### # ##### ##### ##### # #
     # # #   # # # #   #     # #         # #   # #   #       # #
#### # # ### # # # # ####### # # ########### ### # # ######### #
     #   # #   #   #       # # #             #   # #       #   #
 ### ##### ### ########### # # ############### ########### ### #
   #       #   #   # #   # # #   #       #   #       #   #     #
## # # # # ### # # # # # # # # # # ##### # ######### ### ##### #
   # # # #     # #   # # # #   # #   #     #   #   # #   #     #
 ##### # ##### # ##### # # ##### ##### ##### # # # # # ### # ###
   #   # #     #     # #   #   #         #   # # # # #     #   #
## # # # ##### ##### # ####### ### ##### # ### # # # ### ##### #
   # # #     # #   #   #         # #   # #   #   #   #   #   # #
 ### # ##### # # # ##### ######### # # ##### ############# # # #
   # #     # #   #   #   #   #   # # #   #   # #   #   #   # # #
## # ####### ### ### # # # # # # # # ### # ### # # # # # ### # #
 # #   #   #   #   #   # # #   #   # #   # #   # # # # # #   # #
 # ### # # ### # ####### # ######### # ### # ### ### # # # ### #
   #   # # #   #       #   #   #     #     # # #     #   # #   #
#### ### # # ######### ##### # # # ######### # ########### # # #
     #   # # #       #     # # # # #   #   #           #   # # #
 ##### ### # ####### ### # # # # ### # ### # # ####### # ### # #
       #   #         #   #   # #     #     # #       #       # #
