################################################################
################################################################
           #   #   #       #   #     #     #   #     #         #
########## # # # # ####### # # ##### ### ### # # ##### ####### #
     #   #   # # #         # #     #   #     #   #   # #       #
 ### # # # ##### ######### # ##### ### # ######### # ### #######
   #   # #       #       # #     # #   # #   #   # #     #     #
## ##### ##### ### ##### # ####### ### # # # # # # ####### ### #
 # #   # #   # #   #   # # #     #   #     #   #   #   # #   # #
 # ### # # # # # ##### # # # ### ### # ######### ### # # ### # #
 #   # #   # # #     #   #     #     # #       #     # # #   # #
 ### # ##### # ##### ######### ####### # ##### # ##### # # ### #
     #     # # #     #G      #           #   # # #   # # # # # #
 ##### # ### # # ##### ##### ############### # # # ### # # # # #
 #     #   # #     #   #   #   #         #   # # #     #   # # #
 # ####### # ##### # ### # ### # ####### # ### # ####### ### # #
 # #     # # #   # #   # # # # # #   #   #   # #           #   #
 # # ### ### # # # ### ### # # # # # # ### ### # ##### # # #####
   # # # #   # #     # #   # # # # #   #   #   # #     # #   # #
## # # # # ### ##### # # ### # # # ##### ### ##### ##### ### # #
   #   #   # #   # # #       #   # #   #   #     #   #   #   # #
 ########### ### # # ### ##### ### # ### # ##### ### ### # ### #
 #     #         #   #   #   #   # # #   # #   # # #   # #     #
 # ##### # ######### # ### # ##### # # ### # # # # # # # #######
 #       # #       # # #   #       #   #   # #   # # # # #     #
 # ####### # ##### # # # ########### ####### ##### # # # # ### #
 # #   #   #   #   # # # #           #     # #     # # #     # #
 ### # ####### # ### # # ##### ### ### ### # # ##### # ####### #
 #   # #   #   #     # #     # # #   # # # # # #   # # #   #   #
 # ### # # # ### ##### ##### # # ### # # # # # # # ### ### # # #
   #   # #   #   #     # #   # # #   #   #   # # #   # #   # # #
#### ######### ### ##### # ### # # ########### # ### # # ### ###
   #   #       #   #   #   # #   #       #     # # #   # #     #
 # ### # ####### ##### ##### ### ####### # ##### # ##### ##### #
 #   # # #     # #                   # # # #     #     #       #
 ### # # ### # # ##### ############# # # # # ##### # # ####### #
   # # #   # # #     # #       #   # #   #   #   # # #   #     #
#### # ### ### ##### ### ##### # # # ##### ##### # # ### # # ###
     # # #     #   #   #   # # # # #       #   #   #   #   #   #
 ##### # ##### # # ### ### # # # # ######### # ### ####### ### #
 #     # #   # # #   # # #   # # # #         # # # #     # #   #
 # ##### # ### # ##### # ### # ### # ######### # # # ### ### ###
 #     #   #       #     #   #     #     #     # # #   #   # # #
 ##### # ### ####### ##### ############# # ##### # ####### # # #
 #   # # #   #       #   # #   #   #     # # #     #   #   #   #
 # # # # # ### ####### # # ### ### # ##### # # ##### # # #######
   #   #   # #     #   # #   #     # #   # #   #     # #       #
 ######### # # ##### ### ### # ##### # ### ##### ### # ####### #
             # #   #   # # #   #     #   # #     #   #   #     #
########## ### # # ### # # ### # ####### # # ##### ##### # #####
         # #   # #   # # #   # #         #   #     # #   # #   #
 ####### # # ### ### # # # ### ############### ##### # # # # # #
 # #     #   #     # # #   #   #                 #   # # # # # #
 # # ####### # ### ### ### # ##### # ######### # # ### ### # ###
 #   #     #   #   #   #   #     # #   #       #   # #     #   #
 ##### ### ##### # # ##### ##### ##### # ##### ##### ####### # #
     #   #     # # # #   #S#   #     # # #   #       # #     # #
#### ######### # # # ### # ### ##### # # # ########### # ##### #
   #       #   # # #   # #   #   #   # # #     #       # #   # #
 # ####### # ### # ### # ### ### # ### # ##### # ### # # # # # #
 # #   #   #     #   #   # #     #     #       # #   # # # #   #
 # ### # ########### ##### ##### ####### ####### # ##### # #####
 #                                               #       #     #
################################################################
