################################################################
################################################################
#   #         #       #   #   #       #   # #             #     
### # ####### # ##### # # # # # ### # ### # # ######### # # ### 
#   #   #       # #   # #   #   #   #   #   #       # # # # # # 
# ##### ######### # ### ####### # ##### ### ####### # # # # # # 
#     #           #   # #       #   # # #   #   #   # # # #   # 
# ################### # ##### # ### # # # # # # # ### # ####### 
#   #       #   #   # # #   # #   # #     #   # # #   #       # 
# ### # ### ### # # # # # # # ##### ######### ### ### ####### # 
# #   #   #     # # # # # # # #   #     #   #   #   # #     #   
# # ##### ##### # ### # # # # # # ##### # # ### ### # # ########
#     # #     # # #   # # #   # # #     # #         # #   #     
##### # ##### ### # ### # ##### # # ##### ##### # ### # # # ### 
#   #       #   # #   # #   #   # #     #     # #     # #   # # 
# # # ######### # ### # # # # ######### ####### # # ### ##### # 
# #   #     #   #   #   # # #             #     # #     # #   # 
# ### # ### # ##### ####### ############### ##### ### # # # ### 
#   # #   # #       #  S  #           #   # #   #   # #   #     
##### ##### ######### ### # # ######### # # # # ### # ######### 
#           #   #     # #   #       #   #   # #     #       #   
# ####### ### # # ##### ########### # ####### ############# ### 
#   #     #   #   #                 #   #   # #   #       #   # 
### # ### # ####### ##### ##### ####### # ### # # # ##### ### # 
#   # #   #       # #   # #     #   #   #     # # #     #   # # 
##### # ######### ### # # ####### # # # ####### # ##### ##### # 
#     #   #     #   # # #         # # # #   #   #   # #   #   # 
# ####### # ####### # # ########### # ### # ####### # ### # ### 
# #       # # #   #   # # #         #     #       #     #   #   
# # ####### # # ####### # # ####### ############# ### ######### 
# # #   #     # #     # # # #                   #   #           
# # # # # ##### # ### # # # ##### ##### ##### ##### ####### ####
# #   #   #     # #     # # #   #     #     #     #       # #   
######### # ##### ####### # # # ##### ##### ### ######### # ### 
#         # #   #     #   #   #   #   #   #   #     #     #     
# ######### # ####### # ######### # ### # ### ##### # ######### 
#   #     # #   #     #           # #   #   #   #   #   #     # 
# ### ### # ### # # ############### # ##### ##### ##### # ### # 
#     #   # #   # # #   #     #         #   #   #     #   #   # 
# ######### # ### ### # # ### ########### ### # ### # ##### ####
#   #   # # #   #   # #   # #   #       #G#   #     #     #     
### # # # # # # ### # ##### ### # ##### # # ######### ### ##### 
# # # # # # # # #   #   #     # #     # # #         #   #   #   
# # # # # # # ### ####### ### # ##### ### ####### # # ####### # 
# # # # # # #   # #       # #   #   #   #       # # #   # #   # 
# # # # # # ### # # ####### ##### ##### ####### # # ### # # ### 
#     #         #   #     #   #       #         # #   # # # #   
# # ########### ##### ### # # # ################# ### # # # ### 
# # #     #       #   # #   # #     #       #   #   # #   #   # 
# # # ### ##### # # ### ########### # ##### # # # # # ####### # 
# # #   # #     # # #   #     #   #   #   #   #   # #       # # 
# # ### # # ##### # # # # ### # ####### # ######### ##### # # ##
# # #   #   #     # # #   #   #         #   #         #   # #   
### # ####### # ### # ##### ##### ######### # ### ##### ####### 
#   #       # # #   # #   # #     #   # #   # #   #   #     #   
# # ######### # # ### # # # # ### # # # # ### ### # # ##### # ##
# # #       # # # #   # #   # #   # # #       #   # #     # # # 
# # # ##### ### # # ### ##### # # # # ######### ### ##### # # # 
# # #     #   # #   # #       # # # #         # #   # #   # # # 
# ####### ### # ##### ########### # ######### ### ### # ### # # 
#   #   # # # #     # #   #       # #   #   #   # #   #   # #   
# # ### # # # ##### # # # # # ##### # # # # ### # # ##### # ####
# #     #   #           #   #     #   #   #   #   #             
################################################################
