                                                               #
######## ############# # ####### ##### ### #####################
 #     #   #         # #   #   # #   # #   #   #   #         # #
 # ### ### # ####### # ##### # ### # # # # # # # # # ####### # #
 # #       # #     # #   #   #     #   # # # #   # # #   #   # #
 # # ####### # ##### # # # ######### ### ### ##### # # # # ### #
   #   #     # #     # # # #       # #   #   #   # # # # #     #
###### # ##### # ####### # # ####### # ### ### # # # # # #######
     # # #   # # #       # #         #   #   # #   #   #   #   #
 ### # # # # # # ##### ### ######### ### # ### ##### ##### # # #
 #   # # # # # #   #   #   #           # # #   #         #   # #
## ### # # # # ### # # # ####### ##### # # # ### ####### ##### #
   #   # # # # # #   # # #       # #   #   #   # # #   # #     #
 ### # # ### # # ####### # ####### # ######### # # # # ### #####
 #   # #   # #   #       #       #   #   #     # # # # #   #   #
 # ### ### # ### # ### ######### ##### # # ##### # # # # ### # #
   #   # #   #   # #   #   #   #   #   # # #   # # # #   # # # #
#### # # ##### ### # ### # # # ### # ### # ### # # # # ### # # #
     #   #   #   # #   # #   #   #   #   #   # # # # # #   # # #
 # # ##### # ### # # ### ####### ### # ##### # # # # ### ### ###
 # #       #     # # #   #     #   # #   #   # #   #     #     #
 ### # ### ####### ### ### ### ### ####### ### ### ####### ### #
 #   #   # #     #     #   #   # #       # # # #     #     #   #
 # ##### # # ### ######### # ### ####### # # # ##### # ##### # #
 #   #   # #   # #       # #     #     # # # #     #   #     # #
 ### # ######### # ##### # ####### ##### # # ##### ##### ##### #
   # #           # #     # #       #   # # #       #   #   #   #
#### ##### ####### # ##### # ####### # # # # ####### # ### # ###
   #     #       # # #     # #     # #   # #       # #   # #   #
 # ##### # ##### # # # # ### # ##### ### # ####### # ### # ### #
 #       # #   # # #   #   #   #   # #   #     #   # #   # #   #
 ######### # ### ####### # # ### # # # ####### # ### # ### # ###
 #         #     #     # #   #   #   #   #     # #   #     # # #
 ######### ####### ### # ##### ########### ##### ########### # #
     #       #       # #     # #   # #   # #     #           # #
#### # ####### ####### # ##### # # # # # # # ##### ### ####### #
   # #   #   # #   #   # #   #   #   # #   # #       #       # #
## # # # # # # # ### ### # # ######### ##### # ##### # ### ### #
   # # #   #   # #   #     # #       #   # # # #     #   #     #
 ### # ######### # ##### ##### ##### ### # # # ############# ###
     #     #   #   #   # #     #   #     #   #     #       #   #
###### # ### # ####### # # ### # # ####### ####### # ##### ### #
   #   #     #   #   # # # #   # #   #   #   #     # #   #   # #
 ### ### ####### # # # # # ### # ### # # ### # ##### # # ### # #
     #   #     # # # #   #   # #   # # # #   # #     # #     # #
###### ### ### # # # ### ### ####### # # # ### # ############# #
     #   #   #   # #   # # #         # # # #   # #           # #
 ##### # ### ##### ### # # ########### ### # ### # ######### ###
   #   # # #   #   # #   #   #         #   #     #   # #   #   #
## # ### # ### # ### ####### ##### ##### ### ####### # # ##### #
S#   #   #   # #       #   #     # #   # #   #       # # #   # #
 ### # ##### # ####### # # ##### # # # # # ### ####### # # # # #
     # #   # #G      # # #       #   #     #   #       # # #   #
 # ### # # # ####### # # ######### ######### ##### # # # # #####
 #   #   # #   #   #   #     #             # #   # # #   #     #
#### ##### ### # ########### # # ######### # # # # # ######### #
         #     #   #     #   # #     #     #   # # # #         #
 ### ### ######### # # ### ### ##### ### ####### # # # #########
 #   #               #     # #     #   # #       # #   #       #
 ##### ############# ####### ##### ### # # ####### ##### ##### #
     # #   #       # #             # # # #   #     # #       # #
#### # # # # ##### # # ############# # ####### ##### # ##### # #
     #   #   #     #                 #                 #     # #
################################################################
