################################################################
#         #     #   #                         #         #       
# ####### # ### # ### ### # ########### ##### # ####### # ##### 
#     # # # # #   #   # # #         # #     #   #     #   #     
# ### # # # # ### # ### # ####### # # ##### # ### # ####### ### 
#   # #     #     # # # # #     # # # #   # #     #       # #   
##### ########### # # # # # ### ### # # # # ### # ### ### # ### 
#     #         # #   #   #   #     # # #   #   #   # #   # #   
# # ### ####### # # ######### ####### # ##### ####### # ### # ##
# # #   #   # # # # #     # # #     #   #     #       #   #G#   
# ### ##### # # # # # ### # # # ### ####### # ########### # ####
#   #       #       # #   #   #   # #     # #   #       # #     
# # ########### ##### # ########### ### # # ### ####### # ##### 
# #       #   # #   # #           # #   #   #   #     #     #   
# # ####### # # # # # ########### # # ##### # ### ### ##### # ##
# #   #     # # # # #   #     #   #   #     #   #   #     # #   
# ### # ##### # # ##### # ### # ####### ####### # ####### # ### 
#   # #   #           #   #   #   #     #     #   #   #   # #   
### # ### ####### ##### ######### # ######### ##### # ##### # ##
#   #   # #       #     #     #   #               # #   #   #   
######### # ##### # ##### ### # ############# ##### ### ####### 
#     #   # #     # #   #   #   #           # #   # # #       # 
# ### # ### # ##### # ##### ##### ######### ### # # # ####### # 
# # #   #   # #   # # #   # #   # #       #   # # #   # #     # 
# # ### # ### ### # # # # # # # # ##### # ### # # ##### # ######
# # # # # # #   # # #   #   # #   #   # #   # # # #     # #     
# # # # # # ### # # ######### ##### # ### # # # # ##### # # ### 
#   #   # #   #   #     #   #   #   # #   # #   #       #   # # 
####### # # ##### ##### ### ### # ### # ### ################# # 
#       # #           # #   # # # # #   #   #   #             # 
##### # # ### ##### ### # # # # # # ##### ### # # ##### ##### # 
#     # #   # #   #     # #   #   #   # #   # # #     # #   # # 
# ##### ### ### # # ##### ### ##### # # ### # # ##### ### # ### 
#   #   #   #   # #       #         # #   # # # #     #   #   # 
# # # # # ### ### ############# ##### # # # ### # ##### ##### # 
# # # # #   # # #     #   #  S#     #   #             # #   # # 
# # # ##### # # ##### # # # # ##### ##### ########### # # ### # 
# # # #     # #     #   # # #       #     #       #   # # #   # 
# # ### ##### # ######### # ######### ##### ##### # ### # # ### 
# #   #   # # # # #     # #   #     #   # #   #   #     # # #   
##### ### # # # # # ### # ### # ### ### # ### ######### # # # ##
#     # #   # #   #   #   #   #   #   #   # #   #     #   #   # 
# ### # ##### ### ######### ##### ######### ### # # # ### ##### 
# #     #   #               #     #     #     # # # # # #   #   
# ####### # ################# ##### ### ##### # ### # # ### ### 
#   #   # #           #   #       # # #   #   # #   # # #   #   
# # # # # ########### ### # ##### # # ### # ### # ### # # ### ##
# #   # #   #       # #   # #   # #   #   #   #   #   # # #     
# ##### ### # # ##### # ### ### # ### ##### # ##### ### # # ####
#     #   # # #     # # #   #   #   #     # #   # # #   # # #   
# ### ### # # ##### # # # ### ##### ##### # ### # # # # # # # # 
#   #   # # # # #   #   #   # #   #           # # # # #     # # 
### # # # # # # # ##### ### # # # ########### # # # ##### ### # 
# # # # # #   #   #   #     #   #   #   #     #   #       #   # 
# # # ### # ####### # ### ### ####### # ################# # ### 
# # #   #   #       #   #     #     # # #   #   #       # #   # 
# # ### ##### ######### ##### # ### # ### # # # # ##### # ##### 
#     #     #   #     # #   #   #   #     #   #   #   # #       
##### # ####### # ### # # # ##### ################### # # ### ##
#   # #   #   # # # #     #     #   #     # #         # #   #   
# # ##### # # # # # # ######### ##### ### # # ### ##### # # ### 
# # #   # # #   #   # #   #   #     #   # # # #   #   # # #   # 
# ### # # # ########### # # ####### ##### # # # ### # # # ### # 
#     #   #             # #                   #     #     #   # 
