################################################################
#     #               #           #       # #       #     #     
# ### # ### ######### ########### # ##### # # ### # # ### # # ##
#   # # #   #   #   #   #         #   #       #   # # #   # #   
### # # # ### # # # # # # ############# ####### ##### ##### ### 
# # #   # #   #   # # #           #   #   #   # #   #   # #   # 
# # ##### # ####### ####### ### ### # ### # # ### # ### # ### ##
# # #     #       #       #   #     #   # # #     #     #   #   
# # # ########### ####### # # ####### ### # ############# ##### 
# # # #   #   #   #     # # #       #     #   #       #   #     
# # ### # # ### ##### ### # # # ############# ####### ### # ####
# #     # #   # #     #   # # #     # #       #     # #   #     
# ####### ### # # ### # ### # ##### # # ####### ### # # ####### 
# #     # #       #   # #   #     #   # #   #   #   # # #     # 
# # ##### # ####### ### ### ### # ##### # ### ####### # # ### # 
# #     #   #     #   #   # #   #   #   #   # #   #   #   #   # 
# # ### ### # ### ### ### # ######### ### # # # # # ### ####### 
# # #     # #   #     #   #     #     # # #   # # # #     #   # 
# # # ### # ### ### # # ####### # ##### # ##### # # # ### # # # 
#   #   # # #   #   # #     #   # #   # #       # #   #   # #   
####### # # # ##### # ##### ##### ### # ######### ### ##### ####
#     # #   # #   # #     #     # #   #   #     # #   #     #   
# ### ####### # # # # ######### # # ##### # ### # # ### ##### # 
#   # #     # # #   #   #   #   # # #     # # # # #   #   #   # 
### # # ### # # ##### # # # # ### # # ##### # # # # # ### # ### 
# # # # # #   # #     # # #   #   #   #   # # #     # #   # # # 
# # ### # ##### # ##### # ##### ##### # # # # ##### # # ### # # 
# #     #       #     # #       #       # #   #   # #       #   
# ####### # ##### ### ############### ##### ### # ############# 
#     #   # #       #     # #           #   #   #             # 
##### ##### # ##### ##### # # # ##### ### ### ######### ##### # 
#   #       # #     #   # #   # # #   #   # # #   #   # #S    # 
# ########### # ##### ### ### # # # ### ### # ### # # # # ######
# #     #     #     # #   #   #   #         #   #   # # # #     
# # ### # # # # ### # # ########### ########### ##### ### # ### 
# # #   # # # #   # # # #   #     #     #     #     #     #   # 
# # # ### # # # ### # # # # # ### ### ### ######### ######### # 
# # #     # # # #   #   # #   #   #     # #     #   #       # # 
# # ####### # # # # ########### ##### # # ### # # ### ##### # # 
#   #     # # # # #     #     # #   # #   #   # #   # #     # # 
####### # # # ### ####### ### # ### # ##### ### ### # # ##### # 
#       # # #   #         # #   #   #   #   #         #   # # # 
# # ##### # ### # ######### ##### ##### # ####### ####### # # # 
# #   #   #   # #   #     #     # #   #   #     # #     #   # # 
##### # ##### # ### # # # # ### # # ##### # ### ### ### ### # # 
#   # #       #   #   # # # #   # #       # # #   #   #   # # # 
# # # ####### ### ##### # # # ### ####### # # ### ### ### # # ##
# #   #         #   #   #   # #   #     # #   # #   # #   # #   
# ####### # ####### # ### ### # ### ### ##### # ### ### ### ### 
# #     # # #     # # #     #   #   # #   #     # #   # #       
# # ### # # # # ### # # # # ##### ### ### ##### # ### # ####### 
# #   # # #   # #   # # # #     #   #   #     #   # #   #   #   
# ### # ##### ### ### # ### # # ### ### # ### ### # ##### # # # 
# # # #     # #   #   # #   # #     #   # #   #   #   #   #   # 
# # # ##### # # ### ##### ### ####### ##### ##### # # # ####### 
#   # #   # # # #   # #   #      G  #   #   #   #   # # #     # 
# ### # ### # # ##### # ### # # ### ### # ##### ##### # # ### # 
# #   # #   # # #   #   #   # #   #   #   #   #   # #   # #   # 
### ### # ### # # # ######### ### # ####### # ### # ##### # # # 
#   #   #   # #   # #       # # # # #   #   # #   # #     # # # 
# ### ##### # ##### # ### # # # # # # # ##### # ### # ### # ### 
# #   #   # # #     #   # # # # # # # #       # #   # #   # #   
# # ##### # ### ######### # # # # # # ######### # ### # ##### ##
#   #           #         #   #   #                   #         
