################################################################
################################################################
#                               # #     #         #       #     
############# # # ########### # # # ### # ####### # ##### # ### 
#     #       # #       #     #   # # #   #     # #     #   # # 
# ### # ####### ####### ########### # ##### ### # ##### ##### # 
#   #   #             #   #   #   # #     #   # # #   # #   # # 
# # ##### ##### ##### ### # # # # # # ### ### # # ### # ### # # 
# # #         # #   # #   # #   #   #   # #   # #   # #     # # 
# # ######### # # # # # ### ######### # # # ### ### # ##### # # 
# #       #   # # #   #     # #       # # # #   #   #   #   # # 
# ####### ##### ##### ####### # # ##### # # # ### ### ### ### # 
#       #     #   #   #       # # #   # # # #     #   #   # # # 
##### # ##### ### # ### ### ### # # # # # # ####### # # ### # # 
#     #   #   #   #       #     # # #   # # #   #   #   # # #   
# ######### ### ########### ##### # ##### # ### # ####### # ####
#     #     #   #   #     # #   # #   #   #   # #   #     #   # 
##### # ####### # # # ### # # ### # # ####### # ### # ### ### # 
#   # # #     #   #   # # #   #   # #       #   # # #   #   #   
# # ### # ### ######### # ##### ### ####### ##### # ####### ### 
# #     # #   #   #   #   #     #   #       #     #       #   # 
# ######### ### # ### ##### ##### ### # ##### ### ####### # ### 
#           #   # #           #   #   # #     # #         #   # 
############### # # ##### # # # ### ##### ##### ############# # 
#   #     #     # #   #   # # #   #     # #     #           #   
# ### ### ####### ### # ### # ##### ### # # ### # ######### # ##
#     # #     #       # #   #     #   #   #   # # #         #   
####### ##### # ####### # ####### ##### ### ### ### ########### 
#           # # #     # #       #     #       #     #         # 
# ######### # ### ### ######### ##### # ##### # ##### ### # # # 
# #         #     # #   #     #     # # #   # # #     #   # #   
# # ####### ####### ### ##### # ### # # ### # # # ### ######### 
# #     #     #       #     #   #   # #   #   #   # #     #   # 
# ##### # ### # # ######### ##### ### ### ##### ### ##### # # ##
#   #   # # # # #         #   #G    #   #   # #     #   #   #   
##### ### # # # ############# ######### ### # # # ##### ####### 
#   #   # #   # # #         #  S      # #   #   #   #   # #     
# # ##### # ### # # ##### ########### # # ######### # ### # ### 
# #       # #   # #     #   #     # #   # #       # #   # #   # 
########### # ### ##### ### # ### # ##### ####### # ### # ### # 
#   #       # #     # #   # #   #       #         #   #   #   # 
# # # ####### # ### # ### # ########### ########### # ### # ### 
# # #       # #   #     # # #         #             # #   # #   
### # ####### ##### ##### # # ####### ####### # ### ### ### # # 
#     #             #     # #   #   # #     # #   # #   #   # # 
# ##### ####### ##### ######### ### # # ### # ### # # ### ### # 
# #   # #     #     #       #   #   # #   #   #   # # #   #   # 
# # # # # ### ##### ####### # ### ### # # ##### # # # # ### ### 
# # #   #   #     #   #     #   #     # #     # # # # # #   # # 
# # ############# # # # ####### # ##### ##### # ### # # # ### # 
# # # #           # # #         #   #       # # #   # # #   # # 
# # # # ########### ############### ######### # # ### # ### # # 
# # # #       # #   #     #       # #         # #     # #   #   
# # # ####### # # ### ##### ##### # # ####### # ####### ########
#   #   #     #   #   #     #   # #   #       #       # #   #   
# ### # # ######### ### ##### # # ##### ####### # ### # # # # # 
#     # # # #       #   #   # # #       #   #   # #   #   # # # 
####### # # # ####### # # # # # # # ### # # # ### # ####### ### 
#       #   #         # # # # # # #   #   # # #   # #   # #     
# ### ##### ########### # ### # ############# # ### # # # ######
#   # #     #   #   #   #   # #     #     #   # #   # # #   #   
### # # ##### # # # # # ### # ##### # ### # ### # # # # ### # # 
#   #         #   #   #   #   #       #     #   # #   #       # 
################################################################
