################################################################
################################################################
       # #   #     #           #               #         #   # #
## ### # # # ##### # ##### ### # # ##### ####### ####### # # # #
   # #   # #       # #   # # # # #     # #     # #     # # # # #
 ### ### # ######### ### # # # # ##### # # ### # # ### # ### # #
 #       #       # #   # # # # # # #   # #   #   #   # #   # # #
## ############# # ### # # # # # # # ### ### ####### # ### # # #
   #       #     #   # # # #   # # #   # #   #     # # #   #   #
 ### ### ### ####### # # # ##### # ### ### ##### # # ### ##### #
   # #   #   #   #   #   #   #   # # # #   #     # #   # #     #
## # # ### ### # # ##### ### # ### # # # ##### ### ### # # #####
 # # # #   #   # #     #   #         #   #   # #   # # #   #   #
 # # # # ####### ##### ### ##### # ######### ### # # # ##### # #
     # # #             #   #   # # #       # #   #       #   # #
 ####### # # ######### # ### # # ### ##### # # ### ##### ### # #
 #   #   # #   #     # #   # # #   # # #   #   #   #   #     # #
 # # # ######### ### # ### # # ### # # # ####### ### # ####### #
 # # #     #   #   #   #   # #   # # # #     #   #   #   #     #
 # ####### # # ### ### # ### ### # # # ##### ##### ##### ### ###
 #     # #   #     #       # #   # #     # #   #   #   #   #   #
 ##### # ########### ##### # ########### # ### # ### ##### # # #
     #               # #   #         #   #   # #     #   # # # #
 ### ####### # ####### # # ### ##### # ##### # ##### # ### # ###
 #     #     #   #     # # #     #   # #   # #   #   #   # #   #
## ### # # # ### # ##### # # ### # # # # # # ### # ##### # ### #
   # #   # # #   # #   # #   #   # # # # #     #   # #S  # #   #
 ### ### # ### ### # # # ##### ### ### # ##### ##### # ### # # #
   #   # #   #     # # # #   # # #   # #   # #   #   #     # # #
## ### # ### ####### # # # # # # ### # ### # ### ### ######### #
   #   # #     # #   #   # # #   # #   #   #   #       #     # #
###### # # # # # # ######### ##### ##### ##### ####### # ### # #
     #   # # #   #           #   #   #         #     #   #   # #
 ### ### # ##### ############### ### ########### ######### ### #
 # #   # #     #     #     #       #       #     #             #
 # ### ####### ##### ##### ####### ####### # ### # ####### #####
   #   #     #     # #   #   #   #       # #   #   #     #     #
#### ### ### # ### # # # ### # # # # ##### # ### ### ### ##### #
   #     # # # #   #   #   # # # # # #     #   #   #   # #     #
 # ####### # # # ### ##### # # # # ### ##### # # ### ### # #####
 # #         # # #   #   # #   # # #   #     # # #   #   # #   #
 # # ########### # ### # # ##### # # ### ##### ### ### ### # ###
 # #   #       # #   # # # #     #         #   #     #   # #   #
 ##### # ##### # ### # # # # ##### ######### ### ####### # ### #
 #     # #   #   #   # # # #   #         #   #   #       #     #
 # ##### # ####### # # # # ### # ####### # # # ### # ###########
   #     # #       # # # #     #   #   # # # # #   # #     #   #
 ####### # # ### # ### # ######### # # # # ### # ##### ### # # #
         #   #   # #   #           # #   #     #     # # #   # #
############## ### # ####### # ############# ####### # # ##### #
 #   #           #   #   #   #   #         #   #   # # # #   # #
 # # # ####### # ##### # # ##### # ####### # # # # # # # # ### #
   #   #     # #   #   # #G#     #     #   # #   # # # # #     #
######## ### # # # # ##### ######### ### ######### # # # #######
         #     # #   #   #     #     #   #     # # # # # #     #
 ####### ####### ##### # ##### # ##### ### ### # # # # # ##### #
   # #   #     #       #     #   #   #   # # # #   # # # #   # #
## # # ### ### ########### # ####### ### # # # ### # # # # # # #
   # # #   # #   #   #   # #         #   # #     # # # #   # # #
 ### # # ### ### # # # # # ### ####### ### ##### ### # ##### # #
 #   # #       # # # # # # #   #     #   #     #     # #     # #
 # ### ####### # # ### # # # ### ### ### ############# # ##### #
     #         # #     #   #     #     #                       #
################################################################
