################################################################
   #     #   #     #   #     #   # #     #                     #
 ### # ### # ##### # # # ### # # # # ### ####### ############# #
 #   #     #  S  # # #   #   # #   #   #     #   #   #     #   #
 # ############# # ### ####### ####### ##### # ### # # ### # # #
 # #   #     #   #   #     #   # #     #   # # # # #   #   # # #
 # # # # ##### ##### ##### # ### # ### ### # # # # ##### ##### #
 #   # #     # #   # #     # # # # #   #   # # # #   #   #   # #
 ##### # ### # ### # ##### # # # # ##### ### # # ### # ### # # #
     # # #   #   # #     # #     #       # # #     # #   # # # #
 ##### # ####### # ##### # # ############# # # ##### ### # # # #
     # # #       #     # # # #         #   # #   #   #   # #   #
#### # # # ########### # # # # ######### ### ### # ####### #####
   # # # #   #     #   #                 # # # # #     # #     #
 ### # # ### # ### # ##### ####### ##### # # # # ##### # ##### #
   # #     # #   #       # #     # #   #   # #       # #       #
 # # ##### # ######### # # # ### ### # # ### ### # ### ####### #
 # #     # # #   #   # # # # # #   # #   #   #   # #   #       #
 ####### # ### # # # # # # # # ### # # ### ####### # ### ##### #
       # #     # # # # #   # #   # # #   #       # # #   #   # #
###### # ####### # # ####### # # # ### # ####### ### ##### # # #
     #         #   # #         # #   # #       #   # #     # # #
 ### ##### ### ##### # ############# # ####### ### # # ##### # #
   #     # # #       #       #       # #   # #     # # #     # #
## ##### # # ### # ######### # ####### # # # ####### # ####### #
   #   # # #     # #       # # #         #           #   #   # #
 ### # ### ### # # # ##### # # ########### ##### ####### # # # #
     #   # #   # #   #   #   #         #       #           #   #
######## # # ### ####### ############# ### ### ### ##### #######
   #   #   # # #     #   #           #   #   #   # #   # #     #
 # ### ##### # # ##### ### ######### ### ### ### # # # ### ### #
 #           # #       #         #   #   #   #   # # # #   # # #
######## # # # ######### ####### ##### ### ### ##### # # ### # #
   #   # # #   #       # #     #   #   #   # #       # # #   # #
 # # ### # ##### ##### # # ### ### # ##### # ######### # # ### #
 # #     #       #   #G#   # # #   #     #         # # # #     #
## # ####### # # # # ####### # ######### ######### # # # #######
   # #       # # # #       #   #       # #           # # #     #
 ##### ####### ### ####### # ### ####### # ######### # # # ### #
       # #   #     #   # # #   #     #   # #     #   # #   #   #
######## # ### ##### # # # ### ##### # ### # ### # ### ##### ###
         #           # # # #   #   #   # # #   # # #       # # #
######## ##### ####### # # # ### ####### # ##### # # ####### # #
         #           #   #   #   #           #   # #         # #
 ####### # ### ### ########### ### ######### # ######### ##### #
     #   #   # #   #   #   # #   #   #     #   #       #       #
#### # ####### # ### # # # # ### ### # ### ### # ##### ##### # #
     #         #     # # #     #     #   #       #     #     # #
 ############# ####### ####### ##### ########### # ##### #######
   #     #     #   # #     #           #       # # #           #
## ### # # ##### # # ##### ##### ####### ##### # # ########### #
 # #   # # #   # #     #   #   #   #   # #     # # #     #     #
 # # ### # # ### ##### # ### # ##### # # ####### # # ### # #####
   #   #   # #   #   # # #   #       # #     #   # #   # #   # #
#### # ##### # ### # # # # ########### ##### # ### # # # ### # #
     # #     #   # #   # # #         #       # #   # # #     # #
 ##### # ####### # ##### # # ### ############# # ### # ####### #
 #   # #         # #   #   #   # #         #   # # # # #       #
 # ### ########### # ######### # # ##### ### ### # # # # #######
   #   #   #   #   #   #       # # #   #     #   #   #   # #   #
 ### ### # # # # ##### # # # ### # ### ##### # ##### ##### # ###
 # # #   # # #   #   #   # # #   #     #   # #     # #     #   #
 # # # ### # ####### # ### # # ####### # # ####### # # # ##### #
   #     #             #   # #         # #         #   #       #
