################################################################
#     #     #   #     #         #       #               #       
# ### # ### # # # ### # ####### # ##### ### ##### ##### ##### # 
# # #   #   # #     # #   #   #   #   #   # #     #   #   #   # 
# # ##### ######### ##### # # ##### ##### # # ####### ### # ### 
#   #   # #       #   #   # # #     #   # # #   #         #   # 
##### ### # ##### ### # ### # # ##### ### # ### ##### ####### # 
#   #     # #   #     # # # #   #   #     #   # #   # #       # 
# # # ##### # # # ##### # # ##### # ########### # # # # ####### 
# # #   #   # # # #     #         #       #   #   # # # #   #   
### ### # ##### # # ############### ##### # # ####### ### # # # 
#   # # #     # # #             #   #   # # # #     #     #   # 
# # # # ##### # # ############# ##### # # # # # ### ########### 
# # # #   #   #                     # # # # # # #   #       #   
# # # ### # ######### # ##### ##### # # # # # # # ### ##### ### 
# #     # # #   #     #     # #   #   #   # # # # #   #   #     
# ### ### ### # # ######### # # # ##### ### # # # ### # # ##### 
#S  # #   #   # #       #   # # # #     #   # # #   #   #   #   
##### # ### ### ######### ### # # # ### # ##### ### ####### # ##
# #   #   # #   #       #   # # # # #     #     #   #   # # #   
# # ##### # # ### ##### ### ### # ### # ### ##### ### # # # ### 
# #     #   #     #   #     #   #     # #       # #   # # #   # 
# ##### ########### ####### # ######### # ##### # ##### # ##### 
#   # # #       # #       # #   #         #   # #   #       #   
# # # # ##### # # ####### # ### ############# # ### # ####### ##
# # # #   #   # #   #   #     #         # #   # #   #       #   
# # # ### # ### # # # # ### # ######### # # ##### ### ##### ### 
# #   # #   # #   # # # #   #         #   #       # # #   #     
# ### # ##### ##### # # # ### ### ################# # # # ######
#   # #   #         # #   # #   #           #         # #       
### # ### # ######### ##### ### ##### # ##### ### # ### ####### 
#   #     #   #     # #             # # #       # #       #     
# ####### ### ##### # ############# # ### ####### # ### ### ####
# #     # # # #     #         #   # #         #   # #   #   #   
# # ##### # # # ############# # # ######### ### ##### ### ##### 
# # #       #G#             #   #   # #   # #   #     #   #     
# # # ####### ### ##### ########### # # # # # ### ##### ### ####
#   #     #   #   #     #   #     # # # # # # # #     # #   #   
####### # # ####### ### # # # ##### # # # ### # ##### # # ### ##
#     # #   #     #   # # #   #   # #   #     #       # # #     
# ### # ####### # ##### # ##### # # ################### # ### # 
# # # # #   #   # #     #   #   #   #       #     #     #   # # 
# # # # # # # ### # ####### # ############# # ##### # ##### # ##
#   # # # # # #     #     # # # #   #   #   #     # #       #   
##### # # # # # ##### # # # # # # ### # # ####### # ########### 
#   # #   # # #   #   # # #   #   #   #   #     # #             
# # # ##### ##### # ### ####### ### ##### # ##### # ### ### ####
# # #   #         #   #   #     #   #     #     # #   #   #     
# # ### ### ######### ### # ##### # ##### ##### # ### # # ### # 
# #   #     #         #   #       # #     #   # #     # # #   # 
# ### ##### # ######### ########### # ### # ### ####### # ######
# # #     # # #   #   # #           #   # # #           #   #   
# # ##### # # ### # ### ##### # ######### # # # # ##### ### # # 
# # #     # # #   # #   #     # #   # #       # #   #   #   # # 
# # # ##### # # ### # ### ##### # # # # ########### # ### ##### 
# #   #   # # #     #   # #   #   # # #     #       #   #     # 
# ##### ### # ### ##### # # # ##### # ##### # ######### ##### # 
#       #   #     #     #   #   #   # # #   #   #     #     # # 
####### # ####### # ######### # # ### # # ##### ##### ##### # # 
# #   # # #   #   #   #       # # #   # # # #   #   # #     # # 
# # # # # # ### ##### ### ### ### # ### # # # ### # # # ### # # 
# # #   #   #   #     #   # # #   # #   #   #   # #   #   # # # 
# # ####### # ######### ### # # ### # # ####### # ####### # # # 
#                       #     #       #       #   #       # #   
