################################################################
################################################################
#   #                 #       #               # #       #       
# # # ################# ##### ### # ### ##### # # ##### # ### # 
# # #   #     #       # #   #   # #   # #   # #   # #   # # # # 
# # ### ### # ### ### # # ##### ##### ### # # ##### # ### # # ##
# # #       #     #   #   #     #   #     # #     #       # #   
# # ################# ### # ##### # ############# # ##### # ### 
# #       #   #     #   # # #   # # #           # # #   # #     
# ####### # # # ### ### # # # # # # # ##### ##### # # # ####### 
#     # #   # #   #     # #   # # # #   # #         # #     #   
# ### # ##### ######### # ##### # # ### # ######### # ##### # # 
# # #   #     #   #     #   #   # # #   #     #   #   # #   # # 
# # ##### ##### # # ####### # ##### # ##### ### # ##### # ##### 
# # #   # #   # # #       # #       #   #   #   #   # #   #     
# # # # # # # # # ####### # ########### # ### ##### # ##### ####
#   # # #   #   #                         #   #   # #           
##### # ##### ########### ######### ####### ### ### ########### 
#   # # # #   #       #   #       # #     # #     # #         # 
# # # # # # # # ##### ### # ##### # # ### # # ### # # ####### # 
# #   # #   # #S    #       #   # # # # # # # #   # #   #   # # 
# ##### ########### ####### # # # # # # # # # ##### ### ### # ##
# #     #           #     # # # # # # # #         #   #   # #   
# ##### # ######### # ### # # ### # # # ######### ### ### # ### 
#     #   #   #   # # # #   #     #     #     #   #     #   # # 
##### # ### # # # ### # # ######### ##### ### ##### ####### # # 
#     # #   #   #   # #   #   #       #   #       #       #   # 
######### ######### # # ### # # ##### # ######### # ### ##### # 
#     #   #     #   # # #   # #     # # #   #     #   #     # # 
# ### # ### ### # ##### # ### ### ### # # # ### ####### ### # # 
#   # #   # #           # # #   # #   #   #   # #     # #   # # 
##### ### ### ######### # # ### # # ######### # ### # ### ### # 
#     #   #   #       # #   #   # # #         #     #     #   # 
# ##### ### ### ##### # ##### ##### # ############# ####### ### 
#       #   # #     # # #     #   # #     #   #     #     # # # 
# ######### # ####### # # ##### # ####### # # ####### ### # # # 
# #       # #   #   #   #   #   #     #   # #         # #   # # 
# # ##### # ### # # ### ### # ####### # ### ########### ##### # 
# #   #   #   # # #     # #   # #   # # #   #     #   # #     # 
# ### # ##### # # ##### # ##### # # # ### ####### # # # # ##### 
#   # # #   #   # # #   #         # #   #   #   #   #   # #   # 
##### # # # ##### # # ##### # # ### ### ### # # ##### ### # # # 
#     # # #       #   #     # # #     # # #   #     # #   # # # 
# ##### # ######### ### ####### # ### # # ######### # # ### ### 
#   #   #     #         #       # #   #             #   #   #   
### # ####### # # # ##### ##### # # ######### # ####### # ### ##
# # #     #   # # # #   #   #   # #           # #     # #   #   
# # ##### ####### ### # ### ##### ### # # ##### ##### # ### ### 
# #   #   #     # #   #   # #     #   # #     #   #   #   #   # 
# ### # ### ### ### ##### ### ##### # # ##### ### # ### ##### # 
#   # #   #   #     #   #   # #     # #   #     #   # #     #   
# ### ####### ####### # ### # ########### # ### ##### ##### ####
#     #     #   #     #   #   #       #   # # #                 
# ##### # # ### # ########### # ##### # ### # ##### ########### 
#     # # #     # #       #   #   # #   #   #       #     #     
##### ### ####### # ##### # # ### # ##### ####### ### ### ######
#   #   # #     #   #     # #   #   #   # #       #   # #       
# # ### # # # ####### ##### ########### # ####### # ### ####### 
# #   #   # # #     #     #       #   # #   #     #   #       # 
##### ##### # # ### ##### # ### # ### # ### # ######### ##### # 
#     #   # # #   # #   # #   # #   # #   # # #       #     # # 
# ##### # # # ### ### # # ##### # # # ### # ### ##### ##### # # 
#       #   #         #      G  # #       #         #       #   
################################################################
