################################################################
 #   #     #     #         #     # #     #             #     # #
 # # # ### ##### # ####### # ### # # # # # # ### ##### ##### # #
   #   #   #     # #   #   #   # #   # #   #   # #   #     # # #
######## ### ####### # # ####### # ### ##### # ### # ### # # # #
   # #   # #   # #   # #   #   # #   #     # #   # #   # #   # #
 # # # ### ### # # ### ### # # # # ####### # ### ##### # ##### #
 #   # #       #     #     # #   #   # #   #   # #     # #     #
 ##### # ########### ####### ##### # # # ####### # ##### # # # #
 # #   # #   #     #               # #   #       # #     # # # #
 # # ### # # # ### # ############### ####### ##### # # ### # # #
   #   #   #   # # #     #     #     #     #     # # #   # # # #
## ### ######### # # ### # ### # ##### ### ##### # # ### # # # #
           #     # # # #   #   #         #   # #   #   #   # # #
 ######### # ### # # # ##### ### ######### # # ##### # ##### # #
   #     # #   #   # # #   #   # #       # # #       #   #   # #
 ### ### # ### ##### # # # ### # # ##### # # ##### ####### #####
 #   #   #   #           # #   # # #   # # # #   # #     #     #
 # ### ##### ####### ##### # ### # ### # ### # # ### ### ##### #
 # #   #     #       #   # #   # #   # #   #   #       #   #   #
 # ##### ##### ####### # ##### # ### # ### ############### # ###
 #     # #   #   #     #   # # #   # #   # # #       #   # #   #
###### # # # # # # ####### # # ##### # ### # # ####### ### ### #
   #   # # # # # # #   # # #   #   #   #   #   #     #     #   #
 # # ### # ### # # ### # # ##### # ### # ### ### ### ####### # #
 # # # # # #   #   #     #       # #   # #   #   # # #       # #
## # # # # # ####### ############# # ### # ### ### # # ### #####
   # # # # # # #                 #   #   #   #   # # # #   #   #
 ### # # # # # # ####### ### ######### ##### ### # # # # ##### #
 # # # # # # # # #       #   #     #   #   #   # # #   # #     #
 # # # # # # # # # ########### ### # ##### ### # # ### # # #####
         #     # # #         #   #   #     # #   # #   #   #   #
 ##### ### ### # # # ####### ### ##### ### # ##### # ####### # #
 #   #       #   #   #         # #       #   #   # # #     # # #
 # # ####### ############### ### ####### ### # # # # # ### # # #
   #   #     #       #   #   #   #     # #   # #   #     #   # #
 ##### # ##### ##### # # # ### ### ### # ### # ##### ####### # #
 #     #   #       #   # #   # # #   # #   # #     # #     # # #
 ######### ### ### ##### ##### # ### # ### # ##### ### ### # # #
   #     #   #   # #   #     # #   # #     #     # #   # # # # #
## # ####### ##### # ####### # ### # ### ##### # # # ### # ### #
   #       # #   # #       #   # #   #   #   # # #   #   #   # #
 ######### # # # # ####### ##### ##### ### # ### ##### ##### # #
   #     #   # #       #   #   # #     # # #   #           #   #
## # ### ##### ######### ##### # # # # # # ### # # # ##### ### #
 # #   #       #       # #   # # # # #   # #   # # #   #       #
 # ### # ### ### ##### # # # # # ### ##### ##### # ##### # ### #
 #   # #   #         #   # # #           # #     #   #   # #   #
 ### ##################### # ####### ##### # ##### # # ##### ###
   #   #   #         #   # #   # #     #   #   #   # # #     # #
 ##### # # # ####### # # ##### # # ##### ##### ##### # # # ### #
 #     # #   # #     # #      G#   #   # #   #   #   # # # #   #
 # ### # ##### # ##### ######### ### # # # # ### # ### # # # ###
 #   # #   # #   #   # #         #   # #   #     # #   # # #   #
 ### # ### # ##### # # # ####### # ### ########### # # # ##### #
 #   #   # #     # # # # #     # # # #       #   # # # #       #
 # ####### # ### # # # # ### # # # # ####### ### # # # #########
 #         # #   # # # #   # # # # #   #   #   #   # #         #
 ############# ### # # ### # ### # # ### # ### ##### # # ### ###
 # #           #   # # #   # #   # # #   #   #       # #   #   #
 # # ########### ### # ##### # ### # # ################### ### #
 # #       #     #   #   #     #   # # #     #     #   #   #   #
 # ####### ##### # ##### ####### ### # # ### # ##### # # ### ###
                 #               #S      #           #   #     #
