################################################################
#   #       #   #         #     #     #   #           #     #   
# # ##### # # # # # # ##### ### ### ### # # ######### ##### # # 
# #     # #   #   # # #       #   #     # # #     # #  S  #   # 
# ##### # ######### # # ##### ### ##### ### ##### # ##### ##### 
#     # # #   #   # # # #   # #   #   #     #     # #   # #   # 
##### # # # # # # # ### ### ### ### # ####### ##### # # # # # # 
#     # #   # # # #   #   #     # # #   # #   #     # #   # # # 
# ##### ##### # # ### ### ####### # ### # # ##### ### ##### # # 
# #     #   # # #   #   # #       # #   #         #   #   # # # 
# ### ##### # # ### ### # # # ##### # ### ######### ##### # # # 
#   # #   #   #   #   #   # # #     #   # #     #   #   #   #   
### # # # ### ### ### # ### ### ####### # # ### # ### # ####### 
# # # # # #   # # #   #       #   #     #     #   #   # #   #   
# # # # ### # # # # ####### # ### # ######### ##### # # # # ### 
#   # #     # # # # #     # #   # # #   #   # #     # #   #   # 
##### ####### # # # # ### # ### # # ### # # # ####### ####### # 
# #   #     # # # #   #   #   #   #     # # #         #     #   
# # ### ### # # # ##### ### # ############# # ############# ### 
#   #   # #     #   # # # # #     #     #   # #         #   #   
# ##### # ######### # # # # # ### # ### # ##### ####### # ### ##
# #   #       #   # #   # # #   #   # # # #     #   #   #       
# # # ### ##### ### ##### # # # ##### # # # ####### # ######### 
#   #     #   # #   #   #   # #       #   # # #     #G# #       
##### ##### # # # ##### ####### # ######### # # ##### # # ##### 
#     #     #   #     #         #         # # #       #   #   # 
# ##### ############# # # ############# # # # ############### # 
# #     #   #     #   # #       #     # #   #         #     #   
# # ##### # # # ### ########### # ### # # ### ######### ### ### 
#   #   # #   #     #   #   #   #   # # #   #     #       #   # 
# ### # # ########### # ### # ##### # # # # # ### # ######### # 
#     # # #   #     # #   #   #   # # # # # #   # #   # #   # # 
# ####### # # # ##### ### ##### # # ### ### ### # ### # # ### # 
#   #     # #   #     #   # #   # #     #   #   #     # # #   # 
# # # ####### ### ##### ### # ### ####### ### ######### # # ### 
# #       #   #   #   # #       # #     #   # #   #   # #   #   
# ####### # # # ### ### # ####### # # # # # # ### # # # ##### ##
# #     # # # # # #     # #       # # #   #   #     # #         
# # ### # ### # # ####### ########### ### ##### ### ##### ######
# # #   #     # # #     #       #     #   #       #       #     
# # # ### ##### # # ### ####### # ##### ### # # # ######### ### 
# # #   #     # # #   #   #   #   #       # # # #   #         # 
# # ### # ### # # ### ### ### ######### # # # ##### # ######### 
# # #   #   # # #     # #     #       # #   # #   # # #     #   
# # # ####### # ####### ##### # ##### # ##### # # # # # ##### ##
# # #       # # #     #   #   #     # # #     # #   #   #     # 
# # ####### ### # ### ### # ####### ### # ######### ### # ### # 
#   #     #     #   #   #         #     #         # #   #   # # 
# ### ### ######### ### # # # ### ##### ######### ### ##### ### 
# # # #   #     #   # #   # #   #         #     #     #   #     
# # # ##### ### # ### ##### ### ####### # ##### ####### ########
# # #     #   # # # # #       #     # # #       #     #         
# # ##### ##### # # # ### # # ##### # # ######### # ### # ##### 
#       #     #   #       # #     # #   #         #     # #   # 
####### ##### ################# # # ##### ############### # # # 
#   #   #   #   #     #       # # #     #   #   # #   #   # #   
# # ### # ##### # # # # ##### # # ##### ### # # # # # # ########
# #   # #   #   # # #   #   #   # #   # #   # # # # # # #   #   
##### # ### # ##### ##### # ##### # ### # ### # # # # # # # # # 
#     #     #     # #   # #       # #   # #   #   # # # # #   # 
# ##### ######### # # # ##### # # # # # # ##### ### # # # ##### 
# #               #   # #     # # # # # #       #   #   #   # # 
# # ### ############### # ##### ### # ######### # ######### # # 
#   #   #               #     #     #           #           #   
