################################################################
#         #     #             #   #               # #   #       
# ##### ### # # # ############# # # ############# # # # ### ### 
#   #   #   # # # #         #   #   #   #         #   #     #   
# # # ### ### ### # ##### ### ######### # ################### ##
# # #   # # #       #   # #   #   #   # # #       #         # # 
# # ##### # ####### # # ### ### ### # # # ##### # # ##### # # # 
# # #     # #     #   # #   #   #   #   #       #       # # # # 
# ### ##### # ### ####### ##### # ############# ### ### # # # # 
#   # #   # # # # #   #   #   # #               #     # # #   # 
### # # # # # # # # # # ### # # ##### # ######### ##### # ##### 
#   #   # # #   # # #   #   # #       #   #     # #     #   #   
# ####### # ##### # ######### # ### # ### # ##### # ##### # # ##
# #   #   # #   # # #   #   # #   #G#   #   #     #     # #   # 
# ### # ### # # # # # # # # # ### # # # ##### ######### # ##### 
#     #   #   # #   # #   #   #   # # # #   #     #     #       
##### ### # ######### ######### ### ### # # ##### # ######### # 
#   #   # # #       #           #   #   # #     # #   #     # # 
# # ### # # # ######### ####### # ### ##### ##### # # # ### # # 
# #         #           #     # # #         #     # #     # # # 
# ######### ### ##### ### ### ### # ######### ##### ####### # # 
#       #     # #     #   #       #       #   #       #     # # 
######### ### # # ### # ############# # # # ##### ### # ##### ##
#         # #   # #   #   #       #   # # # #     #   # #       
# ######### ### # ####### # ##### ##### # # # ##### ### # ##### 
# #   #         #       # #     #   #   # # #   #   #   #   #   
# # ### # ####### ### ### ######### # ##### ##### ### ####### # 
# #   # #   #   #   #   #     #     #   #   #     #   #     # # 
# ### # ##### # ####### ### ### ####### # ### ##### ### ### # # 
#   #   #     #   #   #   # #   #       #   # #   #   # #   # # 
### ##### ####### # # ### # # ### ######### # ### ### # ##### # 
# #     #       # # #     # #   #     #   # #     #   #       # 
# ### # ####### # ######### ### ##### # # # ####### ########### 
#   # #     #   #         #   #   #   # #   #       #     #     
### ####### # ########### # # ### # ### ##### ######### # # # ##
#     #     #     #   # # # #     # #   #   # #         # # #   
##### # ### ##### # # # # # ######### ### # # # ##### ### ##### 
#   #   #     # # # # # # #     #   #   # #   #     #   #       
# # ##### ### # # # # # # ####### # ### # ############# ####### 
# # #   #   #   # # # # #   #   # #     # #       #   #     #   
# # # # ######### # # # ### # # # ####### # ##### # # ##### ### 
# # # #       #   # #     #   # # #     # # #   # # #   #   #   
# # # ####### # ### ##### ##### # # ### # # ### # ##### # ### ##
# # # #     # # # # #           # # # # # #     #     #   #     
# # # # ##### # # # ####### ##### # # # # ########### ####### # 
# #   # #   #   #   #     #   #   #   # #         #   #       # 
# ##### # # ### ##### ### ### # ##### ####### ##### ##### ### # 
# #   #   #     #   #   #   # # #   #   #   #       #   #   # # 
# # # ########### # ### ### # # # # ### # # ######### # ### # # 
#   #           # # #     # #   # #   # # #   #       #     # # 
############### # # # ##### ######### # # ##### # ### ######### 
#   #     #   # # #   # #   #   #   #  S#       #   # #     #   
# ### ### # ### # ##### # ##### # # # ############# # # ##### # 
# #   #       #   #     #     #   # #         #     #     #   # 
# # ### ##### ##### ### ##### ##### # ####### # # ####### # ### 
#   # #   #   #   #   #     # #     # #     #   # #     # # #   
##### ### # # ### # ####### # # ##### # ### ### ### ### # # ### 
#         # #   #   #   #   #   #     #   # #   #   #   # #   # 
# ######### ### ### # # # # ##### # ##### # ##### ### ### ### # 
# # #       #   #   # # # #       #     # # #   #   # #   #   # 
# # # ######### ##### # ######### ### ### # # # ### # ### # ### 
# # #     #   #     # # #   #   # #   #   # # #     #   # # # # 
# # ##### # # ##### # # # # # # ### # # ##### ######### ### # # 
#       #   #     #   #   #   #     # #       #             #   
