################################################################
################################################################
           #     #         #       #   #             #         #
 ######### # ##### # ####### ##### ### # ######### # # ####### #
 #   #     # # #   #      S  #     #   # #       # #   #   #   #
 # # # ##### # # ############# ##### ### # ##### # ##### # # ###
 # # #   #     # # #           #         #   # # # #   # # #   #
 # # ### # ##### # # ########### ########### # # # # # ### # # #
 # #   #   #     # #     #           #   #     # #   #     # # #
 # ### ### # ##### ##### # ### ####### # # ##### ############# #
 # #   #   #     #       #   #         #   #     #     #       #
 # ### # ####### ########### ########### ### ##### ### # # #####
 #   # #       #   #       #     #     #   #       # # # # #   #
 ### # ### ### ### # ##### # ### # ### # ########### # ### # # #
   # #     # #   # # # #   #   #   # # #             # #   # # #
## # ####### ### # # # # ### ####### # # ######### # # # ##### #
   #   #   #   # #   #   #         #   #     #     # # #     # #
 ##### # # ### # # ##### ### ##### ######### # ##### # ### # # #
 #   # # #   #     #   #   # #   #   #     # #   #   #   # #   #
 ### # ##### ### ### # ### # # # ### ### # ##### ### ### # #####
 #   #   #       #   # #   # # #   #   # # #   # #   #   #     #
 # ##### ####### # ### ### # ##### ### # ### # # # ### ### ### #
   #   #       # # # #   # # #   #     # #   #   #   # #   #   #
 ### ######### ### # ### # # # # ####### # ##### ##### ### # ###
         #     #   # #   # #   # #     #   #     #     #   #   #
######## # ### # ### # ### ##### # ### ##### # ### ##### ##### #
         #   # #   #   #         #   #     # #   # #     #     #
 ####### ### ##### ##### # # ############# # ### # ####### # ###
 #         #     # # #   # # #     #     # # #   #   # #   #   #
 ########### ##### # # ### ### # ### ### # # # ##### # # # ### #
 #         # #           #     # #     # # # # # #   #   #   # #
 # ####### ### ### ##### ####### # ##### # # # # # ####### ### #
 # #   #   #   #       # #   # # # #   #   # # # # #   #     # #
 # # # # ### ### # ### # ### # # # # # ##### # # # # # ##### # #
 # # # #     #   #   # #       #   # #   #   #   #   # #   # # #
 # ### ##### # ##### # ############# ### # # ######### # # ### #
 #     #   # #   #   #             # #   # #         #   #   # #
 ####### # ### # # # ############# # # ### # ##### ######### # #
 #     # #   # # # #   #     #   #   # # # #     # #   # #   # #
 # ##### ### ### # # ### # ### ####### # # # ### # # # # # ### #
   #   # #       # #     #     #     # #   #   # #   #   # #   #
 ### # # ######### # ########### ##### ####### # ######### ### #
 #   # #   # #     # #     #   #   #   #   #   #         #   # #
 # ### ### # # ##### # ### # # ### # ### # ############# ### # #
 # # #     # #     # # #   # #   # # #   #             #   # # #
 # # ####### ##### # # # # # ### # # # ############### ##### ###
 # #   #   #   #   # # # # # # #   # #     #         #     #   #
 # ### ### # ### ##### # ### # ##### ##### ##### ### ##### ### #
 #     #   #   #     # #     # #   #     #     # #   # #   #   #
 ####### ### # ##### # ####### # ####### ##### # ##### # ### ###
 #           #     #   #         #   #   #   # #   #   #   #   #
 # ##### # ####### ##### ##### # # # # ### # # ### # ##### ### #
   #   # #     #   #     #   # # # #   #   # # #       # # # # #
 ##### # ####### ### ### # ### # # ### # ### # # ### # # # # # #
   #   #       #     # # # #   # # #   # # #   #   # #   # #   #
 ### # ####### # ##### # # # # ### ##### # ##### # ####### ### #
   # #     # # # #   #   # # # #   #     #       #   #     #   #
 # ####### # # # # # ##### # # # ### ##### ######### # # #######
 #       # # # # # # #     # # #     #     #         # # #     #
 ##### # # # # ### # # ##### # ####### ### # ######### # # ### #
 # #   # # # # #   # #       #           # #   #   #   # # #   #
 # # ##### # # # ### ######### ##### ### # ##### # # ##### # ###
   #         #   #   #G        #     #   #       # #       #   #
################################################################
