################################################################
#   #   #       #     #   #               #                   # 
### # ### # ### # ### # # # ############# # ############### # # 
#   #     #   # #   #   #   #                   #     # #   #   
# ########### # # # ######### ##### ### ####### ##### # # ### ##
#             # # #   #       #   #   #   #   #   #   # # #     
############### ##### # ####### # # # ##### # # # # ### # ##### 
#                     #       # # # #     # # # #   #   #     # 
# ### # ####################### # # ##### ### # ##### ####### # 
# #   # #       #       #       #   #   #     #           #   # 
# ### # # ####### ##### # ####### ### # ########### ##### # ### 
#   # # #   #   # #   # # #   #   #   #   # #   #   #     #   # 
### # # # ### # # # # # ### # # ### ##### # # # ############# # 
#   # # # #   #   # # #     #     #     # #   #     #       # # 
####### # # ####### # ### ##### # ##### # ######### # ##### # ##
#     #   # #     # #     #   # #     # #     #       #   # #   
# ### ##### # ##### ####### # # ####### ##### ######### # # ### 
#   #     # # #     #       # #     #   #   #     #   # # #     
### ##### # # # ### # ####### # ### # ### # ##### # # ### ##### 
#   #       #   #   #   #G  # # #   #     #     # # #           
# ### ########### ##### ### # ### # ########### # ####### ######
#   #     #     # #     #   #     #           # #     #   #     
# # ####### ### ### ##### # ### ####### ### ### ##### ##### ### 
# #     #   # #   #   #   #     #     #   #     #   # #       # 
# ##### # ### ### # # ######### # ### ### ####### # ### ####### 
# #     #     #   # # #       # #   # #     #   # # #   #   #   
### ######### ####### # ##### ##### # ##### # # ### # ### # # ##
#   #       #       # #   #         # #   # # #     #   # # #   
# ### # # ######### ##### ########### # # # # ######### # ##### 
#     # # #       #       #   #       # # #   #     #   #     # 
# ##### ### ##### ######### # # ######### # ### ### # ####### # 
#     # #   #   #   #   #   # #   #       #     # # #   #   #   
####### # ##### ### # # # ### ### # ####### ##### # ### # # ####
#     # #     #   #   # #   #   # # #   #   #   #   #   # # #   
# ### ####### # ####### ### ### # # ### # # # # # ### ### # # # 
# # #       # # #     # #   # # #       # # # # # #   #   # # # 
# # ### ##### # # ##### # ### # # ### ### # # # ### ### ### ### 
# #     #   # # #     #   # #   #   #     # # #     # # # #     
# ####### # # # ##### ##### ##### # ####### # ####### # # ######
#   #   # # # #     # #           #     #   # # #     #   # #   
### # # # # # # ##### ##### ##### ##### ##### # # ####### # # # 
# #   #   #   #       #   # #   #   # #       # # # #   # #   # 
# ####### ##### ####### # # # # ### # ######### # # # ### ##### 
#         #   #         # # # #   # #         #     # #   #     
##### # # # # ########### ### ### # ##### ### ##### # # ### ### 
#   # # #   #   #       #   # #   #       #           # #   #   
# # # # ####### # # ### ### # # ########### ####### ### ##### # 
# #   #       # # #   #   #   #         #   #     #   #     # # 
# ########### # ####### ############### ##### ### ### ##### # # 
# #     #   # #       #           #   # #   #   #   # #   #   # 
# ##### # # # ####### # ### ##### # # # # # ### ### # # ####### 
#     #   # #     #   # #   #   #   # # # # #   #   #   #     # 
# ### ##### ##### # ##### # # # ##### # # # ##### ##### # # # # 
#   # #   #       # #   #S# # # #     # # #       #     # # # # 
### # ### ####### # # # ### # # ##### # # ######### # ### # ### 
#   # #           # # #   #   #   #   # # #       # # #   #   # 
# ### # ######### # ##### # ##### ##### # ####### # # # ##### # 
#   # # #     #   #     # #     #     # # #     # # # #     # # 
### # ### ### # # ##### # # ### ##### # # # ### # # ####### # # 
# # # #   # # # #     #   # # #   #   # #   # # #         # # # 
# # # # ### # ####### ##### # ### ##### ##### # ### # # ### # # 
#   #   #   #   #     #     # #   #   #   #   #   # # # #   #   
### ##### ##### # ##### ##### # ### # ### # ##### # # ### ######
#       #       #             #     #               #           
