################################################################
################################################################
           # #         #     #     #     #         #     #   # #
 ######### # # ##### ### ### # ### # ### ######### # ### # # # #
   #   #   # #     #   #   # # # # # # # #         # #     # # #
#### # # ### ##### ### ### # # # # # # # # ######### ####### # #
     #   #           # #   # # # #   # # # #   #   #   #   #   #
 ############# ##### ### ##### # ##### # # # # # # ### ### ### #
         #     #   # #   #     #     # #   # #   # #   #   #   #
######## # ##### # # # ### ####### # # ##### ### # ##### ### ###
       #   #     #   # #   #       #     # #   # #           # #
 ### # ### # ####### # # ####### ####### # # # ##### ######### #
   # # #   # #     #             #       # # # #   #     #     #
## # # # ### # ### # ############# ####### # ### # ### # # #####
   # #   #   # #   #   #   #   #   #         #   # #   # # #   #
#### ##### ### # ##### # # ### # ### ### # ### ### # ### # ### #
     #   # #   #       # #   #   #   # # # #   #   #   # # #   #
 ##### # # # ##### ##### ### # ### ### # # # ### ##### # # # ###
   #   #   # #   # #   # #   # # # # # # # # # # #     # # #   #
 ### ##### # ### ### # ### ### # # # # # # # # # # # ##### ### #
 #   #     # #   #   #               #   # # #   # #       #   #
 # ##### ### # ### ##### ############### ### ##### ######### ###
 #     #   #   #   #             #     # #   #               # #
 ##### # ####### ####### ####### # ### ### ########### # ##### #
 #     # #       #     #       #     #   # #       # # #       #
## ##### # ####### ### # ##### ####### # # # ##### # # ### ### #
   #     #       # #   # #   # #    S# #   # #   # #   #   #   #
 ############### # ##### # # # # ### ####### # ### ######### # #
   #         #   #     # # # # # #           #     #     #   # #
 # # ####### ######### # # # ### ############# ##### ### ### # #
 # #   #       #     # # # #   #       #       #   # #   #   # #
 # ### ####### # # ### # # ### ######### ######### # # ### ### #
 #   #       # # # #   #     #     #     #         # # #   #   #
 ### ######### # # # ####### ##### # ##### ######### # # ##### #
 #   # #     # # #   #   #   #     #     # #       # # #     # #
 # ### # ### # # ##### # # ############# # ####### # # ##### ###
 #     #   #   #     # #       #     #   #       # # #     #   #
 ######### ######### # # ##### # # # # ######### # # ##### ### #
     #   #     #     # # #   #   # # # # #     # # #   # #   # #
 # ### # ##### # ####### # # # ### ### # # ### # # ### # ### ###
 #     #   #   #   #     # # #   #         #   # # #   #   #   #
 # ##### # # ##### ### ### # ### ##### # ####### # # ##### ### #
 # #   # # #   # #   #     #   # #   # #    G      # #     #   #
 ### ### # ### # ### ##### ### # # # ############# # ### # # ###
   #   # #   # #   #     #   # # # #             # # #   # #   #
## ### # ### # # ####### ### # ### ############# # # # ### ### #
   #   #   # # # #     # #   #     # #   #   # # # #   # # # # #
 ##### ### # # # # ##### # ######### # # ### # # ####### # # # #
     #     # # #   #       #       #   #     # #       #     # #
 ### ####### # ### # ##### # ##### # ######### ##### ### ##### #
   # #       #   #       #   #   #   #   #     #   #   # # #   #
#### # # ####### ### ### # ### # ### # # # ##### ##### # # # # #
   # # # #     #   # # # # #   #   #   #   #     #   # # # # # #
 # # # # ##### ### # # # ### ##### # ####### # ### ### # # # ###
 # # # #       # # #   #     #   # #         #   # #   # # #   #
 ### ### ####### # # ########### # ####### ##### # # ### # ### #
   #   #         # #       #     #       #   # #   #     # #   #
## # # ### ####### ####### # ########### # # # ########### # ###
 # # #   #   #   #     #   # #           # #   #     #     # # #
 # ##### ### # # ##### # ### # # ######### ##### ### # ##### # #
 #       # #   #     #   #   # # #     #   #   #   # # #   #   #
 ######### ####### # ##### ##### # ### # # # # ### # # # #######
                   #     #       #   #   #   #     #           #
################################################################
