#                                                               
# ######### ### ### ### ########################################
# #   #   # #   # #   # #     #       #         #         #     
# # ### # ### ### ### ### ### ### ### # # ##### ### ##### # ####
# #   # #     #     #     # #   #   # # # #   #     #     # #   
# ### # ####### ########### ### ##### # # # # ####### ##### # # 
# #   #   #       #           #     #   # # #     #   #     # # 
# # ##### # ##### # # ### ######### ##### # ##### # ### ##### # 
# #     # #     #   #   #   #     # #     #   # # #     #     # 
# ##### # ##### ### ### # # # ### # ### ##### # # # ##### ##### 
# #   # #     #   # #   # # #   # #   # #     # # #   #   #   # 
# ### # ##### # # # # ##### ### ##### # # ##### # ### # ### # # 
#     #       # # # #     #   # #     # # #   #   #   # #   # # 
# ############# # ####### ##### # ##### # ### ####### # ### # # 
#   #     #   # # #   #   #     #   #   #   #       # #     # # 
# # ##### # # # ### # # ### ####### # ##### # ##### # ####### # 
# #     #   # # #   # # #   #   #   # #     # # #   # #   #   # 
# ### ####### # # ### # # ##### # ##### ##### # # ### # # # ### 
#   #     #   # # #   #   #   # #     # #     # # #     # #   # 
### # ### # ### # ##### ### # # ##### # # ##### # # ######### # 
# # #   #   #     #   #     #       # # #     # # #   #       # 
# # ### ##### ##### # ### # ##### ### # # ### # # ### # ####### 
#   #         #   # # # # # #   # #   # # # # # #   # #     #   
##### ####### # # ### # # # # # ### ### # # # # ### # ##### # ##
#     #     # # #     #   # # #   # #   #   # #       #   # #   
# ### # ### ### ########### # ### # # ####### # ####### # # ####
# # # #   # #   #           #   # # #     #   #   #   # #   #   
# # # ### # # ##### ########### # # ##### # ##### # # # ##### # 
#   # #   #   #   # #         # #   #   #   #     # #   #   # # 
# ### # ####### # ### ####### # ### # # ### # ### # ####### # ##
#   # #     #   #     #     #   #   # # #   #   #         # #   
### # ##### # ### ####### ####### ### # # ############### # ### 
#   #   #   # #   #     #           # # # #       # #         # 
# # # ### ### ##### ### ####### ##### # ### ##### # # ######### 
# # #   # # #   #  S#   #   #   #     #     #   # #   #         
# ##### # # ### # ### ### # # ### ########### # # ### # ########
# #     #     #   # #     # #   #     #   #   # # #   # #   #   
# # ######### ##### ####### ######### # # # ### # # # # # ### # 
# #     #     #   #       #         # # # # # # # # # # #     # 
# ##### # ##### # # ##### ######### # ### # # # # ### # ####### 
#   # # # #   # #   #   # #     # #   #   #   # # #   #   # #   
# # # # # ### # ##### # # # ### # ##### ##### ### # # ### # # ##
# #   # #   # #   #   # # #   #             #     # #   #G#   # 
# ##### ### # ### ### ### ##### ####### # ########### ### # ### 
#     #     #     #   #   #     #     # # #         # #   #     
### # ############# ### ### ##### ### ### # ####### # # ####### 
#   #   #           #   #         # #   # # #   #   # #       # 
# ##### # # ### # ### ### ######### ### ### # ### ### ####### # 
# #   #   #   # #   # #         #     # #   #   # #       #   # 
# # ### ##### # ### # ######### # ### # # ##### # # ##### # ### 
# #   # #   # #   # #     # #   # #   # # #   # # # #   # #     
# ### # # # # # # # ##### # # ##### ### # # # # # # # # # ##### 
#   # #   # # # # #     # # #     #   #   # # # # #   # #   #   
### # ####### # # ### ### # ##### # ####### ### # # ### ### # ##
#   #     #   # #   # #   #     # #         #   # #   #   # # # 
# ####### # ######### # ### ### # # ######### ### # ##### # # # 
# #       # #   #   #   # #   # # # #     # #     # #     # #   
# ### ##### # # # # # ### # # ### # # ### # ####### # ######### 
#   #       # # # # #     # #     #   #   # #   #   #       # # 
# # ####### # # ### # # ### ########### ### # # # ######### # # 
# #     #   # #     # #   # #   #     # # # # #   #   #   #   # 
# ##### ##### ####### # # # ### # ### # # # # ##### # # # ##### 
#     #       #       # #           #               #   #       
################################################################
