################################################################
#   #     #             # #       #   #           #           # 
# # # ### # ########### # # ##### # # # ######### # ### ##### # 
# # # #   # #   #     # #   #     # # #     #       #   #   #   
# ### # ### # # ##### # ##### ####### ##### # # ######### # ### 
# #   #     # #       #   #   #           # # #   #       # #   
# # ######### ####### # ### ### ######### # ### ### ####### # ##
# #   #   #       #   #     #     # #   # #   # #   #     # #   
# ### ### # # ##### # ####### ### # # # # ### ### ### ##### ### 
#   #   #   # #     #     #   #   #   # #   #   # #   #   #   # 
# ##### ####### ##### ### ##### ####### ### ### # # # # # # # # 
#   # #       #     #   #       #       #     #   # # # # # # # 
### # ####### ##### ### ######### ##### # # # ##### # ### ### # 
# # #       #     #   # #       # #   #   # # #   # #   #     # 
# # ### ### ##### ##### # ##### ### # # ### # ### # ### ####### 
# #   # #   #   #     # #     #     # # #   #     #   #   #     
# ### # # ##### ##### ####### ####### # # ####### # # ### # ####
#   # # # # #       #  G      #     # # #   #       # # #   #   
### # # # # # ### # ############### # ##### # ####### # ####### 
#   #   # #   #   #               # #       # #       #   #     
# ####### ##### ######### ####### # ######### # ####### # # ####
# # #   #   #   #     #   #               #   # #       # #     
# # # ##### # ####### # ### ##### # ##### # # # # ##### # ##### 
# # #   # # #         #   #     # #     #   # # # #   # # # #   
# # ### # # ### ######### ##### ############### # # # # # # # ##
# #       #   #   #     #   #   #   # #   #     # # #   # # # # 
# # ##### ### ##### ### ### # ### # # # # # ####### ##### # # # 
# # #   #   #     #   #     # #   #   # # #   #     # #   # # # 
# # # # ### ##### ### ####### # ####### # ### # ##### # ### # # 
# # # #       # #   # #               # #   # #   #   # #       
# # # ####### # ### # ##### ########### ### # # # # # # ####### 
# # # #     # #   #   #     #       #   #     # # # # #         
# ### # ##### # ####### ### # ##### # ######### # ### ######### 
# #  S#       #         #   # #   # # #       # # #           # 
# # ### ##### ##### # ### # # # # ### # ##### ### # ####### ### 
#   #   #   # #     # #   # #   #   #       #   # #   #   #     
# ####### # # # ##### # ### ####### ##### ##### # ##### # # ####
# #       # #   #     # #         #     # #   # #       # # #   
### ####### ### # ##### ### ### ####### # # # # ######### # ### 
#   # #   # # # # #   #   #   # #     # # # # # #         #     
# ### # # # # # # # # ### ### # # # ### # ### # ############### 
#   #   #   #   # # #   # #   #   #   # #     # #   #         # 
### ############# ##### # ########### # ####### # # # ####### # 
# #               #   # # #     # #   #   #     # #   # #   # # 
# ################# # # # # ### # # # ### # ##### ##### # ### # 
#   #   #     #     #   # # # # #   #   #   #       #   # #   # 
### # # # ### # ##### ### # # # ##### # ##### ##### # ### # ### 
#   # # # #   # #     #   #   # #   # #           #   #   # #   
# ### ### # ### # ##### # ##### # ### # ######### ### # ### # ##
#   #   # #   # #   #   #     # #     # #       #   # #     #   
### ### # ##### # ### ### ##### ####### # ##### # # # ######### 
#   #           # #   #   #     #   #   # #     # # #           
# ############### # ####### ##### # # ##### ####### # ### ### # 
#       # #   # # #         #     # #       #       #   # #   # 
####### # # # # # ############# # # ######### ####### ### ######
#   #   #   #         #       # # #       #   #         #       
# # # ####### # ### # # # ### # # ####### # # ######### ##### # 
# # # #   #   # #   #   # # #   # # #     # # #       # #   # # 
### # # # # ### # ####### # ### # # # ####### # ##### # # # ### 
#   # # # #   # #   #   # #     # #   #       #   #   # # # #   
# ### # # ##### ### # # # ####### ### ### ##### # ### # # # # ##
# #   # #         #   # # #     #   #   # # #   #   #   # # #   
# # ################### # # ### ### ### # # # # ### ##### ##### 
#                       #     #   #   #   #   #   #     #       
