################################################################
#     #   #   #   #     #     #     #     #   #     #     #     
##### # ### # ### # ### # ##### ### # # # # # # ### ### ### ### 
#   # # #   #     #   #       # # #   # # # # #   #   #   #   # 
# # # # # ################### # # ##### ### # ####### # # ### # 
# #     #   # #             # # #     #   # # #       # #     # 
# ##### ### # # ########### # # # ##### # # # # ####### ####### 
#     #   # #   # #         #     #   # #   # #     #       #   
# ### ##### ##### # ######### ##### # ############# # ##### # ##
# # #     #   #   #         # #     # #     #       # # #   #   
# # ##### ### ### ######### # # ##### # ### # ####### # # ##### 
# # #   #   #   #           # #   #   #   # #   #   # #   #     
# # # ##### ### ####### ##### ### ### ### # ### ### # ####### ##
# #       #     #     # #       #   #     #   #   # # #     #   
# ##### # ####### ### # ### ####### ######### ### # # # ### ####
#     # # # #   # # # #   #       #   #       # # #   # # # #   
##### ### # # # # # # ### # ### ##### ####### # # ### # # # # # 
#   # #   # # # # # #       #   #   #       #   #         # # # 
# ### # ### # ### # ##### ####### ######### ### ##### ##### # # 
#   # # #   #     #   #   #   #   #   #     # # #         #   # 
### # # # # ####### ### ### # # ### ### ##### # ######### # ### 
#   # #   #         #   #   # #   # #   # #     #         #   # 
### # ####### ####### ### ### ### # # ### # ##### ############# 
#   #       # #     # # # #   #   #   #   #       #     #   #   
# # ####### # # ### # # # # ### ######### ######### # ### # # # 
# # #     # # #   # #   # # #   #       # #   #     # #   # # # 
# # ##### # # ### # ### # # # ##### ### # # # # # ### # ##### # 
# #       # #   # #     # # #       # # # # #   # #   # #   # # 
######### # ### # ####### # ######### # # # ##### ### # # # # ##
#       # #   #         # #           # #   #   #   # #   # #   
# ##### # ### # ######### ########### # ##### # ### # ##### ### 
#   # # #   # #   #       #     #   # #       #     # # #G  #   
### # # ### # ### # ####### # # # # ################# # # ### # 
#   # #   #   #   # #   #   # #   #   #     #       # # #     # 
# ### # # ### # ### # # ##### ####### # ### ####### # # ####### 
#   # # #   # # #   # #   #   #     # #   #   #   # # #   #     
### # ##### # # # ### ### # ### ##### ### ### # # # # # ### # # 
#   #   #   #   # #     #   #     #   # # #   # # # # #     # # 
# ##### # ##### # ##### ##### # ### ### # # ### # # # ####### # 
#     # # #     #       #     # #   #   # # #   # # #         # 
##### # # # ### ############### # ### ### # ##### # ########### 
#   # #   # # #   #     #             #   #       # #       #   
# # # ##### # # # # ##### ### # ##### # ########### # ### # # # 
# # # #       # # # #     #   #   #   #   #     #     #   #   # 
# ### ### ##### # # ### ########### # ### # ### ####### ####### 
#   #   # #   # # #   # #   #       #   # #   #         #     # 
### ### ### # # # ### # # # # ######### # # # ########### ### # 
#     #   # #   #       # # # #   # #   # # # #           # # # 
### ##### ########### ### # # ### # # ### # # ##### ####### # # 
#   #     #         # #   #   #     # #   # #     # #   #   #   
# # # ##### ####### ### ####### ##### # ### ##### # # # # # ### 
# # # # #     #   #     #   #   # #S  #   #   #   # # # # # #   
### # # # ### # ######### ### ### # ##### ### # ##### # # ### # 
#   # # #   # #       # # #   #   #     #   # #       # # #   # 
# ### # ### # ### ### # # # ##### ##### ### ##### ##### # # ### 
#     #   # #   #   #           #   #   # # #   #   #   # # #   
# ####### # ### ############### ### # ### # # # ##### ### # # ##
#       #     # #                   # #   #   #       #   # #   
####### ####### # ########### ####### # ############### ### # # 
#   #   #   #   # #         # #       # #       # #   #     # # 
### # ### # # ### # ### ##### # ####### # ##### # # ########### 
#   #   # #   #   # # #       #     #   #     #   # #   #     # 
# ##### # ##### ### # ############# # # ##### ##### # # # ### # 
#         #       #                   #               #   #     
