################################################################
#     #     #       #       #         #             #         # 
# ### # ##### ##### # ##### # ####### # ######### # # # ##### # 
# #   #   #   #     #   # # # #     # # #     #   #   #   #   # 
# # ### ### ### ####### # # # # ### # # # ### # ######### # ### 
# # #   #   # #         #   # #   #   # # # # # #         #     
# ### ### ### ########### ### ### ####### # # ### ############# 
#       #   # #         # #   # #   #     # #     #         #   
##### ##### # # ##### ### # ### ### # ##### ####### ####### # ##
#   # #     # #     #   # # # #   #   #                 #   #   
# # # # ##### ##### ### # # # ### ############# ### ### ####### 
# #   #       #     #   # # #               #   #     #   #     
# ### ######### ##### ### # ##### ##### ### # ### ### ### # ####
#   # #   #     #   #   # #     # #     # #   #   #     # # #   
##### ### # ##### # ### # ##### ### ##### ####### # ##### # ### 
#   #     # # #   #   #   #   # #   # #   #       # #   #   #   
# # ##### # # # ##### ##### # # # ### # ### # ##### # # ##### ##
# #   #   #G#   #   #   #   # # #   #   #   # #     # #   # #   
# ### # ### # ### # ### ### ### # # # ####### # ### ##### # ### 
# # # #       #   #   #     #   # # #   #     # # #       #   # 
# # # ### ##### ##### # ##### ##### ### # ##### # ######### ### 
#   # #   #   # #   # #   #   #   #   #   #     # #     #     # 
##### # # # # # # # # ##### ##### ### ####### ### # ### # ### # 
#   #   # # #   # #   #   #     #     #       #   #   # # # #   
# # ##### # ##### # ### # ##### ########### ### ##### # # # ####
# #     # # # #   # #   #   #   #         #     #   # # # #    S
# ##### # # # # ##### ##### # ### ####### # ##### # ### # # ####
#   #   # # # #     # #   # # #   #     # #       #     #   #   
### # ### # # ##### # ### # # # ### ### # ####### # ##### ### # 
#   # #   #   #   # # #   # # #     #   #     #   #     #     # 
# ### ### ### # # ### # ### # ############### # ### ##### ##### 
# # #   #     # #   # #   # #   #       #   # # # #       #   # 
# # # # # ##### ### # ### # ### # ##### # # # # # # ####### ### 
# # # # # #     #     #   #   #   #   # # #   # #       # #     
# # ### # # ########### # ### ####### # # ##### ##### # # ######
# #     # #   #     #   #             #   #     #   # #   #     
# ####### ### # ### ### ############# ##### # ##### # # ### ### 
#   #       #   # #   # #       #           #     #   #     #   
### # ########### ### # # ##### # ##### ### ##### ##### ##### ##
#   #     #     #     # #     # # #   #   #   #   #   #   # #   
# ####### # # # ####### ##### # ### # ### # # # ### # ### # ### 
#     #     # #           #   #   # # #   # # # #   #     #     
##### ####### ##### # # ### ##### ### ##### ### # ####### ######
#   #         #     # # #   # #   #   #     #   # #   #   #     
# # ############# ### # # ### # ### ### ### # ##### # ##### ### 
# #   #           #   # # #   # #   #   #   #     # #         # 
# ##### ### # ##### ##### # # # # ### ##### ##### # ########### 
#       #   #     #   #   # # #   #   #     #   # #     #       
################# ### # ### # ##### # # # ### # # ##### ########
#                 #   # #   #   #   # # #   # # #     #         
# ########### ##### ### # ####### ### # ### # # # ############# 
# #           #   #   # #     #   #   #   # # # #     #       # 
# # # ######### # ##### ##### # # # ### ### # # ##### # ### ### 
# # #       # # # #     #   #   # # # # #   # #     # #   #     
# ### ##### # # # # ##### ### ##### # # # # # ##### # ### ######
#   #     #   # # # #   #   # #     # # # # # #   # #   # #     
# # ####### ### # # # # ### # # ##### # # ### ### # ### # ##### 
# # #     # #   # #   #   #   # #     # #   # #   #   # #   #   
# # # ### ### ### ####### ### # ##### # ### # # ### ### ### # ##
# #   #   #   #         # #   #     #   #   # #   # #   #   #   
# ##### ### ### # ##### # ######### ##### # # ### # # ### ##### 
#     #   # # # # # #   # #       #     # # # #   # # #   #   # 
# # ##### # # # # # # ### # ##### ##### # ### # ### # # ### ### 
# #     #   #   #   #   #   #           #     #     #           
