################################################################
   #       #   #   #     #                       #   #     #   #
 # # # # # ### ### ##### # ##################### # # # ### ### #
 # # # # #   # #   #   # # #     #   #         #   #   # #     #
 ### # ##### # # ### # # # # ### # # # ##### ########### #######
   # #     #         #   #   #   # #   #   # #         #       #
 # # ##### ####### ########### ### ##### # ### ####### # ##### #
 #       #       #       # #   #     #   #   #       # # #   # #
 ############# # ### # # # # ### ### # ##### ####### # # # ### #
   #     #   #S#   # # #   # # #   # #   # #     #   # # # #   #
 # # ### # # ### # # # ##### # # # ##### # ##### # ### # # # ###
 # #   #   #   # # # #       #   #       #   #   #   #   # #   #
 # ### ####### ### # ##### ### ############# # ##### ##### ### #
 #   # #     # #   #     #                   #     #   #     # #
 ### # # ##### # ### ### ##### # ### ############# ##### # ### #
 # # #   #     #   #   #     # #   #       #     # #   # #     #
 # # ### # ##### # ### ##### # ### ######### # ### # # # #######
   # #   # #   # # #       # #   #   #       #   #   #   #     #
 ### # ##### # ### ######### # # ### # ######### ######### ### #
   #     #   #   # #     #   # #   #   #       #       #     # #
 # ####### ##### ### ### # ### ### ### ####### ####### # ##### #
 #         #   #   # #   # #     #   # #   #         #   # #   #
 ########### # ### ### ### ### # ### # # # # ######### ### # ###
 #         # #   #   # #     # # # # # # #   #       #     #   #
 # ##### ### ### ### # ##### # # # # # # ##### ##### ### # ### #
 #   #   #   # #   # # #     # #   # #   #   #   # # #   # #   #
 ### # ### ### ### # # # ##### ##### # ### # ### # # # ##### ###
     #     # # #   #   #   #   #     #     # #   #   #     #   #
 ####### ### # # ######### ##### ##### ####### ########### ### #
 #     #     #   #   #   # #   # #   #   #   #       #   #   # #
 # ### # ######### ### # # # # # # # ### # # ####### # # ### # #
 # # # # #       #   # # # # # # # # #   # #         # #   # # #
 # # # # # ##### ### # # # # # # # # ### # ########### ### ### #
 # #   # # #   #   # # # #   # #   #   # #   #           #   # #
## ##### # # ##### # # # ##### # ##### ##### ########### ### # #
   #       #   #   #   #     # # #   #     #       #   # # # # #
 ######### ### # ##### ### # # ### # ### ######### # # # # # ###
     #   #     #     #   # # #   # #   # #       #   #   # #   #
#### # # ### ####### ### # ##### ##### # # ##### ######### ### #
 #   # #   # #     # # # #   # #     # # # #   #     #       # #
 # ### ### # # ### # # # ### # ##### # # # # # # ### # # ### # #
 #     #   #   #   # # # #   #     # # # #   # # #   # # #   # #
 ####### ### ### ### # # # ### ### # # # ##### # # ### # # ### #
   #     #   #   #   # # # #   # # #   #       # # #   # # #   #
 # # ##### ########### # ### ### # ##### ####### ### ### ### ###
 # #   #     #     #     #   #       #   #   # # #   # #   #   #
 # ### # ##### ### # ##### ####### # # # # # # # # ### ### ### #
 #           #   # #       #   #   # # # # # # #   #   # #     #
 ##### ##### ##### ######### # # ### # # ### # ##### ### #######
 #   #     #       #       # # #   #   # #   # #   #   # #     #
 # # ############### ##### # ##### ### # # ### # ##### # ##### #
 # #       #       # #   # #   #   #   #   #   # #     #       #
 # ####### # ##### # # # # ### # ### ####### ### # ####### #####
 # #     #   #   #   # # # #   # #             #   #       #   #
 # # ### ##### ####### ### # ### ##### # # # ### ### # ##### # #
   #   #             #   # #     #     # # #       # # #     # #
 ##### ####### ######### # ####### ##### # ####### # # # ##### #
         #     #    G#   # #   #   #     #   #   #   # #   #   #
 ######### ### # ### # ### # ### ### # ##### # # ########### ###
     #     #   # #   #     #     #   # #     # #             # #
#### ####### ### # ################### # ##### ############### #
     #   #   #   #   #     #         # #     #   #       #   # #
 ##### # ##### ##### # ### # ####### ########### # ##### # # # #
       #           #     #         #                   #   #   #
