################################################################
################################################################
#                             #                 #     # #   #   
# ############# # ### ##### # ####### ####### ### ### # # # # # 
#   #       #   # # # #   # #   #     #  G  #   # # # # # # # # 
# # ####### # ### # # # # # ### # ##### ### ### # # # # # # # # 
# # #   #     #   #   # # #   #   #   # #     #   # #   # # # # 
# # # # # ##### ####### # # # ##### ### ##### ##### # ### # # # 
# # # # # #     # #     # # #   #   #   #   #         #   #   # 
# # # # # # ##### # ##### ##### # ### ### # ##### ##### ########
# # # # # #       # #   #     #     #   # # #     #     #       
# # # # # ######### ### ##### ##### ### # # # ### # ####### ### 
# # # # # #       # #         #   # #   # # # #   # #       # # 
# # # # # # ##### # # ##### ### # ### ### # # # ### # ####### # 
# # # # # #   # #   # #   # #   #   #   # #   #   #   # #   #   
# # ### ##### # ##### # # # # ##### ##### ### ### ##### # # # ##
# #   #     # #       # # #   #         # #   #         # #   # 
# ### ##### # ####### # # # ########### # # ### ### # ### ##### 
# #   #   # # #       # # # #       #     # #   #   # #   #   # 
# # # # # # # ### ##### # ### ##### ######### ### ### # ##### # 
# # # # #   #   # #     #     #   #   #       #   # # # #   #   
# # ### ####### ### ########### ##### # ####### ### # # # # # ##
# #     #   # #     #         #     # # #         # # # # # #   
# ######### # ####### # ##### ##### # # # # ### # # # # # # ### 
#     #   # #         # #   # #     # # # # #   #   #   # # #   
# ### # # # # ########### # # # ##### # # # ### ######### # # ##
#   #   #   # #           # # #       # # #   #   #     # # #   
# ########### # ########### ########### # ### ##### ### ### ### 
#             #           #     #     # #   #       # #     # # 
# ### ##### # ### ############# ##### # ### ######### ####### # 
# #   #   # #     #       #     #     #   #       #           # 
# # ### # ### ##### ##### # ##### ####### ### # ### # ##### # # 
# #     #   #   #   #   #   #         #   #   #     # #   # #   
# ######### # ### ##### ##### # ##### # ####### ####### # # ####
#   #   #   # #   #   # #     #   #   #     #   #       # #   # 
# # # # # ### # ##### # # ####### ######### ##### ####### ### # 
# #   # #   # #     # #   #     #         # #   #       #   # # 
# # ####### # ##### # # ####### ####### # # # # ####### ### # # 
# # #       # #   #   # #   #     #   # # #   #         #   #   
# ### ####### ### ##### ### ### # # ### ################# ### ##
# #   #   #           #   #     # #   #               #   #     
### # # # ######### # ### ####### ### ##### ########### ### ####
#   # # # #       # #         #   # # #   # #   #     # # #     
# ##### # # ##### # ##### ### # ### # ### # # # # ### # # ##### 
# #   # # #     # # #   # #   # #   #     #   # #   #   #       
# # # # # ##### # ### # # ##### # ### ####### # ### ########### 
#   #   #     # # #   # #       #     #     # # # # #   #       
# ####### ##### # # ### ### ##### ##### ### ### # # # # ####### 
#   #   #       # # # #   # #     #   # #   #   # #   #     #   
# ### # ######### # # ### # # # ### # # # ### ### ######### # ##
#   # # # #     #   #   # #   #   # # # # #     # #   #     #   
# # # # # # ########### # ####### # # # # ### # # # ### ####### 
# # # # # # #   #       #   #     # # # #   # #   #   # #   #   
# # ### # # # # # ######### # ##### ### ### ##### ### # ### # ##
# #   # # #   # #     #     #   # # #   # #     #     #   # #   
# ### # # ##### ##### # ##### # # # # ### ##### # ####### # ### 
# #   # #   #   #   # # #     #   #   # #   #   #   #   # # #   
# # ### ### # ### # # # ############### # # # ####### # # # # # 
# #     #   #   # # # #     #S      #     # # #   #   #   #   # 
# ####### ##### # ### ##### # ### ### ##### # # # # ########### 
#             # #   # #   #   # #     #     #   # #     #       
# ### ######### # # # # # ##### ####### ######### ##### # ### ##
#   #             #     #             #         #       #   #   
################################################################
