################################################################
       #             # #   #       #     #     #             # #
#### # ####### ##### # # ### ##### # ### # ### # ######### # # #
   # #   #   # #   # # #     #   #   #   #   # #   #       #   #
 # ##### # # # # ### # ####### # ##### ### # ##### # ###########
 #   #   # #   #   # #         #     #     #       #           #
 ### # ### ####### # # ########### ### ##### ####### ######### #
 #   #     #       # #   # #     #   # #   # #     #         # #
 # ######### ####### ### # # ####### # # # ### ### ### ### ### #
 #   #     #       #   #     #     #   # # #   # # #   #   #   #
 ### # ### ##### # ### # ##### ### ### # ### ### # # ####### # #
 #   #   #     # #         #   # #   # #     #   # #   #     # #
 ####### ##### # ####### # # ### ### # ####### # # # # # #######
         #         #   # #   # # # # #   #     # # # # # #     #
 ######### ##### # # # ### ### # # # ##### ##### # # # # ##### #
 #     # # #   # #   #   #     # # # #       #   # # # #       #
## ### # # # # # ####### # # ### # # # ####### ### # # #########
   #   #   # # #   # #   # # #   # # # # #     #   # #         #
 ### ##### # # ### # # ### # # ### # # # # ##### ### ##### ### #
   #     # # #   # # #   # #   #   #   #   #     #       #   # #
######## # # ### # # ### # ##### ########### ##### ######### ###
 #       #   #   #   #   #         #         #           # #   #
 # ####### ### ####### ########### # ######### ### ##### # ### #
   #       #   #     # #       #   #   #       #       #   # # #
 ### ####### ##### # # # ##### # ##### ####### # ##### ##### # #
 # #     #   #     #   # #     #     #     #   #     #       # #
 # ##### # ### ######### # ######### ##### # ####### # # ### # #
 #       # # #   #   #   #   #         #   # #   #   # #   # # #
 # ####### # ### # # # ##### # ##### # # ### ### # ####### ### #
 #   #   # #   # # # # #     # #     # #   #   #   # #   # #   #
 # # # ### ### # # # # # ##### ####### ### ### ##### # # # # ###
 # # #     #   # # #   # #       #       # #   #   # # #   #   #
 ### ####### ### # ##### # ##### ##### ### # ### # # # ####### #
   # #     #   # #   #   # #     #   # #   #     # #   #   #   #
## # # ### # # # ### # ##### ##### # # # ##### ### ##### # # ###
 # # # #   # # #     #     # #   # # # #     #   #       # #   #
 # # # # ### ########### # # # # ### ####### # # ############# #
 #   # # #   #         # # #   #     #   #   # #     #         #
 ##### # # ### ####### ### ##### ##### # # ### ####### ####### #
   # # #   # #       #     #   # #     #   #   #       #       #
## # # ##### ####### ##### # # # # ########### # ######### ### #
 #   # #   # #     #     # # # # # #   #   #   # #       # #   #
 ### # ### # # # ####### ### # ### # ### ### ### # # ### # # ###
     #   # #   # #     #     #     #   #     #   # # #     #   #
#### ### # # ##### ### ############### ##### # ### # ####### # #
       # # # #     # #     # #   #   #       # #   #       # # #
 ##### # # # # ##### ##### # # # # # ### ##### # # ####### ### #
     # # #   # #           # # # # #     #     # #       #   # #
###### # # ### ##### ####### # # ### ### # ##### ########### # #
     # # #   # #   #   #     # # #   #   # #     #     #     # #
 ### # # ### # # # ### # ### # ### ####### # ##### ### # ##### #
   #   #   # #   #   #   #         #   #   #         # # #     #
 ######### # ####### ##### ######### # # ############# # ##### #
 #   #   # #   #   # #     #         # #     # #       #     # #
 # # # # # # # # ### # # ### # ####### ### # # # ### ####### ###
 # # # # # # # #     # # #   # #     #   # # # #   # #     #   #
 # # # # # ### ######### # ##### ####### ### # ### # # ### ### #
 # #   # #   #           #     # #     # #   #     # #   #   # #
 # ######### # ############### # # ### # # ######### ### ### # #
 #         #   #   #           #   #   #  G#     #     #   # # #
 ######### ### # # # ############### ####### ### ### # ### # # #
 #   #   #     # #   #        S      #     #   # #   # #   # # #
 ### # ####### # ##### ################### ### ### ### # ##### #
               #       #                           #   #       #
