################################################################
################################################################
#   #             #   #   #     #     #       #   # #           
# # # ######### ### # # # # ### # ### ##### # # # # # # ####### 
# # # #     # # #   # # # #   # # #       # # # # # # #       # 
### # ### # # # # ##### # ### # # ####### ### # # # # ####### # 
#   #   # #   #   #   # # #   # # #     # #   # # #   #     # # 
# ##### # ### ##### # # # # ### ### ### # # ### # ##### ### # # 
# #   #   # #   #   #   #   # # #   # # # #   # #     # #   # # 
# # ####### ### # ########### # # ### # # ### # ##### # ####### 
# #         #   #       # #   #   #     # #   #     # #     #   
# ### ### ### ######### # # # ##### ##### # # ####### ##### # ##
# #   #   #   #       #   # #     #   #   # # #       #   # #   
# ### # # # ####### ####### ##### ### # ##### # ####### # # # ##
#   # # # #   #   #     #   #   #   # #     #       #   #       
### # # # ### # # ### # # ### ##### # ##### ####### # ######### 
#   # # #       #   # # # #     # #   #   #   #   #           # 
# ### # ########### # # # ##### # ##### ##### ### # ######### ##
# #   # #     #     # # #S#                 # #     #   #   #   
# ### # # ### ### ### # # # # ####### ##### # # # ### # # ##### 
#   # # # # #   #     #     #   #   #     # #   # #   # # #     
### ### # # ### ############# # # # # ##### ##### # ### # # ### 
#   #   # #   #     #       # # # # # #     #   # # #   # # # # 
# ### ### # # ##### # ##### # ### # # # ##### # # # ##### # # # 
#     #   # #       # #     # #   # # #       #   #   #   # #   
##### # ### ########### ##### # ### # ######### ##### # ### ### 
#     # # #     #     # #     # # # # #   #   #     # #   # # # 
# ##### # ##### ### # # # # # # # # ### # # # ####### ### # # # 
# #     #     #     # # # # # #   #     # # #         #   # #   
# # ##### # ######### # # # ##### ######### ########### ### ### 
# # #     #       #   #   #       #   #   # # #       #   # #   
### # ####### ##### ### ########### # # # # # # ##### ### # ### 
#   #       #                       #   #   #       # # # # #   
# ######### # ######### ########################### # # # # # ##
# # #   #   # #       #     #   #   #     #       # #   #   #   
# # # # # ##### ##### ##### # ### # ### ### ##### # ########### 
# # # # # #     #   #   #   #     #   #   #   #   # #     #     
# # # # # # ##### ##### # ########### ### ### ##### # ##### ### 
# #   # #   #     #   # #         #   #       #   # # #   # #   
# ##### ##### ### # ### # ####### # ##### ##### # # # # # # # ##
#       #     #   # #   #       # # #   #       #   #   #   #   
########### ####### # ########### # # # ########### ########### 
#  G      #       # # #           # # #   #   #           #     
# ####### ####### # # # ######### # # ### # # # # ### ### # # ##
# #     # #     # # # # #   #   # # #   #   # # # #   #     #   
# ### ### # ### # # # # # # # # ### ### ####### # # ####### ### 
#   # #   #   #   #   #   #   #     #   #       # #     # # #   
### # # ######### ################### ### # # # ####### # # # ##
#   #         #   #     #         #   #   # # # #       #   # # 
# ########### # # ### # # # ####### ######### # # ########### # 
# #     #   # # # #   # # #       #   #     # # # #         # # 
# # ### # # # # # # ### # ####### ### # ### # ### # ####### # # 
# # # #   # #   #   #         #   #   # #   #   # #   #       # 
# # # ##### ######### # ##### ##### ### # ##### # ### ####### # 
# # #     #   #       # #   # #     #   #     # #   #     # # # 
# # # ####### # ####### # # ### ##### ####### # ######### # # # 
# # # #       #   # #   # #   #       # #   #   #   #     #   # 
# # # # ######### # # ### ### ######### # # ### # # # ### ##### 
#     # # #       #   #   #   #         # # #   # # # #   #     
####### # # ####### ### ####### ### ##### ### ### # # # ### ####
#       # # #     # # # #     # #   #     #   #   #   # #   #   
# ####### # # ### # # # ### # # # ### ##### # # ######### ##### 
#         #   #   #         #   #           # #                 
################################################################
