################################################################
################################################################
#       #     #     #     #       # #                       #   
# ####### ### # ### # ### # ##### # # ### # # ##### # ##### # # 
#       # #   # #   # #   # #     # # #   # # #     #     # # # 
# ##### # ####### ### ####### ##### # ##### # # ######### ### # 
# #   # #   #   #   #   #   # #       #   # # # #         #   # 
### # # ### # # # ##### # # # # # ##### # # # # ########### ### 
#   # #   #   # # #  S    # # # # #   # # # # #   #   #   #   # 
# ### ### ##### # # ####### # # # # # # # ### ### # # # # ##### 
#   # #   #   #       #   #   # #   # # #   #   # # # # #   #   
### # # # # ### ##### # # # ### ####### ### ### # # # ### ### ##
#   # # # #   # #   # # # #     #       # #   # #   #     #   # 
# ### # # ### # # # ### # # ##### ####### ### # ########### ### 
# #   # #       # #     # # #   #   #   #     # #           #   
# ############# # ####### ### # ### ### # ##### # ########### ##
# #   #       # # # #     #   #   # #   # #   #   #       #   # 
# # # # ##### # # # # # ### ##### # # ### # # ### # ### ### ### 
# # # #     # #   #   # #   #   # # #   #   #   #     #   #   # 
# # # ##### # # ######### ### # # ### # ####### ####### # ### # 
#   #       # #           #   # #     #         #     # #     # 
############# ### ############# ################# ### ##### ### 
#       #   #   #     #       # #   #         # # #   #   #     
# ##### # ##### ##### ### # # # # # # ####### # # ##### # # # ##
#   #   #   # # #   #   # # # #   # # #     #   #     # # # #   
### # ### # # # # # ### ### # # ### # # ### # ####### # # # ####
#   # #   #   # # #   #   # # #   #   # #   #       #   # #     
# ### # ####### ##### ### ### # # ##### # ##### ######### ##### 
# # #   #     # #   #           #     # # #   #         #     # 
# # ### # ### # # # # ####### ####### # # # # ####### ####### # 
#   # # # #   #   # # #     #   #   # # #   #       # #     # # 
##### # # ######### # # ### # # ### # # ########### # # # ### # 
#   # # # #       # #   #   # #   # #   #         # #   # #   # 
# # # # # # ##### # # ### ### ### # ##### ######### ####### ### 
# #     # #   #   # # #   #   #   # #     #       # #       #   
### ##### ### ##### # # ### # # ### # ##### ##### # # ####### # 
#   #     #         # # #   # #       #     # #   # #   #     # 
# ### ##### ##### ### # ############### ##### # ### ### ### # # 
#     #     #   # #   #       #   #     #     #   #   #   # # # 
# ####### ### # # ### ### ### # # # ##### ##### # ### ### ### # 
#         #   # #   #   # # #   # #       #   # #   # # #   # # 
### ####### ### ### # # # # ##### # ####### # # ### # # ### # # 
#   #     # # #       # #       #   #       # # #   # # # # # # 
# ### ### # # ### ##### ############# ####### ### ### # # # # # 
# #   #     # #   #   # #     #   #   #     #     #       # # # 
### # ####### # ### # ### ### # # # ####### ####### ####### ### 
#   # #   #   #   # #     # # # # # #         #       #   # #   
# ##### # # ##### # ####### # # ### ### ##### # # ##### # # # # 
#     # # # #   # #     # # # #     #   #   #   # #   # #   # # 
##### # # # # ### ##### # # # ####### ##### ##### # # # ##### # 
#     # # #     # # #   # # #       # #   #       # # # #     # 
# ##### # ##### # # # ### # ####### ### # # ##### # # # # ##### 
#       #     #     #     #         #   # #   #   # #   # #   # 
# ########### ##### ##### ########### ### ### # ### ##### # ### 
#           #   #       #             # #   # # #   #     #     
# # ##### # ### ####### ############### ### # # # ##### # ##### 
# # #     #   #   #   # #               # # # # #     # #   #   
# # ######### ### # # # ##### # ####### # # # ####### ##### # ##
# # #   #   # #   # # #       #     #       # #    G  #     #   
# # # # # # ### ### # ####### ##### ######### # ####### ####### 
# # # #   # #   #   #     # #     # #       # # #   #   #   #   
# # # ##### # ### ####### # # ### # # ##### ### # # # # ### # ##
# #   #     #     #       #   #   #       #     # #   #     #   
################################################################
