################################################################
   #     #     #           #               #     #   # #       #
 # ##### # ### # ######### # ##### ### ### ##### # # # # #######
 # #   # #   # #         #     #   # # #   #     # # #     #   #
## # # # ### # ######### ##### # ### # # ### ####### ##### # # #
   # #       #           #   # # #   # #     #     # #   # # # #
 ### ### ################# # ### # ### # ##### ### # # # # # # #
   # # # #           #   # # #   # #   # #     #   # # # # # # #
## # # # # ######### # # # ### ### ### # # ##### ### ### # # # #
   # #   # #     #   # # #     #       #       #           # # #
 ### # ### ### # # ### # ############################# ##### # #
   # #         # #     #       #             #   #   #   #   # #
## ####### ##### ####### ##### # ########### # # # # ### # ### #
   #   # # #     #     #   #   #       #   #   #   # # #   #   #
 ### # # # # ### # ### ### # ######### ### ######### # ##### # #
   # # #   # #   #S# #   # #   #     # #   #         #       # #
## # # ##### # ### # ### ####### ### # # # # ################# #
 #   #       #   #     # #   #   # #   # # #     #       #   # #
 ######### ##### ##### # # # # ### ##### # ##### ##### # # ### #
 #     #   #         # # # #   #       # # #     #     # #   # #
 ##### # # # # ####### # # ##### ##### ### # ##### ##### ### # #
     #   # # # #   #   # # # #   #   #   # #     # #   #   # # #
#### # ### # # # # # ##### # # # # # ### # ##### # # # ### # # #
     # #   # # # # # #     # # # # #   # # #   # # # #   # #   #
#### ### ### # # # # # ##### # ### ### # # ### # # ##### # ### #
   #     #   # # # #   #       #   #   # #   # # #   # # # #   #
 # ####### ### # # ####### ##### ### ### ### # # ### # # # # ###
 # #     #   # # # #       #     #   #   #   # #     #   # #   #
 ### ### ### # # # # ##### # ##### ### # # ### ####### ### ### #
   # #       #   #   #   # # # #   #   # # #     #     #   #   #
## # ########### ##### # # # # # ### # # # # ### # # # # ##### #
     #         #       # # # # # #   # # # # # #   # # #     # #
 ##### ####### # ##### # ### # # ### # ### # # ##### # ##### ###
 #     #       # #   # #       #   # #         #   # #     #   #
 # # ##### ##### # # ##### ####### # ########### # # # ####### #
 # # #   # #     # #     #   #     #     #     # # # #   #     #
## # # # # # ### # ##### ##### ### ####### ### ### # # ### #####
   # # #G#   #   # #   #   #   #   #     #   #   #   # #   #   #
 ##### # ##### ### # # ### # ##### # ### # ##### ##### # ### # #
 #   # # #       # # #   # # #     #   #   #     #     #   # # #
## # ### ####### # ##### # # ##### ### ##### ##### ####### # # #
   #     #   #   #   # #   #   # # #   # #   #     #     # # # #
 ######### # # # ### # ####### # # # ### # ######### ### # # # #
   #       # # # #   # #       #   #     # #         #   #   # #
## ######### ### # ### # # ############# # # ######### ####### #
 #   #     #     #   #   # #     #   #   # # #   #     #     # #
 ### # ### ##### ### ##### # ### # # # ### # # # # ####### ### #
   # #   #         #     # # # # # # #   #   # # #       # #   #
## # ##### ############# # # # # # # ### ##### ######### # # ###
       #   #   #         # # # # # #   #   #           #   # # #
 ##### # ### # # ########### # # # ### ### ######### ####### # #
 #   #   #   # # #   #         # #   #     #   #   # #       # #
 # # # ### ##### # # # ##### ### ### ####### # ### # # ####### #
 # #   #   #   # # #   #   # #   # #         # #   # # #       #
 # ### # ### # # # ##### # ### ### ########### # # # # # ##### #
 #   # #   # # # #     # #   # #           #   # #   #   # #   #
#### # ### # # # ### ### ### # ##### ##### # ##### ####### # ###
   # #       # # #   #   # #   #   #   # # #     #       # #   #
 # ####### ##### # ### ### ##### # ### # # ##### ####### # ### #
 #       #   #   #   #     #     #     # # #   # #   #   # #   #
 ####### ### # ##### ########### ####### # # ### # # ### # # ###
       #     #   #   #   #     # #   #   # #   # # #     # #   #
###### ##### ### # ### # # ### # # # ### # ### # # ##### # ### #
       #               #   #     # #               #           #
