################################################################
       #     #         #                                       #
 ##### # ### ### ##### ##### ####### ### # ####### # ### ##### #
   #   #   #     #   #     #       #   # #     #   # #   #   # #
 # # ##### ####### # ##### # ##### ### # ##### # ### ##### # # #
 # #   #   #     # #       # #   #   # #   #   #   #       # # #
 # ### # ####### # ######### # # ### ##### ####### ##### ### ###
 # # # #   #     #   # #   #   #   # #   #   #     #   #   #   #
 # # # ### # ####### # # # # ##### # # # ### ### ### # ### ### #
 #   #   #   #   #   #   # # #   # # # #     #   #   # # #   # #
 ####### ####### # ####### # # # # # ######### ####### # # ### #
 #     #   #     # #   #     # # # #         #         # #   # #
 # ### ### # ##### ### # ####### # ######### ########### ### # #
 # #   #   #     #   #   #     #   #       #   #     #       # #
 # ##### ### ####### # ### ### ##### ######### # ### # # ##### #
 #   #   #           # #   # # #     #     #   # # # # # #     #
 ### ### # ########### # ### # ### ### ### # ### # # # ### #####
   #   # # #       #         #   #     # #   # # # # #   #     #
 ##### # # # ####### # # ### ### ####### ##### # # # ### ##### #
     #   # #     #   # #   #   # #     #     # #   #   #   #   #
 ### ##### # ##### ### ### ##### # ######### # ####### ### # # #
 # #           #     #   #   #   #   #   #   # #   #   #   # # #
 # ### # ##### # ##### # ### # ##### # # # ### # # # ##### # # #
 # #   #     #   #   # #   # # #   #   #         # #     # # # #
 # # ### ### ####### ##### # # # # ##### ##### ######### ### # #
   # # #   #   #   #       # # # # #   # #   # #       # #   # #
 ### # # # ### # # ######### # ### # ### # # # # ##### # # #####
 #   #   #   #S  #   #     # #   # #     # # # # #   #   #     #
## ### ######### ### # ### # ### # ####### # # # ### ######### #
   #   #   #   #   #   #   # #   #         # # #   #     #   # #
 ####### # # # # ####### ### # ############# # ### # # # # # # #
 #       #   # #       #   # #   #   #   #   # #   # # #   #   #
 # ########### ########### ##### # # # # # ### # ### # ####### #
   # #   #   #   #     # #   #   # #   # # #   #   # # #       #
#### # # # # ### # ### # ### # ### ##### # # ##### # # ####### #
 #   # # # # # #   #   #   # #   #     # # # #   # # #   #     #
 # # # # # # # ##### ##### # # # ####### # # # ### # ### # #####
   # # # # # # # #   #       # # #     #     #   # # #   #     #
 ##### # # # # # # ########### # # ### ##### ### # # # ####### #
     # # # #   # # #         # #   # #   #       # # #   #     #
#### # ### ##### # ######### # ##### ### # ##### # ##### # ### #
   #     #       #     #   # #       #   # #   # #       #   # #
 # ##### ####### ### # # # # # ### # # ##### # # ######### # # #
 #     #           # # # #   #   # # #   #   #         # # # # #
 ##### ########### # ### ##### # # ##### # ##### # ### # # # # #
     # #           #   # #     # # #   # # #   # #   # #   # # #
#### # # ####### ##### # ### ### # # # # # # ### ### # ##### # #
     #   #     # #   # #   # #   # # # # # #   # #   #       # #
 ######### ##### # # # ### # # ### # ### # ### # # ####### #####
       #   #   # # # #   # # # #     #   #G#   # #     #   #   #
###### # ### # # # ##### # ### ####### ### # ### ##### ##### # #
 #     # #   #         #   #   #     #   # #         #       # #
 # ##### # ##### ##### ##### ### ### ### # ################### #
 #   # # # #     #           # # # #     #   #             #   #
 ### # # # # ##### ##### # ### # # ####### # # ########### # ###
   # # #   #     # #   # #     # # #       # #       #     #   #
## # # ### ##### # # ### ####### # ######### ####### ######### #
   # #     #   # # # #   #   #   #                 # #       # #
 ### # ##### # ### # # ### # # ############### ##### # ##### # #
   # # #   # #   # #   #   #   #     #       #     #   # #   # #
## # # # # # ### # ##### ####### ### # ### # ##### ##### # ### #
   # # # #   #   #     # #   # # #   # #   #     #       # #   #
 ### # # ##### ####### # ### # # # ### # ####### ##### # # ### #
     # #     #         #     #   #     #       #       # #     #
