################################################################
#                                   #   #   #   # #       #     
####### ############# ##### # ##### # # ### # # # # ##### # ### 
#     # #             #   # #   #     #   #   # # #   #   # # # 
# ### # ####### ####### # ##### ######### ##### # ### # ### # # 
#   # #   #   # #       # #   #     #   # #     # #   #   # # # 
##### ### # ### # ####### # # ### # ### # # ##### # ##### # # # 
#   #     #     # #     # # #   # # #   # #       #   # #   # # 
# # ############# # ### # # ### ### # ### # ##### ### # ##### # 
# # #     #       # #   #   # #     # #   # #   #   # # #     # 
# ### ### # ####### # # ##### ####### # ##### # # ### # # ##### 
#   #   # #   #     # #               #       # # #   # #     # 
### ### # ### ####### ##### # # # ### ### ##### # # ### # ### # 
# #   # #     #     #   #   # # # # #     #   # # # #   #   #   
# ### # ####### ### ### # ### ### # ##### # # # # # # ##### ####
# # #   #     #   #     #   # #   # #     # # # # #   # #   #   
# # ### # ### ############# # # ### # ##### # # # ##### # ### # 
#       # #     #       #   # #     # #   # # # #   #     #   # 
# ####### ##### # ##### # ### ####### # # # # # # # # ######### 
# #       #   #   #     #   #   #     # #   # # # # #   #       
### # ##### ####### ########### # ##### ##### # # ##### # ##### 
#   # #     #       #           # #     # #       #     #   #   
# ##### ##### ####### ########### # ##### # ##### # ####### # ##
# #     # #   #     #           # #     #   #   # #       # #   
# # ##### # ##### # ####### ##### ####### ### # # ####### ##### 
# #   # #   #     #       # #   #   #   # # # # #   #     #   # 
# ### # # ### ########### ### # # ### # # # # # ### # ##### # # 
#     # #     #         #     # # #   # #   # #   # #     # # # 
####### ####### ####### ####### # # ### # ### ### # ##### # # # 
# #     #     #   #   # #   #   # # #   # #   #   #   #   # # # 
# # ##### ####### # ### # ### ##### # ### # ### ####### ### # # 
#   #   #   #     #   # # #   #     # #   #   #       # #   # # 
# ### # ### # ####### # # # ### # ### # # ### ####### # ##### # 
# #   #   # # # #   #   # #   # #   # # #         #   # #       
# # ##### # # # # ####### ### # ##### # ##### ##### ### # ##### 
# # #   #   # #         #   # # #   #   #   #     #     # #   # 
# # # ####### # ####### ### # ### # ### # # ### # ####### # # # 
# # # #   # # # #     #     #     #  G#   #   # #         # # # 
# # # # # # # ### ### ### ########### # ##### ### # # ##### # ##
#       #   #     # # #   #         # #     # #   # #       #   
# ################# # # ### ##### ### ### ### # ############### 
# #   #           # # # #   #   #   #   # #   # #       #     # 
# # # # ### ### ### # # # ### # ### ### # # ##### ##### ##### # 
#   # #   #   # #   #       # #   #   # # # #   # #   #   # # # 
# ### ### ### # # ##### # ### ### # ### # ### # # # ##### # # # 
# #   # #   # # #     # #   # #   #   # #     #   #   # # #   # 
# # ### ### # ####### # ### # # # ### # # ######### # # # ### # 
# #     #   # #     #     #   # #   # # #   #       #   #   # # 
# ####### ### # ####### # ##### ### # # ### # ##### ####### # # 
#       # #   #         #     # #   #   #   #   # # #       #   
##### ### ################# # # # # ##### ##### # # # ######### 
# #   #   #         #       # # # # #   # # #   #   #   #   #   
# # ### ### ##### # # ######### # # ### # # # ########### # # ##
# #   # #   #     # #       #   # #     # # # #   # #     # #   
# ### # # # # ##### ####### # ### ##### # # # ### # # ##### ### 
#   #     # #   #           #   #     #             #   # # # # 
### # ######### ####### ####### ### # ########### ##### # # # # 
#     #       # #   #   #     #   # #           #     # # # #   
# ##### ##### ### # ### # ### # # # ########### ####### # # ### 
#   #S  #         #   # # #   # # #         #   #     #   # # # 
### # ### ########### ### # ##### ### # ### # ### ### ##### # # 
#   #   # #       # # #   #   #   # # # #   #     # #     # #   
# ##### ### ##### # # # ##### # ### # # # ######### ##### # ### 
#     #         #   #   #       #     # #               #   #   
