################################################################
################################################################
# #         #         #           #     #             #       # 
# # ####### # ####### # ##### # ### # ### # # ####### # # ### # 
# # #   #   # #     # # #     # #   #   # # #   #   #   #   #   
# # # # # ### # ### ### # ####### ##### # # ### # # ####### ### 
# # # #   #   # # #     # #           #   #   #   #   #   #   # 
# # # ##### # # # ####### # ######### ####### ### # ### ##### # 
#   # #     # # #   #     # #   #   #   #   #   # #   #     # # 
##### # # ##### ### # ##### # ### # ##### # ### # ### ##### # # 
#   # # #   #       # #     #   # #       #   # #   #   # #   # 
# # # # ### # ####### # ####### # ########### # # # ### # ######
#S#       #     #   # #         # #   #       # # #   #     #   
### ##### ####### # # ####### ### # # # ####### ### # ####### # 
#   #   # #     # # #   #     #   # # #   #   # #   #   #     # 
# ### # # # ### # # ##### ##### ### # ##### # # # ##### # ##### 
#   # # # #   #   #   #   #   #     # #     # # # #   # # #     
# # # # ##### ####### # ### # ####### # ##### # ### # ### # ### 
# #   # #   #       #   #   #       #   #   # #     #     # #   
# ####### ######### ##### ######### ##### # # ############# ####
# #             #   #   #   #   #       # # #   #   #     #     
# # ### ##### # # # # # ##### # # ####### # ### # # # ### ##### 
#   #   #     #   # # # #   # # #   #     # # #   #   # #   #   
### # ### ######### # # # # # # # ### ##### # ######### ### # ##
#   #   # #       #   # # #   #   #   #     #         # #   #   
# ##### # # ########### # ######### ### ############# # # ##### 
# #     #   #   #       #   #       # #   # #           # #   # 
# # ### ##### # # ######### # ####### ### # # ##### ##### # # # 
# # # #       # #     #   # #         #   #   #     #     # #   
# # # ##### ### ##### # # # ########### ####### ##### ##### ####
# # #     #   # #   # # #           # #   #   #     #       #   
### ##### ### ### # # ####### ##### # ### # # # ### ######### # 
#   #   #     #   # #       #     # #   #   # # #   #         # 
# ### # ##### # ### ####### ##### # ### ##### ### # # ##########
# #   #       # #   #     #   # # #   #   # # #   # #           
# ########### # ##### ### ### # # ### ### # # # ### ########### 
#   # #       #     # # # #   #   # #   #   #   # # #   #       
### # # ##### ##### # # # # ####### ### ### ##### # # # # ##### 
#   #   #         #   # #   #         #         #   # # # #   # 
# ####### ### ######### ##### ##### # ##### ##### ##### # ### # 
# #       #   #     #       # #     #   #   #     #     #   # # 
# # ####### ### ### # ##### # # ##### # # ### ####### ##### # # 
# #       # #   #   #     # # # # #   # #           #       #   
# ##### # ### ### ####### # # # # # ### ### ####### ######### ##
# #   # #       #   # #   # # # # #   #   # #     # #   #   #   
# # # # ########### # # ##### # # ### ### # # ### # ### # # ### 
# # # #       #   # #         # #   # #     #   # #   #   #     
# ### ##### # # # # ########### ### # # ######### ### # ########
#   # #   # # # # #     #   #   #   # # #   #     # # #         
# # # # ### # # ##### # # # # ### ### # # # # ##### # # ####### 
# # # #     # #     # #   # #   # #   # # # # #   # # #   #   # 
### # ##### ####### # ##### # # # # ##### # # # # # # ### ### # 
#   #   #   #     # # #     # #   #       # # # #   # #       # 
# ##### # # # ### # # # ##### ############# # ### ### # ####### 
#       # # #   # # # #   #   #     #     # #   #       #       
########### ### # # # ### # # # ### # ### ##### ### ########### 
#   #    G    # #   #   # # #   #   # # #     #   #   #     #   
### # ####### # ######### ########### # ##### ### # # # ### # # 
#   # #       #       #   #         # #   #   #     # #   # # # 
# ### ##### ######### # ### ####### # ### # ### ######### # ### 
#     #   #     #   #   #   #   # #   # #   #       #   # #   # 
####### # ### # # # ##### ### # # ##### ##### ##### # # ##### # 
#       #     #   #           #                   #   #       # 
################################################################
