################################################################
 #   #       #   #       #   #   #   #   #             #   #   #
 # # # ##### # # ####### ### # # # ### # # # ##### ### ### # # #
 # # #   #   # #   #   #   #   # # #   #   #     # # #     # # #
 # ##### ### # ### # # ### ##### # # ########### # # ####### # #
       #   #   # # # #   #   #   # # #       #   #   #   #   # #
###### ### ##### # ##### ### # ### # # ##### # ### ### # ##### #
     #   #       #   #       #       #     # # #     # #       #
 ### # ############# ####### ####### ####### # # ### # #########
 #   #   #   #     #       #   #   #   #     # #   #       #   #
## ##### # # ### ######### ### # # ### # ### # ### ####### # # #
   #   #   #   #   #     # # #   #   # #   # # #     #   #   # #
 ### # ####### ### # ### # # ####### # ### # # ####### # #######
 #   # # #         #   #   #   #     #     # # #   #   # #     #
 ##### # # ########### ####### # ########### ### # # ### # ### #
   # # #   # #       # #     # #         #       # # #   #   # #
## # # ### # # ### ### # ### # ######### ##### ##### ####### # #
 # # #   #   #   #     #   #     #       #   # #   #       # # #
 # # ### # ##### ######### ####### ####### # # # # ####### # # #
   # #     #   #         # #     #         # # # # #     #   # #
 ### # ##### # ######### # # ### ########### # # # # # # ##### #
         #   #     #     #   #   #   #   #   # # # # # #     # #
 # # ##### ### ### # ##### ####### ### # # ### # # # # ####### #
 # # #     # #   # # #   # #       #   # #   # # #   #       # #
 # ### ##### ### ### ### # # ### ### ####### # # ########### # #
 #   #   #     #   #   # #   # # #   #     # # #       #   #   #
 ### ### ### ##### ### # ##### # # ### ### # # ####### ### #####
 #     #   # #   # #   #     #       #   # #   #     #   #     #
 # ####### # # # # # ####### ####### ### ##### # # # ### # ### #
 # #       # # # #   #     # #   #     # #     # # #   # #   # #
 # # ####### # # ######### # # # ##### # # ##### # ##### ##### #
 #   #         #     #     # # #   #   # #   #   #       #   # #
 ##### ### ##### # ### ##### # ### ### # ### # ########### # # #
 #       #   #   #   # #     #  G#       #   #         #   #   #
 # ##### # # # ##### # # ############# ### ########### ### #####
 # # #   # # # #   # # #       #     #     #         #   # #   #
 # # # ### # # ### # # ####### # ### # ##### # ##### ### # # ###
 #   # #   # #   #   # #     # #   # #   #   #   #   #   # #   #
 # ### # ### ### ### # ##### # ### # ### # ##### # ### ### ### #
   #   #   #   # #   #   #         #       #     # #   # #     #
#### ### # ##### # # ### ################# # ####### ### # #####
     #   #   #   # # #   #       #       # # #     #   # # #   #
 ##### ##### # ### # # ### ##### # ##### # ### ### ### # # # # #
 #   # #   # #   # # #   # #   #   #   # #   # # #   # # # # # #
 ### ### # # ### # # ### # # # ### # # # ### # # ##### # # # # #
   #     #     # # # # # # # #     # # #           #   #   # # #
## ####### ##### # # # # # ##### ### # ########### # ### ### # #
   #       #   # # #   # #     #   # #   #   #   #         # # #
 ### ### ### # # # ### # ### # ##### ##### # # # # ######### ###
 #   #   #   #   #   # #   # #       #     #   #           #   #
 ####### # ####### # ##### # ######### ######### ######### ### #
   #     #   #   # #     # #   # #     #S  #   # #   #   #     #
## ### ##### # # ##### ### # # # # ##### # # # # # # # # ##### #
 #   #   #   # #     # #   # #   #     # # # # #   # # #     # #
 ### ### # ### ##### ### ### ########### # # # ### # # ##### ###
 #   #   #   # #   # #   #   #   #     # #   #   # # #     #   #
 # ### ##### # # # # # ####### # # ### ######### # # ##### ### #
 #   #     # # # # # #       # # #   #     #   # # #   #   #   #
 # # ### # # # # ### ####### # # ### ##### # # # # ##### ### ###
 # # #   # # # #   #         # #   #     #   # # #   #   #   # #
 ### # ##### # # # ############### ##### ##### # # ### ### ### #
 #   #     #   # #         #   # #   #   #   # #   #   # #     #
 # ####### ##### ######### ### # ### ##### # # # ### ### #######
   #                     #                 #                   #
