################################################################
           #   #       #         #   #       #     #       #   #
 # ####### ### # ### # # ######### ### ### ### ### ####### ### #
 #   #   #   # # #   #   #   #     #   # #     #   #   # #     #
 ### # ##### # # # ####### # # ##### ### ####### ### # # # ### #
 # # #   # # #   #   #     # # #     #   #     #   # # #   #   #
 # # ### # # ### ##### ##### # # ##### ##### ##### ### ##### # #
 # #   #   #   #     # #   #   #   # # #   #     #     #     # #
 # ### ### ### ##### # # # ####### # # ### # ########### ##### #
 # # # #   # # #     #   #           #       #       #   # #   #
 # # # # # # # # ### ########### # # ##### ### ##### ### # # ###
     # # #       # #     #     # # # #   # #   #   #   #   #   #
#### # ########### ##### ### # # # # # # # # ### ##### ####### #
   # #       #         #     #   # #   #   #  S      #     #   #
 # ######### ##### ### ### ####### ### ######### ######### # ###
 #         #     # #       #     #   # #       # #       # #   #
 ######### # ### ### ####### ### ### # # ### ### # ##### # ### #
 # #   #   #   #   # #     #   #     #   #   #   # #   #   # # #
 # # # # ######### # # ####### ### ########### ### # # ##### # #
 #   # # #         # # #   #   #   #           #   # #     #   #
 ### ### # ######### # # # # ####### ########### ### ##### # ###
   #   # # #         # # # #   #   #     #     #       #   #   #
 # ### # # # ### ### # # ##### # # ##### ##### ######### ### # #
 # #   # # #   #   #   #   #   # #       #   # #   #   # #   # #
 # # ### # ### ### ####### # # # ######### # # # # # # # # #####
 # # #   # #   #   # #     # # # #   #   #G#   # #   #   #     #
 # # # ### # ### ### # ##### ### # ### # # ##### ######### ### #
 # #       #   #     # #   #     #     # # #     #           # #
## # ################# # ############### # # ##### ########### #
   # #               # #   # #           #   #   #   #         #
 ##### ############# # ### # # # ####### ##### # ### # #########
   #   #           #   #   #   #     # #     # #   # #   #     #
 # # ### ####### ####### ########### # ### ### ### # ### ##### #
 #   # #   #   # #       #   #   #   # #   #   # #     #     # #
 ##### # ### # ### ####### # # # ##### # ### ### ########### # #
         #   #   # #       #   #   #     #   #   # #       #   #
## ##### # ##### # # ############# ##### # ##### # # ##### # ###
   #   # #     #   #   #   #       #       #       # # #   #   #
 ### # ####### ####### # # # ####### ##### ### # ### # # ### # #
     #       #       # # # #       # #   #     # #   # #   # # #
 ########### ####### # ### ####### ### # ####### # ### ### ### #
     #     #         #   # #   #   #   # #   #     #     #   # #
 # # # ### ############# # # ### ### ### # # ### ##### ##### # #
 # # # #       #       #   # #   #   # # # #   #     # #     # #
 # # # # # ##### ##### ##### # ####### # # ### ##### # # ##### #
 # # # # # #     #   #     # #       # # # #   #     # # #     #
 # ### # ### ##### # ##### # ####### # # ### ### ##### # #######
 #     # #   # #   #       #       #         #   #     #       #
 ####### # ### # ############### ### ####### # ### # # ####### #
       # #     #   # #   #     #   # #     #       # # #     # #
## ### # ######### # # # # ### ### # # ### ######### # # ### # #
   #   #       #   #   # #   # #   # # # #       # # # # #   # #
 ############# # ####### ##### # ### # # ####### # # # # # ### #
   #     #   #   #     # # #         # #       # #   #   #   # #
## # ### # # ##### ### # # # ##### ### # ####### ############# #
   #   # # #     # # # #   # #   # # # # #     #         #   # #
 ##### # # ##### # # # ### # # # # # # # # ### ######### # # # #
 #   # # #     #   #   #     # # #   # # #   # #         # #   #
 ### # # ##### ##### ####### # # ##### # ##### # ######### #####
   #   #       #     #     #   # #     # # #   #     #       # #
 # ############# ##### ### # ### # ##### # # ### ### # ##### # #
 # #     #   #   #   #   # # # #   #   # # # #     # #   #   # #
 # # ### # # # ##### ##### # # ####### # # # ####### ### # ### #
 #     #   #                               #         #   #     #
