################################################################
#       #   #                       # #   #                 #   
##### # # ### ### # ############# # # # # # ############# # ### 
#     # #     #   # # #       #   # #   # #   #         # #     
# ##### ####### # # # # ##### # ### # ### # ### ####### ########
# #   #         # #   # #   #   #     #   # #   #     #   #     
# ### ########### ##### ### ##### ##### ### # ### ####### # ### 
#   # #     #   #     #     #     #   #   # #     #       # #   
### # # ### # # ##### ####### ##### # ### # ####### ####### # ##
# #   # # #   #   #   #       #   # #   # # #G#   #       # #   
# ##### # ####### # # # # ##### # # ### # # # # # ####### # ### 
#     #   #         # # # #     #   # # #     # #     #   # #   
##### # ############# # # # ######### # ####### # # # # ### # ##
#   #   #           # # # # #       # #       # # # # #     #   
### ### # ######### ### # # ### ##### ####### # # # ########### 
#       #         #   # # #   #     # # #     # # #           # 
# ############### ### # # ### # ### # # # ##### # # ### ### ### 
#   #       #     # #   # # # # # # #   #   #   # #   #   # #   
##### ##### # ##### ##### # # # # # # ##### # ### ####### # # ##
#   #   #   # #   #         # # # #   #   #   # #   #   # # # # 
# # ##### ##### # # ######### # # ##### # # ### ### # ### ### # 
# #       #     # #   #     # # #     # # #     # # #     #   # 
# ######### ##### ### # ### # # # ### # # ### ### # ####### ### 
#     #     #   #   #     #   # # #   # #   # #   #         #   
##### ####### # ### # ##### ### # # ### ### # # # ########### # 
#   #   #   # #       #   #     # #   # #   #   #       #     # 
### ### # # # ##### ### # ##### # ### # # ### ####### # # # ####
#   # # # #   #         #     #   #   # # #     # #   #   #     
# ### # # ### # ############# ######### # ### # # # ########### 
#     #   #   #  S      #   #       #   #   # #   # # #       # 
##### ##### # ##### ##### # ####### # ##### ####### # # ##### # 
#           #   # #       #       # #     # #     #   # #     # 
# ####### ### # # ############### # ##### # # ### ### # # ##### 
#       #   # #   #             # #     # #   # #   # # # #   # 
# ##### ### ### ### ############# # ##### ##### ### # # # ### # 
#     #   #   #   #     #         #       #     #   # # #   #   
# ####### ### ######### # # ############### ##### ##### ### ### 
#   #       #     #   # # #       #   # #   #   #       # #   # 
### # ### ####### ### # ######### # # # # ### # ######### ### # 
#   # #   #     # #   #           # #   # # # #   #     # # # # 
##### # ### ##### # # ############# ##### # # ### # ### # # # ##
#     #   #       # # #   #   #     #     # # # # #   #   # #   
# ####### ######### # # # # # # # ### ##### # # # ### ##### ### 
# #       #       # #   # # #   #     #   #   # #     #   # #   
# # ####### ##### ####### # ############# # ### ####### # # # ##
# #         #   #   #   # #   #         #   # #   #     #   # # 
# ########### # ### # # # ### # # ##### # ### ### # ##### ### # 
#         #   #   #   #     # # # # #   # #     #   #   # #   # 
# ####### # ##### # ######### ### # # ### # ######### # # # # # 
#   #   # # # #   #   #       #   #   #   #       #   # # # # # 
# # ### # # # # ##### # ####### ### ##### # ##### # # ### # ### 
# #     #   # #   #   # #     # # #     # # #   #   # #   #     
# # ######### ### ##### # ##### # ##### # # # # ##### # ########
# # #   #       # #   # # #     # #   # # #   #   #   #         
# # # # # ##### # # # # # # ##### # # # # ####### ############# 
# #   #   #   # # # # # # #       # # # # #   #             #   
# # ######### # # # # # # ######### ### # # # ############# # ##
# #         # # #   #   #   #         # #   #     #         #   
# ####### # # # ######### # # ####### # ######### # ####### ### 
# #     # # # #   #       #       # # #       # # #       #   # 
# # ### # # # # ### ##### ##### # # # ####### # # ### ### ### # 
#   # # # #   # #   #   #     # #   #   #     # #   # #   #   # 
# ### # # ##### # ### ####### ########### ##### ### # ######### 
#   #   #     #             #                                   
