################################################################
################################################################
# #   #   #   #         #     #     #   #       #   #     #     
# # ### # # # ##### ### # ### # # # # # # # # ### # # ### # ### 
#       #   # #   # #   # #   # # # # #   # # #   # #   # # #   
# # ######### # # # # ### # ### # ### ##### # # ### ### ### # ##
# # #   #       # # #   # #     #     #     # #   # # #     #   
# # # # ######### # ### # ############# ### ####### # # ####### 
# # # #   #   # # # #   # # #       #   #   #   #   #   #   #   
# # # ### # # # # # # ### # # ##### # ####### ### ##### # # ### 
# # # # #   # #   # # # #   #   #   #       #   # #     # #   # 
### # # # ### # ##### # # ##### ##### ##### ### # ##### # ### # 
#   # # # #   #           #   #   #     #   #   #     # # # #   
# # # # ### ##### ##### ### # ### # ### # # # ####### # # # ### 
# # # #     # #   #   # #   # #   # # # # # # #     # # #   #   
# # # ####### # ### # ### ### # ### # # # ### # ##### # ####### 
# # #  S#     # #   # #   # #   #   #   #     #   #   #   #   # 
# ##### ### # # # ### # ### ############# ##### ### ####### # # 
#     #   # #     # # # #   # #         # #       #     #   # # 
# ####### # ##### # # # # ### # ####### # # # ### ##### # ### # 
#   #     # #   # # #   # #   # #   #   # # # #       #   # # # 
### # ####### # # # ##### # ### # # # ### # # ####### ##### # # 
#   # #     # # # # #   #   #   # # #   #   #   #   #       #   
# ### ##### # # # # # # # ### ##### ### # ##### # # ####### ### 
#   #     #   # #     # # #   #   #   # #     # # #       #   # 
######### ##### # ##### # # ### # ### # ### # # ######### ### # 
#     #     #   # #   # # # #   #     # #   # # #     #   #   # 
# ### ##### ### # # # # # # # ##### ### # ### # # # ### ### ### 
#   #   #     #   # # #   #   #   # #   # #   #   # #   #   #   
### ### ##### # ### # ####### # # ### ### ### ##### # ####### ##
#   # #   # #       #   #     # # #   #     #     #   #     #   
# ### ### # # ######### # ####### # ####### # # # ##### ### ### 
# # # #   #   #   #   #       #   # #       # # # #   #   #   # 
# # # # ### ### # # # ######### ### # # ##### ### # # ### # ### 
# # #   #     # # # #   #     # #   # #     # #   # #     #     
# # ######### # # ##### # ### # # ######### # # ### ############
# #     #   # # #     # # #   #   #     #   # #   # #     #     
# # ### # # # # ##### # # ### ####### ### ### ##### # ##### ### 
# #   #   #     #   #   #   # #     # #   #   #     #     #   # 
# ########### ##### ####### # # ### # # ### # # ######### ### # 
#       #   #           #   # #   # #   #   # # #         #   # 
####### # # ########### # ### ### # ##### ### # ### # ##### ### 
#     # # # #     #   # # # #     #   #   #   # #   #   #     # 
### ### # ### ### # # # # # ######### ##### ### # # ### # ##### 
#   #   #     # # # #   #   #   #   #   #   # # # #   # # # #   
# ### ######### # # ### ####### # # ### # # # # ### # ### # # ##
#   #     #         #           # #   # # #   #   # #   #   #   
### ##### # ######### ########### # ### # ####### # ### ### ### 
#     #   #   #     # #           #     # #   #   # # #     #   
# ##### ##### # ### # # ################### # # ### # ##### # ##
#   #   #     # #   #   #                   #   #     #   # #   
### # ######### # ### ### ####################### ##### # # ####
#   #   #     # # #   #   #     #     #       # #   #   # # #   
# ##### # ### # # ### # ### ##### # # # ### # # ### # ### ### # 
# #  G# # # #   # #   #   # #     # #   #   #   #   # # #     # 
# # ### # # ##### # # ### # # ##### ### # ####### ### # ####### 
# #   #   # #     # #   #     #   #   # #       #   #     #   # 
# ### ##### # ##### ### # ##### # # # ######### ### ##### ### # 
# #     #   # #     #     #     # # # #       #     #   #   # # 
# # ### # # # # ##### # ### ##### ### # ##### ####### # ### # # 
# #   # # #   #     # #   # #   # #   # #     #   #   #   # # # 
# ##### # ######### # ### ### # # # ### # ##### # # ##### # # # 
#                   #   #     #   #     #       #       #   #   
################################################################
