################################################################
################################################################
   # #     #                             #       #           # #
 # # # ##### ######### ################### ##### # ######### # #
 #   #     # # #     # #                 #     # #   #   # # # #
 ### ##### # # # ### # # ############### ##### # ### # # # # # #
 # # #   #   # #   #   # #     #       #       #       #   # # #
 # # # ####### ### ##### # ### # # ######################### # #
   # #                 # #   #   #     #                   #   #
#### ######### # ##### # ### # ####### # ################# #####
   #           # #           # #       #   #             # #   #
 # ### # ####### # # # # ##### # ######### # ########### # # # #
 #     #   #     # # # # #     #       #   # #     #   # #   # #
 ########### ### # ### # # ############# ### # ##### ### ##### #
   #         #   # #   # #     #         #   #     #   # #     #
#### # ########### # ### ##### # ########### # ### ### # # #####
     # #       #   #   #     #   #   #   #   #  S#     # #     #
 ####### ##### # ##### # ########### # ### ### ######### ##### #
 #   #   #       #   # #   #         #     # # #         #     #
 # ### ########### # # # # # ############### # # ######### #####
 #   #       #   # # # # # #     #   #   #     # #     #   #   #
 ### ####### # # # # # ### ##### # ### # ##### # # ##### ##### #
   # #     # # # # # #   # #     # #   #   #   # # #   # #   # #
 ### # ##### # # ### ### # # ##### # ##### # # # # # # # # # # #
 #   #     #   #     #   # # # #     #     # # # #   # #   #   #
 # ####### ########### # ### # # ##### ##### # # ##### #########
   #     #         # # # #   # #     #     # # # #     # #     #
 ####### ######### # # ### ### ##### ##### ### # # ##### # ### #
         #       # # #     #         #   # #   # #     #   #   #
## ### ### # ##### # ####### ### ##### ### # ### ##### ##### ###
 #   #     #       #           # #   #     # #   #   #     #   #
 # # # # ########### ##### ### # ### ####### # ### ####### # # #
 # # # #           #   # # #   #                             # #
 ### # ### # # # ##### # # ############# ##### # ########### # #
 #   #   # # # #         #         #   #     # #   #   #   # # #
 # ##### ### # ######### ##### ### # # ##### # ### # # # # ### #
 # #   #   # #         # #   #   # # #       # #   # # # # #   #
 # # # ### # ######### ### # ### # ### ####### ##### # # # # ###
   # #   # #       #   #   # #   #   # #   #         #   # #   #
#### ##### ####### ##### ### # ##### # # # ########### ### # # #
   # #     #       #     # # # #   # # # #     #     # #   # # #
 # # # ##### ##### # ##### # # # # # ### ##### # ### # # ##### #
 #   #     # #     #     #   #   # #     #   # #   # # # #     #
 ######### # ##### ####### ####### ######### # ### # ### # #####
 #         # #   # #       #   # #           #   # #     #     #
 # # ####### # # ### ####### # # ####### # ##### # ########### #
 # #   #   #   #     #       # #   #     #  G#   #   #         #
 ##### # ############# ####### ### # ### ##### ##### ###########
   #   #               #     # #   # # # #     #     #   #     #
## # ##### ### # ######### ### # ### # # # ##### # ### # # ### #
 # #     # #   #         #   # #     #   # #     #     #     # #
 # ##### # # ##### ##### ### # ######### # ### ############### #
 # #     # # #   # #   # #   # # #   #   # #   #   #       #   #
 # # ####### # # ### # # # ### # # # # ### # ### # ### ### # ###
 #   #       # #     #   # #   #   # #   # # #   #   #   # # # #
 ############# ########### # ####### ### # # ####### # # # # # #
     #         #     #     #       # #   # #     #   # # # # # #
 ##### ############# # ########### # # # # ##### # ### # ### # #
 #     #           # #   #     # # #   # # #     # #   #   #   #
 # ####### ####### # ### # # # # # ##### # # ### # ### ### #####
   #   #   #     # # #   # # # # #     # # #   # #   #   # #   #
#### ### ##### # # # # ##### # # ##### ### # # ##### ### # ### #
         #     #             #             # #           #     #
################################################################
