################################################################
# #   #                 #   #         #     #   #     #       # 
# # # # # # ######### # # # # # # # # # ### # # ### # ####### # 
#   # # # #     #     # # #   # # # # # #     #     # #   #   # 
##### # # ####### ##### # ##### # # # # # ########### # # # ### 
#   #   #     #   #   # #     # # # # # # #   #   #   # #   #   
# # ########### ##### # ##### # ### # # ### # ### # ### ##### ##
# #       #   #   #   # #   # #   # #   #   #   # # #   #   # # 
# ####### # # ### # ### # # ##### # ### # ##### # # # ##### # # 
#G      # # #     #   #   #     # #   # # #   # # # #           
####### ### ####### ########### # ### ### ### # # # ### ##### ##
#     #   # #       #           #   #   # #   # #       #   #   
# ### ### # # ####### ########### # ### # # ### ####### # # ### 
# #   # #   #   #   # #           #   # #   #           # # #   
### ### ####### ### # ############### # ########### ### # # ####
#   # #     # #   # #     # #         #     #     #   # # #     
# ### ##### # ### # ##### # # # ####### # ### ### # # ### ##### 
# #             #   #   # #   # #   #   #   #   #   # #   # #   
# ############# ### # # # ####### # # ##### ### # ##### ### # # 
# #           #   #   # #   #     # # #   #   # # #   # #   # # 
# # ######### ### # ####### # ##### # # # ##### # # # # # ### # 
#   #     #   #   # #     #   #   # # # # #   # # # # # #   # # 
##### ### # ### # # # ########### # ### # # # ### # # # ### # ##
#   # #   #   # #     #     #     #     # # # #   # # # #   #   
# # ### # ### ##### ### ### # # ######### # # # # # # # # ##### 
# #   # #   #     # #   # # # #     #   #   # # #   # # #     # 
# ### # ### ##### # # ### # # ####### # ##### ### ##### # ##### 
#   # # #       # # #   # #   #       #                 # #     
##### ### ##### # # ### # ####### ######### ##### # ##### # ####
#   #     #     #   #   #       #   # #     #     # #   # #     
# # ####### ####### # ### ##### ### # # ### # ##### ### # ##### 
# #       #   #   # # #   #   #     # # #   #     #       #   # 
# ####### ### # # # # # ### # ####### # # # ##### ##### ### # # 
# #     #   #   # # #   #   # #   #   # # #   #   #   # #   # # 
# # ### ### ##### # ##### ### # # # ### # ### # ### # ### ### ##
# # # # # #   # # # #     # #   #   #   # #   #     #   #   #   
# # # # # ### # # # # ##### ######### ### ############# # ##### 
#   #   #     #   # #                 #   #   #     # #   #   # 
##### ######### ### ################### # # # # ### # ##### # # 
# #   #           #                     # # # #   #       # #   
# # ### # ####### ### # ##### # # ##### ### # ### ######### ####
#   #   #   #         # # #   # #     #     #     #   #     #   
# ########### ##### # # # # ### ##### ############# # # ##### # 
# #   #     # #   # # # # # #   #     #             # # #     # 
# # # # ### ### # ### # # # # ### ######### ########### # ######
# # # # #   #   #   # #   # #   #         #     #     # # #     
# # # # # ### ##### # ##### # # ######### ##### # ### # # # ### 
#   #   #     # #   # #   # # # #       # #   # # # # # #   # # 
############### # ##### # # ### # ##### # # ### # # # # ##### # 
#         #   #   #     # #   # #     # # #     # # # #         
# ### ##### # # ### ##### ### # ##### # # # ##### # # ##########
#   #       # #   # #     #   # #     # # #   #   # #   #   #   
### ############# # # ##### ### # ##### # ### # ### ### # # # # 
# # #   #   #   # # #       #   # #     # #   # #     # # # # # 
# # # ### ### # # # ######### ### ####### # ### # ### # # # ### 
#   # #   #   #   # # #     #   #         #     #   # # # #   # 
# ### # ### ####### # # ### # # ##################### # # ### # 
# # # #  S# #       # # # # # #     #                 # #   #   
# # # # ### # ### ### # # # # ##### # # ####### # ##### ### ### 
# #   # #   #   # #   #   #   #   # # # #     # #       # #   # 
# ### # # ### ### # ######### ### # # # # ### # ######### ##### 
#   #   # #   #   #     #   #     # # #     # #     #     #   # 
### ### # ##### ##### # # ### ##### # ####### # ##### ### # # # 
#               #     #           #   #       #         #   #   
