################################################################
         #       #         # #             #       #       #   #
 ######### ##### # ##### # # # ### # ####### ##### # # ### # # #
     #   # #   #   #   # #   # # # # #       #   #   #   #   # #
## ### # # ### ##### # # ### # # # ### ######### ####### #######
   #   # # #   #   # # #   # # # #   #   #     # #     #       #
 ### ### # # # ### # # ### # # # ### ### ### # # ##### ####### #
     #   # # #     # # #   # # #   #   #   # #               # #
 ##### ### # ##### ### # ##### # # ### ### # ####### ####### # #
 #   #   #   #   #   #   #     # # # #   # # #     # #   #   # #
 # # ######### # ### ##### ##### # # # ### # # ### ### # ##### #
 # # #     # # #   # # #   #     # # #G    # #   #     #       #
 # ### ### # # ### # # # ### ##### # ####### ### ############# #
 # #   #   #   #   # # # #   #   # #       #   #   #           #
 # # ### ### ####### # # # ##### # # # ### # ##### # # ##### ###
   # #   #     #   #   #   #     # # #   # # #     # #     # # #
## # ######### # # ### ##### ##### ####### # # ########### # # #
       #     # # #     #         # #     #   #         # # # # #
 ##### # ### # # ####### ####### # # ### ### ######### # # # # #
 #   #   # #   # #             # #   # # #         #   # # #   #
## # ##### # ### # ########### # ##### # # ####### # ### # #####
   # #         # # #     #   # #     #   #     #   #   #   #   #
 ### ####### # # # # ### # ### # ### # ####### # ##### # ### # #
   # #       # # # # #   #   # #   # #   #   # #     # # #   # #
## ### ##### ### # # ####### # ### # ### # # # ##### # ### ### #
 # #   #     #   # # #     #   #   #   # # #   #     # #   #   #
 # # ### ##### ### # # ### ############# # ##### ##### # ### ###
 #   # # # #   # #   #   #     #       #   #     #S  #     #   #
 ##### # # # ### # ##### ##### # ##### ##### ####### ######### #
   #   # # #   #       #   # #   #   #     # #       #   #   # #
## # # # # ### ### ####### # ##### # ##### # ### ##### ### # # #
   # # #     #   #       #   #   # # #     #   #       #   #   #
 ### ####### ### ####### ##### # ### ### # ### ####### # #######
 #       #   # # #       #   # #     #   #     #   #   # #     #
 # ##### # ### # # ##### # # # ####### # ####### # # ### # ### #
 # #     # #   #   #   #   # #         #         #     #   #   #
 ### ### # ### ##### ####### ########### ### # ############# ###
     #   #   #   #   #       #   #         # #   #         #   #
######## ### ### # ### ####### # # # ####### ### # ####### ### #
       #             #   #   # #   #   #   # #   #   #   #     #
 ##### ############# ### ### ######### # # # # # ### ### #######
 #   #               # #   #       #   # #   # #   #     # #   #
 # # ############### # ### ####### # # # ##### ### ####### # # #
   #           #   # #   #     #     # #     # # #           # #
############## # ### # # ##### ########### # # # ### # ####### #
   #           #       #     #           # # # #   # # #     # #
 # # ##### ################# ########### ### # ### # ### ### # #
 #   #     #     #   #             #   #     # #   # #   # #   #
 ### ####### ### # # # ##### # ### ### ####### # ### # ### ### #
   # #     # # # # # # # #   #   #   #         # #   #   #   # #
## # # ### # # # ### # # # ##### ### # ######### ### ### ### # #
   # #   #   # #     # # # #   # #   #   #         # # #   # # #
 ####### ##### ####### # # # # # # ##### ######### # # ### # # #
 #     #     # #   #   # #   # # #     # #     # #   #     # # #
 # ### ##### # ### # ### ####### ##### # # ### # ########### # #
 # #       # # #   #   #   #   #     # # # #   #     #     #   #
 # # # ##### # # ##### # # # # ##### # # # # ### ### # ####### #
   # # #     # # #   # # # # #       #   # #   #   # #   #   # #
 ### ### ##### # # ### # # # ########### # ### ##### ### # # # #
 # # #   #   # # # #   # # #   #       # # # # #     # # # # # #
 # # # ### # # # # # ### # ### # ##### ### # # # ##### # # # # #
 # #   #   #   # #   #   #   #   # #   #   # # #     #   # # # #
 # ##### ####### ##### ##### ##### # ### ### # ##### ### # ### #
                       #           #       #   #               #
