################################################################
################################################################
#   #   #   #   #               #   # #           #   #     #   
### # ### # # # # ##### ######### # # # ######### # ### ### # # 
#   #     # # #   #   # #   # #   #   # #       # #   # #   # # 
# ######### ####### # # ### # # ####### # ##### # # # # ####### 
# # #   # #         # #   # # #   #     #     #     # #       # 
# # # # # ########### ### # # ### ### ####### ############### # 
# #   #S#   #     #   #   #     #   # # #     #   #           # 
# # ##### # # ### # ### ####### ### # # # ##### # # ########### 
# # #     # #   # #   #       #   #   # #   #   #   #   #       
# # # ##### ### ##### ####### # # ##### ### # ####### # # ### # 
#G#   #         #   # #     #   #     #   # #         # # #   # 
# # ### # ####### ### # ### ### ####### # # # ####### # # # ### 
# # #   # #     # #   #   # #   #       #   # #     # #   #   # 
# ### ### # ### # # ####### ### # ####### ### # ### ######### ##
#   # #   # # # # # #     #   # # #     #   # # # #       # #   
### ### ### # # # # ### # ### # # # ### ##### # # ####### # ### 
# #     #   # #   # #   # #   # # #   #     # # #       # #     
# ##### # ### ##### # ### # ### # ### ##### # # # ####### ######
#           #     #   # # #   # # # #     #   # # #     #       
# ######### # # # ##### # ### # # # ##### ##### # # ### ####### 
# #       # # # #   #   #   # #           #     #     #       # 
# # ##### # ### ### ### ### # # ### ##### # ######### ######### 
# # #     #     #       # # # # #   #     # #     #   #   #     
# # # ################# # # # # # ### ### # # ### # ### # # ####
# # # #             #     # #   #   #   # #   # # # #   # #     
### # # ########### ##### # ############# ##### # # # ### ##### 
#   # # #   #       #               #           # #   #     #   
# ##### # # # ####### ############# # ##### ##### # ### ##### ##
#       # # #     #   #   #   #     # #   #       # # #     # # 
######### ####### # # # ### # ##### # # # # ##### # # # ### # # 
#     # #       # # #   #   # #   #   # # # #   #   # # # # # # 
# ### # # ### ### # ##### ### # # ##### # # # # ##### # # # # # 
#   #   # # #     # #     # #   # #   # # # # #     # #   # #   
# ####### # ######### ##### ##### # # # # # # ##### # ##### ####
#   #     # #       # #       #   # #   # # #     # #       #   
# # # ##### # ##### # # ##### # ### ##### # ### ### ####### ### 
# #   #   # # #     # # #   # #     # #   #   # #   #   #       
# ##### # # # ####### # # # # ####### # ##### # # ### # # ######
# #     # # #     #       # #   #   #   #     # # #   #   #     
# ### ### # ##### # ########### # # ##### # ### # ### ######### 
# #   #   #   # # #   #       #   # #   # # #   # #   #     #   
# # ### ##### # # # # # ##### ##### ### ### # ### # ### ### # ##
#   #   #           # #     #     #       # # # # #     # #   # 
##### ### ######### # ##### ##### # ##### # # # # # ##### ##### 
#                 # #       #   # # #   # # # #   #       #     
####### ##### ### ####### ##### # # # # # # # ##### ####### ### 
#     #     #   #       #   #   # # # # #   # #   #           # 
# ### # ### # # ####### # ### ### ### # ##### # # ### ### ### ##
# #   # # # # #       # #     # #   # #       # #   #   # # #   
# # ### # # # # ##### # ### ### ### # ######### ####### # # ### 
# #   # #   # # #     #   #       #   #       #         # #   # 
# ##### ##### # ##### ### # ### ####### ##### ########### ### # 
# #     #     #   #   #   #   # #     # #     #             #   
# # ####### # ### # ### ##### ### ### # # ### # # ### ##### ####
#   #       # # # #   # #     #   # # # #   # # # #   #     #   
##### # ##### # # ### # ####### ### # ##### # # # ### # ### # # 
#     #     # # #   # #         #   #   #   # # #   # #   # # # 
# ######### # # ### ############# ##### # ### ### # # ### ### # 
# #       # #   # #     #   # #   #     #   #   # # # # #   # # 
# # ##### # ##### ##### ### # # ### ####### ### ### # # ### # # 
#   #     #           #       #     #       #       #     #   # 
################################################################
