################################################################
#     #             #     #   #   #   #       #     #     #   # 
# ##### ### ### ### # # ### # ### # # # # ### # ### ##### # # # 
# #   # # # #   #   # #   # #     # # # # # # #   #         #   
# # # # # # ### ##### ### # ####### # ### # # ########### ######
#   # # # #   # #     #   #       # # #   #   #         #       
##### # # ### ### ##### ######### # # # ### ### ####### ####### 
#     # #   #     #   #   #     #   # # # #     # #   #     #   
##### # ### ####### # # # # ######### # # ####### # # ##### # # 
#   #       #       # # # # #   #   #   #     # # # #     # # # 
# # ####### # ####### ### # # # # # ######### # # # ##### # ### 
# #   #   # #   #   #   # # # #   #   # #   # #     #     #   # 
# ### # ### ### # # ### # # # ####### # # # # # ####### ##### # 
# #   #       #   # #   #   # #       # # #   #   #   # # #   # 
# # ####### # ##### # # ##### # # ##### # ######### # # # # ### 
# #       # # #     # # #     # # #     # #         # # # # #   
# ####### ### # ##### ### ##### ### ##### ########### # # # # # 
# #   #   #   # #   #   # #   #G    #     #   #   #   #   # # # 
# # # # ### ### # ##### # # # ####### ##### # # # # ### ### ### 
# # #   #   #   #     #   # #       #   #   # # #   #     #     
# # ####### # ####### ####### # ### ### ##### # ##### ### ##### 
# #   #     # #         #     # #     #               #     #   
# ### ### # # ### ##### # # ### # ### ##### ####### ### ##### ##
#   #     # # #   # #   # # #   # #       # #     #   #     # # 
### ####### # # ### # ##### ##### # # ### # # ### ### ##### # # 
#   # #   # #   #   #       #     # #   #   #   #   # #   # #   
##### # ### ##### ####### ### ############# ### ### # # ### ### 
#   #       #   #         #   #     #     #   #   # # #       # 
# # ##### ### ####### ##### ####### # ### # # # ### # ####### # 
# # #   #   #       # #     #       # # # # # # #   #   #   # # 
# ### # ### ##### # # # ##### ####### # # ### # # # ##### # ### 
#   # #   #       #   # #     #   #   # #   #   # # #     #   # 
### # ### # ########### # ####### # ### ### # ### ### ####### # 
# #   #   # #     #   #           # #   #   #   #     #     # # 
# ##### ##### ### # # ############# # # # ##### ####### ##### # 
# # #   #   #   #   #         #     # #   #   # #   #   #     # 
# # # ### # ### ############# # ##### ##### # # # # # # # ##### 
# # #     #     #       #     #   # # #     # #   # # # #       
# # ############# ##### # ####### # # ### ### ##### # # ########
#     #         #     # #   #   # # #     # #     # # #     #   
##### # ####### ##### # ### # # # # ####### ##### # # ##### # # 
#   # # # #   #       # #   # # #   #           # # #   # # # # 
# # # # # # # ### ##### # ### # ##### ### ####### # ### # # ### 
# # #   #   #     #   #   #   #     # # #         #   # # #     
# # ####### # ##### # ### # ####### # # ############# # # ######
# # #   #   # #     #   #         # # # #         #   #         
### # # # # # # ####### # ####### ### # # ### ##### ##### ##### 
#   # #   # # # # #       #     #     # # #   #     #     #   # 
# ### ##### # # # # ####### ### # ##### # ##### ####### ### # # 
#     # #   # # # #   #   #   # #   #   # #   # #       #   # # 
####### # ### # # ### # # ##### # # # ### # # # ######### ### # 
#     #   #   #   #     #       # #   #   # # # #       #   # # 
##### ### # ######### # ######### ##### ### # # # ##### ### # # 
#   #     #   #     # # # #       #     #   #   # #   # # # #   
# # ### ####### ### # # # # # # ### # # # ####### # ### # # ### 
# #   # #   #S  #     # #   # #     # # #     #   # #   #   # # 
# ### # # # # ######### ############# ####### # ### # ####### # 
#   # #   # # #       #             #       # #     #       #   
### ####### # # ##### ############# # ### # # ############# ### 
# #   #     # # #   #   #   # #   # # #   # # #   #   #   # #   
# ### # ##### # # # # ### # # # # # ### ### # # # ### # ### # # 
# # # #   #   # # # #   # # # # # #   # #   #   #   #   #   # # 
# # # ### # ### # ##### # # # # ##### # ########### # ### ##### 
#         #           #   #   #       #                         
