################################################################
################################################################
# #        S#     #                 #                           
# # # ####### ### ### ########### # ### # # # ####### # ####### 
#   # #       # #   # #         # #     # # # #     # # #       
# ### # ####### ### # # ####### # ######### # # ##### # ### ####
# #   #   #       # # # #   # # # #       # #   #     #   # #   
# # ##### # ### ### # # # # # # ### ##### ####### ####### # ### 
# #     #   #   #   # # # #   #   #     #         #       # #   
# ##### ##### ### ### # ### ##### ##### ########### ####### # ##
#     # #   # #   #   #   # #   #     #   #   #   # # #         
# ### # # # # # # ####### # # ##### # ### # # # # # # # ####### 
# # # # # # # # # #       # #     # #   #   # # # # #   #   #   
# # # ### ### # ### ####### ##### ##### # ### # ### # ### # ####
#   #     #   #   #   #         #     # # # #   #   #   # #     
### ####### ##### ### ### ##### ##### # # # ##### ##### # ##### 
#   # #   # #   #   #   #   #     # #   #   #   # #   # # # #   
# ### # # # # ##### ### # ### ### # ######### # ### # # # # # ##
#   # # # # #     #     # #   # #     #       #   # # # #   #   
### # # ### ##### ######### ### ##### # ######### ### # ####### 
# #   #   #     #         # # #   #   # # #       #         #   
# # ##### ##### ####### # # # # ### ### # # ####### ######### ##
#   #   #     # #     # # # #     # #   # # #           #     # 
# ### ##### # # # ### ### # ##### # # ### # ##### ##### # ##### 
#   #       #   #   # #   #     #   #   # #     #     #   #     
### ####### ######### # ####### # ##### # ##### ##### ##### ####
# # #             #   #       # # #     #     # #   #   #   #   
# # ### # # ##### # ######### # # # ##### ### # # # ### # # # # 
# #     # # #   # #   #   #   # #   # #   #   # # # #   # # # # 
# ### ### # ### # ### # # # ######### # # ### # # # # ### # # # 
# #   #   #     #     # # # #     #   # #   # # # # #     #   # 
# ### # # ############# # # # ### # ### ### ### # ### ##########
# #   # #   #         # # #   #   #     # #   # #     #         
# # ### # # # ####### ### ##### ##### ### ### # # ##### ####### 
#   #   # # #   #     #   #     #   #     # #         #   #     
# ### ##### ##### ##### ### ##### # ##### # ####### ##### ######
# #   #   #   #   #         #     #     #   #     # #   #     # 
### ##### ### # ### ################### ### # ### ### # ##### # 
#   #     #   # # # #           #     #     # #   #   #       # 
# ### ##### ### # # ####### # # ##### # ##### # ### ########### 
# #       #   # #         # # #     #   #   # # #   #       #   
# # ##### ### # ######### ### ##### # ### # # # # ### ##### # # 
# # #   #     #       # #   # # #   #   # #   #   # #   #   # # 
# ### # ############# # ### # # # ### ### ######### ### # ### # 
#     #           #   # #   #   #     #   #   #   # #   #   # # 
# ############### # ### # ######### ### ##### # # # # ##### ### 
#   # #       #   # #   # #         #   #     # # # # # #   #   
# # # # ##### # ### ### # ### ####### ### ##### # # # # # ### ##
# # #   # #   #     #   #   # # #   #   # #   # # # # #  G#     
# # ##### # ######### ##### # # # # ### # # ### # # # ##### ### 
# #   #   # # #       #     #   # #     # #     # #         #   
# # ### # # # # ##### # ##### ### ####### ####### # ##### ### # 
# #     #         # # # #         # #           # # #   # # # # 
# # ######### ### # # # # # # ##### # ##### ### # # # # # # # ##
# # #     # #   #   #   # # #     #   #   # #   # #   # #   #   
# ### ### # ### # ####### # ##### # ### # # ##### # ### ####### 
#     # # #     #       # #     # # #   # #     # #   #     # # 
# ##### # ########### ### ##### # # # ### ### # # ### ##### # # 
#   #   #   # #       #   #   # #   #   #   # # # #   #     # # 
# ### ### # # # # ##### ##### # ####### ### ### # # ######### # 
# #   #   # # # #       #     #     #     #   #   #     #   # # 
# # ####### # # ######### ######### # ####### # ### ### # # # # 
# #         #                     #   #       #     #   # #     
################################################################
