################################################################
################################################################
#     #   #       #       #   # #       #   #         #     #   
##### # # # # # ### ##### ### # # ##### # # # ####### # ### # # 
#     # #   # #   # #   #   #   # #     # #   #   #   # #   # # 
# ##### # ### # # # # # ### ### # # ##### ##### ### ### ### ### 
#       # #   # #   # #   #   #   #   #   #   #   # #     #   # 
########### ### ##### ####### # ####### ### ### # # # ### ### # 
#         # #       #         #         #       #   # #   #   # 
# ####### # # # ### ##################### ########### # ### ### 
#   #   #   # #   #         #   #       #     # #   # #   #   # 
### # # ##### ##### # ####### # ####### ##### # # # ######### # 
# #   #     # #   # #       # #     # # #   # #   #         # # 
# ######### ### # # ####### # ##### # # # # # ############# # # 
# #   #   #   # # # #     #   #   # #     #           #   # # # 
# # # # ##### ### # # # ####### # # ######### ####### # # # # # 
# # #   #   #     #   #   # #   # #   #     # #     #   #   #   
# # ##### # ####### ##### # # ####### # ### # # ### ####### ### 
# #       #     #     # # #     #   #   #   # #   #       #   # 
# ############# # # # # # ##### # ####### ### ########### # ### 
#   #       #   # # #   #   #   #         #   #     #   # #   # 
### # ### ### ### # ####### ### ########### ### ### # # # ### # 
#   # #   #   #   #       #   #         #   #   # #   # # #   # 
# ### # ### ### ######### ### # ##### ### ### ### ##### # # ### 
#     #   # # # #       # #   #     # #   # #   #     #   # #   
######### # # # ####### # # ####### # # ### ### ##### ##### # ##
#       # #   # #       # # #     # # #     #   #             # 
# ##### # ### # # ####### # ##### # # ##### # ### ##### ####### 
# #   # #   # #   #       #     #   #     # # #   #   #         
# # # # # # # ##### ########### # ######### # # ##### ##########
#   # #   #               # #   #   #   #   # # #   #     #     
# ######### # ########### # # ##### # # # ### # # # ##### # ### 
# #       # # #           # # #   # # #   #   #   #       # #   
# # ##### ### # ######### # # ### # # ##### ############# # # ##
# # #     #   # #   #     # #   #   # #   #   #         #   # # 
# # ####### ### # # ####### ### ### # # # ### # ####### ##### # 
# #         # #   #         # #   #   # #   #   # #   #     #   
# ########### ############### ### # ### ######### # ####### # ##
#               #           # #   #     # #       #     #   # # 
# ##### ##### ### ######### # # ####### # # ########### # ### # 
#     #     #       #     #   #       #   # #   #     # # #     
# ### ##### # ####### ### ########### # ### # # # ### # # ##### 
#   #     # # #   #   #   #     #     # #S  # # #   #   #     # 
### ##### # # # # # ### ### ### # ##### # ##### ### ######### ##
#   #     # # # #   # #       # # #   # #     # #   #       #   
##### ##### # # ##### ######### # # # # ##### # # ### # # ##### 
#     #   # # #       #   #     # # #                 # # #     
# ##### # # # ####### ### # ##### ######### ####### ### ### ####
#     # # # #       #     # #   #         #   #   #   # #   #   
##### ### # ### ######### ### # # ####### # ### # ### # # ##### 
# #   #   #   # #     # #     # # #   #   # #   # #   # #       
# # ### ### # # # ### # ####### # # # # ##### ### # ### ####### 
# #   # #   # # # #       # #   #   # # # #   #   #   #   #   # 
# ### # ### # ### ####### # # ######### # # ### ##### # ### # # 
#   #   #   #   # #     #   #           #   # # # #   # #   # # 
### ##### ##### # # ####### ################# # # # ### # ### # 
#       # #     #   #     # #         #       # # # # # # # # # 
# ##### # # ######### ### # # ##### # # ####### # # # # # # # # 
#     # # #   #       # #   # #   # #   #     # #     # # # # # 
####### # ### # ####### ##### # # # ##### ### # ##### ### # # # 
# #     #   #   #     #       # # # #   # #   #     #  G  # #   
# # ####### ##### ##### ##### # # ### # # # ####### # ##### ####
#                           #   #     #   #                     
################################################################
