################################################################
#     #   #   #                             #   #       #       
##### # ### # ########### ########### ##### ### # ##### # ### ##
#   # #   # #   #       # #     #   # #   #           #     #   
# # # ### # ### # ##### ### ### # # ### # # ##### ############# 
# # #   #   # # # #   # #   #   # # #   #   #   #       # #     
### ### ##### # # # ### # ### ### # # ####### # ####### # # ### 
#   #   #   # # # #   # # # #     # # #       #       # # # #   
# ##### # ### # # ### # # # ####### # # ############# # # # ####
# #   # # #   #   #   # # # #     #   #   #   #       #   #     
# # # # # # ####### ### # # # ### # ### ### # # ############### 
#   # #   #   # #   # # #   #   #   #   #   #   #     #     #   
##### # ##### # # ### # ####### ##### ### ########### # ### # # 
#     # #   # # #     #   #         #   # #   #     # #   # # # 
# ##### # ### # ### ##### ####### # ### ### # ##### # ### # # # 
#     # # #   # #   #   #       # #   #  G  #   #     # # # # # 
##### # # # ### # ### ######### # ### ######### ##### # # ### # 
# #   #     #               #   # # #   #     #   # #   #   # # 
# # ####### # ########### # # ### # # ### ### ### # # ##### # ##
#   #     # # #     #   # # #       #   # #   #   # # #     #   
# ##### # # # # ### # # ### ### ####### ### ### ### # # ####### 
# #     # #   #   #   #   #     #     # #     # # # # #   #   # 
# # ##### ####### # ##### ##### # ### # # ##### # # # ### # # # 
# # #   #         # #   #   #   #   # #   #     #       #   #   
# # # # ########### # # ### # # ### # ##### ##### ##### ####### 
#   # #   #   #   # # #   # # #   # # #     #   #   #         # 
##### ### # # # ### # ### # # # # # # # ##### # ### # ### ### # 
#   #   # # #       # #   #   # # # #   #     #     #   # # #   
# # ### ### ######### ### ##### # # ##### ### ######### # # ### 
# # # #   #   #     #   # #   # # #     # # #   #   #   # #     
# # # ### ### # ### ### # # # # # ##### # # ##### # ##### # # # 
# #   # #S#   # # #   # #   #   #   # # #   #     # #     # # # 
# ### # # # # # # ### # ######### # # # ##### ##### # ####### # 
# #   # # # # #   # #   # #       # # # #     #   # #       # # 
# # ### # # # ##### ##### # ####### # # # ####### # # ##### ### 
# #         #             # #       # # #     #   # #     #   # 
# ############### ######### ####### # # ##### # ### ### ##### # 
#       #       # #   #   # #     # # #   # # #   #   # #     # 
####### # ##### # # # # # ### ### # # ### # # ### ### ### ##### 
#       # # #   #   # # # #   #   #     # # #     # #   # #     
# ##### # # # ##### ### # # ######### ### # ####### ### # # # # 
# #   # #   #     # #   # #     #   # #   #       #   #   # # # 
# ### # ######### ### ### ##### ### # # ####### # # ####### # # 
#   #         #   #   # #   #         #     #   # #     #   # # 
### ### # ##### ### ### ### ####### ####### # ### ##### ##### # 
#   #   #     #   #   #   #       #     #   # #       #     # # 
##### ####### ### ### # ######### # ### # ##### # ### ##### # # 
#   #   #   #   # #   #           #   #   #   # # # #   # #   # 
# # # ### # # # # ##### ##### ##### ##### # # # # # ### # ##### 
# # # #   #   # #   # # #   #       #   # # # # # # # # #       
# # # # ########### # # # # # # ##### # ### # ### # # # ####### 
# # # #       #   # #   # # # #       #   # # #   # #           
# # ##### ### # ### ### # # ### ######### # # # ### ########### 
# #     # #   # #   #   # #   #     #   # # # #   #           # 
# ##### ### ### # ### # # ### ### # # ### # # ### ########### # 
# #   #   #     #     # #   #   # #   #   # #   #         #   # 
# ### ### ############# ### ### # ##### # # ### # ##### ### ####
#     # # #     #     #   # # # #     # # # # # #   # # #   #   
####### # # ### # ### # # # # # ####### ### # # # # # # # ### # 
# #   # # # #   #   #   # # #         #   # # # # #   # #     # 
# # ### # # # ##### ##### # ######### # # # # # ####### ####### 
#   #   # # #   #   #     #       #   # #   # #     #   #       
# ### ### # ### # ### ### ######### ### ##### ##### # ### ######
#           #     #     #           #       #       #           
