################################################################
#                       # #     #   #                           
### # # ### ########### # # ### # # # ####### ####### # ### ### 
#   # #   # #     #   # # #   #   #   # #   #       # #   #   # 
# ### ### # ### # # ### # ### ######### # ######### ##### ##### 
#   #   # # #   # # #   #             #   #   #   # #   # #   # 
##### ### # # ### # # ##### ######### # ### # # ### # # # # # ##
#   # #G  # #   #         # #   #   # #     # #   #   # # # #   
# # ### ### # ##### ##### ### # # # # ### ### ### ##### ### ### 
# #     #   # #   # #   #     #   # #       #   #   #   #   #   
# ##### # ##### # ### # ########### ##### ######### # ### ### ##
#   #   #     # #   # #         #   #   #         #   #   # #   
# # # # ##### # ### # ######### # ### # # ####### ##### ### ### 
# # # # #   #   #   # #     #   # #   # #     # #             # 
### # # # # ##### ### # ### # ### ##### ##### # ############### 
#   # # # # #     #   # # #   # #   #   #       #             # 
# ### # # # # ### # ### # ##### ### # ### ####### ########### # 
# #   #   # # #   #   # #         # #   #     #   #             
# ######### # ######### # ######### ### ### ### ### ########### 
#     # #   #           # #       #   # # # #   #   #         # 
##### # # ############### # ##### ### # # # # ####### ####### ##
#   # # # #           #         #           # #     # #     #   
# # # # # # ######### # ####### ####### # # # # ### # # ### ### 
# #   #   # #   #     # #     #   #   # # # # # # # # # # # #   
# ####### # # ### # ##### ### ### # # ### ### # # # # # # # # ##
#     #   # #   # # #   # #   #   # #   #   # # # #   # #   # # 
# ### ##### ### # ### # # # ### ### ### ### # # # ####### ### # 
#   #S    #   # #     # # # #       # # #   #       #     # # # 
# ####### ### # ####### # # # ##### # # # ######### # ##### # # 
# #     #   # #       # # # # #   #   # #         # # #     #   
# # ### ##### ####### # ### # # # ##### ######### # # # ########
#   # #   #   #   #   #     # # # #   #   #   # # #   #         
# ### ### # ### # ### ####### # # # # ### # # # # # ### ####### 
#     #   #     #       #       # # #   # # #   # #       #     
# # ### ############### ### ##### # ### # # ##### # ####### ### 
# #   #     #     #   #     #     #   #   #   #   # #   #   # # 
# ### ##### # ##### # ####### ####### ##### # # ### # ### ### # 
# #   #   # #       #   #           # #   # # # #   #     # # # 
# # ### # # ########### ### # ##### # ### # # # ########### # # 
# #     # #   #       #   # #   #   #   #   # #         #   #   
# ######### # # ######### ####### ### # # ############# # # ### 
#     #   # #       #     #       #   # #   #       #   # #     
##### # # # # ####### ##### ####### ### ### # ##### # ### ##### 
#   # # #   #   #   #       #     # #   #   #     # # #   # #   
# # # # ####### # # ######### ### ### ### # ####### # # ### # ##
# #   #     # # # #   #       #   #   # # #     #   # #     # # 
# ######### # # # ### ##### ### ### ### # ##### # ### ####### # 
# #     # # #   #   #       # #     #   #   #   # #   #   #   # 
# # ### # # ####### ######### ####### # ### # ### ### # # # ### 
# #   #   # #     # # #           #   # #   # # # #   # #   #   
# ### ##### # ### # # # ######### ### # # ### # # # ### ##### ##
#   # #   #   # # # #   #       #     # # # # # #   #         # 
# # # # # ##### # # # ##### ### ####### # # # # ####### ####### 
# # # # #   #   # # # #   #   # #       #   #   #               
# ### # ##### ### # ### # # # ### ############# ### # # ### ####
#     #     #     #     # # #     #     #     #   # # #   # #   
# ######### ######### ### # ####### ### # # ##### ### ### # # # 
#       #   #       # # # # #   #   # # # # #     #   #   #   # 
# # ##### ### ##### # # # # # # ### # # ### # ##### ### ####### 
# # #     # #     # # # # # # #     # #   # #       #   #   #   
# # # ##### ##### # # # # # # ####### ### # ######### ### # # ##
# # #   #   # #   # #   # #   #   #   #   #     #     #   # #   
# # ### ### # # ### ##### ##### # ### # ##### # # ##### ### ### 
# #           #   #       #     #             #   #       #     
