################################################################
                 # #     #   #     #   # #     #   #           #
#### ########### # # ### # # # ### ### # # ### # # # ######### #
   # #   #       #   #   # # #   # #     # #   # #   # #     # #
 # # ### # ####### ### ### # ##### # ##### # ### ##### # # # # #
 # #     #     # # #   #   #       # #     # #   #       # # # #
## ########### # # # ### ########### # ##### # ### ####### ### #
   #     #   # # # #   #     #   #   #   # # # #   #     #     #
 ### ### # ### # # ### ##### ### # # ### # # ### ### ###########
     #     #         #       #   # #   # #   #   #   #   #     #
###### ### # ####### ######### ### ### # # ### ### ### # ##### #
     #   #   #     # #     #   # #   # # # #         # #   #   #
 ### # # ##### ### # # ### # ### # # ### # # ####### # ### # ###
 #   # #   #     # #     #         # #   # #   #   #   # # #   #
 # ### ### # ##### # ############# # # ### # ### # # ### # # # #
 # # #   # # # #   # #           # # # #   #   # # #   # # # # #
 # # ### # # # # ### # ######### # # ### ### # # # ### # # # # #
 # #     # # # #   # # # #     # # #     #   #   #   # #   # # #
 # ##### ### # ### ### # # ### # # ####### # ####### # ##### # #
 # #   #   # #   #   # #   # #   #       # #   #   # #       # #
 ### # ### # # # ### # ##### ########### # ### # ### # # ##### #
 #   #   # #   #   # # #               # #   # #   # # #     # #
 # ##### # ####### # # ######### ##### # ### # ### # ##### # ###
 # #   # #     # # # #           #   # #     # # # #     # #   #
 # # # # ### # # # # ############# ### # ##### # # # ### # ### #
   # # #   # #   # #   #   #       #   #   #   # # # #   # #   #
#### ##### # ### # # ### # # ##### # ####### ### # ### ### # ###
   # #   # # #   # #     # # #   # # #       #   #   #   # #   #
 # # # # # ### # # ######### # # # # ######### ##### ### # ### #
 # #   #       #   #   #     # # # #   #           #     #   # #
 # ##### ######### ### # ####### # ### # ####### ######### ### #
 # #     #   #   #     #   #     #   # #   #     #       # #   #
## # ##### # # # ##### ### # # ##### # ### ##### # ##### ### # #
   # #     #   #     #   #   # #   #   #   #   # #   # #   # # #
 ##### ############# # # # ##### # ##### # # # ##### # ### # # #
     # #     #   #   # #   #   # # #     # # # #   #   # #   # #
#### # # ### # ### ####### # # # # ####### # ### # ##### ##### #
   #   # #   #               # # #   #   #   #   # #   # # #   #
 # ##### # ##### ######### ### # ### # # # ### ### ### # # # # #
 #     # #     # #       #   # # # # # # # #   # #   # # #   # #
 ### # # ##### # # ##### # # ### # # ### # # ### ### # # ##### #
 #   #   # #   # #   #   # #     # #   #   #     # # # #       #
 # ####### # ### ### # ### ####### ### # ######### # # ####### #
 # #     # # #     # # # # #         # # #   # #   # #     #   #
## # ### # # # ### # # # # # ######### # # # # # ### ### # # # #
   # #   # # # #   # #       #         # # # #     # #   #   # #
 ### ##### # ### # # ######### ######### # # ##### # # ####### #
   #     # #   # # #S        # #         # #     # # # #     # #
## # ### # ### # # ######### # ##### ### # ##### # # # # # # # #
   #   # # #   # #   #     # # #   # #   #   #   # #  G# # # # #
 ##### ### # ### ### # ##### # # # ### # ### # ### ####### # # #
   # #     # #     # # # #   # # # #   #   # # #       #   #   #
 # # # ### # ##### # # # # ### # ### ##### # ### ##### # ##### #
 # #   #   # #     #     # #   # #   #           #   # # #   # #
 # ##### # # # ####### ### # ### # ### ############# # # # # ###
 #   #   #     #     # #   #   #   #   # #         #     # #   #
 ### # ######### ### # # ### # ##### ### # ####### # ##### ### #
 # # #   #     # #   # #   # # #   #     # #     # # #     # # #
 # # ### # ### # # ####### # # # # ####### # ##### ### ##### # #
 # #   # #   #   #       # # #   #         #     # #   #   # # #
 # ### # ### ########### # ######### ########### # # ##### # # #
 # # # #   # #       #   #         #           # # # #     #   #
 # # # ##### # ##### ############# ### # ##### # # # # #########
     #       #     #               #   #     #   #             #
