################################################################
#     #       #                                 #       #   #   
# ### # ##### ####### # ##### ############# ### # ##### # # ### 
# #   # #   # #       # #   #             #   # #   #   # #   # 
### ### # ### # # ####### # # ### ####### ### ##### # ### ### # 
#   # # #   #   # #     # # #   #       #   #       # #   # # # 
# ### # ### ##### # ### # # # # ##### ##### ######### # ### # # 
#   # #   # #   # #   #   #   # #   # #     #   #   # #   # # # 
### # ### # # # # ### ####### ### # # # ####### # ### ### # # # 
#       # #   #     # #     #   # # # #   #   #   #   #   #   # 
# ####### ######### # # ### # # # # # ### # # # ### ####### ### 
# #   #   #         # # #   # # # # # # # # #   #   #   #   #   
# # # # ######### # # # # ### ### # # # # # ##### # ### # ##### 
#   # # #     #   # # # #       # # #   # # #     # #   # #     
# ##### ##### # # ### # ### ### # # ##### # # ##### # ### ##### 
#     #     # # # #   #   #   #   # #     # #   #   # # #       
##### ##### # # ### ##### ### ##### # ### # ### ##### # ####### 
#     #   #   #   #   #   # # #   # #   # # # #       # # #   # 
# ##### # ##### # ##### ### # # # # ### ### # ######### # # # # 
#   # # # #   # #G# #   # #   # # #   #   #   #       #     #   
### # # # # # # # # # ### ##### ##### # # ### # ##### ##### ####
# #   # # # # # #   #   #     #     # # #   # # #     #   #   # 
# ### # # # # # ####### ### ####### # # ### # # # ##### # ### # 
#   # # #   # #   #   #   # #     #   #   #   # # #     #   #   
### # # ####### # # ##### # # ######### # ####### # ####### ### 
#           #   # # #     # # #   #   # #       # #   #   # #   
########### # ### # # ##### # # # # # # ####### # ### ### # ### 
#     #   #   #     # #     #   # # #   #     #   # #     #   # 
# ### # # # ######### # ######### # ### # # ####### ######### # 
# # # # # # #   #   # # #       #   #     #         #   #     # 
# # # # # ### # # # # # # ##### ############# ### # # # # ##### 
# #     #   # #   # # # #     #               # # #   #   #     
# ######### # ##### # # ##### ### # ########### # # ######### # 
#   #     #   #   #   # #   # #   #         # # # #   #       # 
### ##### ####### ##### # ### # # ######### # # # # # ######### 
# #   #   #     # # #   #   # # #       #   #     # #   #     # 
# ### # ####### # # # ##### # ##### ### # ######### ### # # ### 
#   #S  #           # #   # #   #   # # #     #   #   # # #     
### ##### ########### # ### ### ##### # ##### # ### # # # ######
# # # #     #       # # #   # #     #   #   # #     # #   #     
# # # # ### # ##### # # # ### ##### ### # # # ##### # ##### ### 
# # # # # # #   # #   #         #   #   # #   #     #   #   #   
# # # # # # ### # ##### ####### # ### ### ####### ### # # # ### 
#     #   #   # #   # #   #   # # #   #   #       #   #   #   # 
# ### ### ##### ### # # # # # ### ### # ### ####### ##### ### ##
#   #       #           # # #   #   # # # #   #   #     #   #   
# # ######### ########### # ### # # # # # # ### # ##### ####### 
# #         #   #   #   # # # # # # # # #   #   #     #   #   # 
# ######### ### # # # # ### # # ### # # ##### ####### # # # # ##
#       #     # # # # #   #   #     # #   #   #     # # # # #   
# ##### ####### # ### ### ########### ### # ### ##### ### # ### 
# #   # #   #   #   # # #     #         #   #   #   # #   #   # 
# # # # # # # ##### # # ##### # ####### ##### # # # # # ####### 
# # # # # # #   # # # #   #   # #     #       # # #   #         
# # # ### # ### # # # # ### ### # ### # # # ##### ##### ########
#   #     # #   # #   #   #   # #   # # # #     #   # # #       
# ######### # ### ####### ### ##### # # # ##### ### # # # ### # 
#       # # #     #         #       # # # #       # # #   #   # 
####### # # ##### # ### ### ######### ### ### ##### # ##### ### 
#       #   # #   #   # #       #   #   #   # #   # #   #   # # 
# ########### # ##### ### ##### # # ### # # ### # # ### # ### # 
# #   #   #   #       #   # #   # #   # # # #   # #   # # # #   
# # # # # # # ####### # ### # ### ##### ### # ####### # # # ### 
#   #   #   #         #     #               #         #   #     
