################################################################
         #     #       #             #       #     # #   #   # #
 ####### # ##### ##### # # ######### ####### # ### # # # # # # #
       #     #   # #   # # #       # #     # #   # #   # # #   #
###### ####### ### # ### # # ##### # # ### # ### # # ##### ### #
       #     #   # #   # # # #     #   # # #   # #   #   # # # #
 ####### ### ### # ### ### # ########### # ### ##### # # # # # #
   #     # #     #   #     #   #     #     # # #     # # # # # #
 ### ##### ####### # ######### # ### # ##### # # ##### # # # # #
 #   #   #     #   #     #     #   # # #     # #   #   # # #   #
 # ### # ### ### ##### ### ######### # ##### # ### # ##### ### #
 # # # #   # #   #     #   #     #   #     # #     # #   #   # #
 # # # ### # # ######### ### # ### ####### # ##### # # # ### # #
 # #   #   # # #   #     #   #         #   #   #   #   # #   # #
 # ##### ### # # # # ##### ######### ### ### ### ####### # ### #
 #       #   # # # # # #   # #     # #   #   #   #       # #   #
 ######### ### # # # # # ### # ### ### ##### # ### ####### ### #
 #       #   # # # #   #     # # #   #   #       # #       #   #
 ### ### ### # # ##### ### ### # ### ### # ##### # ### ##### ###
   #   # #   # #           #   #   # # # # #     #     #       #
## ### # # ### ##### ##### # ##### # # # ### ### ######### ### #
 #   # #             #   # #  G    # # #     #             #   #
 ### ### ########### # # # ######### # ####### # # # # ##### ###
   #   # #           # #       #   #           # # # # #     # #
 # ### ### ##### ##### # ##### # ######### ##### # # # # ##### #
 #   #   #   #   #   # # #     #     #   # #     # # # #       #
 # ##### ### ##### # # # # ### ##### # # # # ####### # #########
 #     #   # #     #   # #   #     #   #   #       # #     #   #
 ##### ### ### ####### ########### ####### ####### # ##### # # #
 #   #   #     #   #   #             #         #   #   #   # # #
 # # ########### # ### # ########### # ### ### # ##### # ### # #
   #           # #     # # #       # #   #   # # #     #   # # #
############## # ##### # # # ##### # ### ### ### # ####### # # #
       #       #     # # # # #   #   #   # # #   # #       # # #
 ##### # ########### # # # # # # ####### # # # ### # ### ##### #
   # # # #         # # # # #   #   #   #   # # #   #   #       #
## # # # ####### # # # # # ####### # # ##### # # ##### #########
   #   #         #   # # #   #       #       # # #             #
 ##################### # ### # # ############# # ####### # # ###
 #         #           #     # # #   #   #   # #   #   # # #   #
 # ####### # # ############### # # # # # # # # ### # # # # ### #
 #   #     # # #       #       # # #   #   # #   #   # # # #   #
 ### ####### ### ##### # ######### ######### # ####### # # ### #
     #   #   #   #   # #   #     # #   #     # #     # # #   # #
 ##### # ### # ##### # ##### ### # # # # ##### # ### # # ### ###
   #   #     #     # # #     #   # # #   #     #   #   #   #S  #
## # ############# # # # ##### ### # ####### ##### ####### ### #
   # #         #   # #   #   # #   #         #   # #     # #   #
 ### # ####### # ### ### # ### ### ####### ### # # # ### # # ###
     #   #   # #   # #   #   #     #   #   #   # # #   #   # # #
#### ### # # # ### # # # ### ####### # ### # ### # # # ##### # #
   #   #   # #   # # # #   # # #   # # #   # # #   # # #   # # #
 # # # ##### ### # # ### # # # # ### # # ### # ##### # # ### # #
 #   #   #   # # # # #   # # # #     #   #   #       #   #   # #
#### ##### ### # # # # ##### # ####### ### ### ##### ##### ### #
   # #     #   # # #   #     #       # #   #   #     #   #   # #
 # ### ##### ### # ##### ##### ### # # # ##### # ### ### ### # #
 #     #   # # #   #     #     #   #   # #   # #   # #   # #   #
 ######### # # ### # ##### ##### # ##### ### # ### # # ### #####
     #   #         #     #   #   # #     #   #   # # #   #     #
 ### ### ##### # # ##### ##### ### # ##### ### # # ##### # ### #
   #   #       # #     #     #   # #     # #   # #   #   #   # #
## ### ##################### ### # ##### # # # ##### # ##### # #
     #                       #   #     #   # #     #         # #
