################################################################
#         #     #   #         #       #   #     #   #           
# ######### # ### # # ####### # ##### # # ##### # # ##### # ### 
#         # # #   # #       #     # # # # #   # # #       #   # 
### ##### # # # ##### ########### # # # # # # # # ############# 
# # #   #   #     #   #       #   # #   #   # # #         #   # 
# # # # ######### # ### ##### # # # ######### # ######### # # # 
#   # # #             #   # # # # #   #     #   #     #   # # # 
##### # # ######### ##### # # # ##### # ######### ### ##### # # 
#     # #   #     # #   # # # # #     #       #   # #   #   # # 
# ##### # ### ### # # ### # # # # ########### ### # ### # ### # 
# #     # #   # #   #   # #   #   #     # #   #   #   # # #   # 
# # ####### ### ### ### # # ### ### # # # # ### ### # # # ##### 
# #     #   # #     # #   #   #     # # # #     #   #   #     # 
# ##### # ### # ##### ####### ### ### # # ####### ########### # 
#   #   # # #   #           #   #   # #     #     # #       # # 
### ##### # # ### ######### ### ##### ####### ##### # ##### # # 
# #     # #       #       #   #     #    S    # #   #     #   # 
# ##### # # ####### ##### ### ##### ####### ### # ####### ##### 
# #       #     #   #   #   #     #       #       #       #     
# # # ####### # # ### ##### # # # ####### # # ##### ####### ####
# # # #     # # # # #       # # # #     # # #     # #   #   #   
# ### # ### # ### # ######### # ### ##### # # ### # # # # ##### 
#     # #   #       #       # #     #   # # # # #   # # #   #   
####### ########### # ##### # ##### # # # # # # ####### ### # # 
#     #         #   # #   # # #   # # #   # # #   #     #   # # 
# ### ######### # ### # # # ### # ### ##### # ### # ##### ##### 
# #         #     #   # # #     #     #     #     # #           
# ######### # ### # ### ################# ### ##### ########### 
# #       #     # # #           #     #   #       #       # #   
# # ##### ### # ### ### ####### # # # # ### ############# # # ##
# #     #   # #   #   #       # # # #   #     #     #     # #   
####### ### # ### ### ####### ### # ##### ### # ### # ##### ### 
#   #   #   #   #   #   #   #     #     # #   #   #   #       # 
# # ##### ### # ### ### ### ##### ##### # # ##### ##### ####### 
# #     #     #   #   #   #           # # #       #             
####### # ####### ### ### ########### # # ######### ### ########
#   #   #       #   #   #   #   #   # # #     #       #         
# # # ### ##### ### ####### # # # # ### # ##### # # # ######### 
# # #   # #   # #   #     # # #   #     #     # # # #         # 
# # ### # # ### # ### # ### # ############### # # # ######### # 
# #   #   #     #   # # #   # #       # #   #   # #     #     # 
# ### # ############# # # ### # ##### # # # ##### ##### # ##### 
#   # #           #   #   #   # #     #   # #   # #   # # #     
### # # ######### # ####### # # # ######### # # # # ### # # ### 
# # #       #   # # #   #   # # # #       # # #   #     # # #   
# # ### ### # ### # # # ##### # # # ##### # # ########### ### # 
# #   # # # # #   # # #     #   # # #     #   #           #   # 
# ##### # # # # ### # ##### ##### # # ######### # ######### ### 
#   #   #   # #   # # #   #       # #     #   # # # #   #   #   
### # ####### ### # # ### ######### ##### # # ### # # # # # # # 
#   #     #     #   # #   #   #     #   # # # #   #   # # # # # 
# ####### ### ####### # ##### # ##### # ### # # ####### # # ### 
#   #   #  G#       # # #   #       # #     # #     #   # #   # 
### # ##### # ##### # # # # ### ### # ############# # ####### # 
#   # #     # #   # #   # #       # #   #           # #   #   # 
# # # # ##### ### # ########### # ##### ##### ####### # # # ### 
# # #   #   # #   #   #       # #     #       #     #   #   #   
### ##### # # # # ### # ##### # ############### ############# # 
#   # #   # #   #   # #   #   #       #     #   #       #   # # 
# ### # ########### # ### ########### # ##### ### ##### # # # ##
# #   #       #   # # #   #   #     # # #   # #   #   # # # #   
# # # ####### ### # ### ### # # ### # # # # # # ##### # # # ### 
#   #                       #   #         #     #         #     
