################################################################
################################################################
 #   #S#     #   #     #       #                 #       #     #
 # # # # ### # # # ### # ##### # # ######### ### # ##### ### # #
 # # # #   #   #   # # #   # # # # #       #   # #   #   #   # #
 # # # ### ######### # ### # # # # # ##### ##### ### # ### ### #
   # #   # #         # # #   #   # # #   # #   # #   #   #   # #
 ##### # # # ######### # ####### # # # ### # # # # ##### ##### #
       # # # #   #     #         # # #   # # #   #   # # #   # #
######## # # # # # ############### # ### # ### ##### # # # # # #
       # #   # # #   #             # # # #     #   #   # # #   #
 ##### # ##### ##### ### ########### # # ##### # ##### # ##### #
     # #   # #       #   #           #             # # #   #   #
#### ##### # # ####### # # ################# ##### # # ### # ###
 #           #   #   # # #   #   #           #   # # # #   # # #
 # # ####### ### # # # ##### # ### ##### ##### # # # # ##### # #
   # #   #         #   #   # #     #     #     # # # #     #   #
## # # # ############### # # ####### # ### ##### # # ##### ### #
   # # #     #       #   #   #   #   # # # #   # #   #   #     #
 ### # ##### # ##### # ######### # # # # # # # # ### # # ##### #
   # # #   #   #   # # #     #   # # #   #   # # #     #     # #
 ### # # # ##### ### # # ##### ### # ######### # ######### # # #
 #   # # # #       #   #           #         # #     #     # # #
 # # # # # ### ### ######### ############# ### ##### # ##### # #
 # # # # #   # #             #           # #   #     #     #   #
 # # # # ### ### # ########### ######### # # ### ############# #
 # # #   # #   # # #     #   # #       # # # # # #           # #
 # ####### # # # ### ### # # # # ### # # ### # # # ######### # #
 # #     # # # # #   #   # #   # # # # #   # #   # #   #   # # #
 # # ### # ### # # ### ### ##### # # # ### ### ### # ### ### # #
 #     # #     # # # #     #       # #   #   #     #           #
 ####### ######### # ####### ##### # # ##### ######### ####### #
 #         #     # # # #   # #   # # # #     #   #     #     # #
## ######### ### # # # # # # ### ### # # ##### ### ##### ### # #
   #       #   # #   #   #     #     # #     # #   #   # #   # #
 ### ##### ### ############### ############# # # ### # ### ### #
   # #     # #       #       # # #   #   #   # # #   #     # # #
 # # # ##### ####### # ##### # # # ### # # ### # # ######### # #
 # # # #   #   #   #   #   # # #   #   #   #     #       #   # #
 # ### # # ### # # ####### # # ### # ################### # # # #
 #G    # #   #   #   #     # #     #       #   #   #   # # #   #
 ####### ### ### ##### ### # ##### ####### # # # # # ### # #####
   #     # #   #   #   #   #       #     #   #   # # #   #     #
 # # # # # ### ### # ### ######### ##### ######### # # ### ### #
 #   # # # #   #     # # #   #   #       #   #     # # # # #   #
 ##### # # # ######### # # # # ######### # # # ##### # # # # # #
     # # #   #       #     #   #       #   # #     #   #   # # #
#### # # ##### ##### # ####### # ### ####### ##### # ### ### ###
     # #     # # #   # #     # #   #       #   #           #   #
 ##### # # ### # # ##### ### # ### ########### # # # ######### #
 #     # #     #   #   # #   #   # #         #   # # #         #
 # ########### ####### # ##### ### # ####### ##### ### #########
 #           #   #     #   # #   # #       #     #   #     #   #
############ # # # # # ### # # # # ####### # ####### ### # # ###
   # #       # # # # #     #   #         # #       #   # # #   #
 # # # ####### ### # ### ### ########### # ####### ### # # ### #
 #   # #     # #   #   #     #     #   # # #   #   # # # #   # #
 ##### # # # # # ##### ####### ### # # ### # # # ### # ##### # #
 #     # # #   #   # #   #     # #   # #   # # #     #     #   #
 ### ### # ####### # ### # ##### ##### # ### # ########### #####
     #   #         #   #   #     # #   #   # #   #         #   #
###### # ########### # ##### ##### # ##### ##### # ######### # #
       #             #             #             #           # #
################################################################
