################################################################
#     #       #     #     #   #     #     #       #     #   #   
# ### # ####### ##### ### ### ##### # # # # # ### ##### # # # ##
# #   #         # #   # #     #     # # #   #   #   #   # # #   
# ### # ######### # ### ####### ##### # ####### ### # ##### ### 
#   # #       #   #   #             # # #     #   # # #   #   # 
### # ####### # ##### ### ##### ### # # # ### ### # # # # ### # 
#   #   #   # #     #   # #     #   # #   #   #   #     #   # # 
####### # ### ##### ### # ########### ##### ########### # ### # 
#   #   #     #     #   # #   #     # #   # #     #   # #     # 
# # # ### ##### ##### ### # # # ### # ### # # ### # # # ####### 
# # #   # #   #     # #     #     #       #   #   # # #   #     
### ### # # # ##### # ### ##################### ### # # # # ### 
#   #   #   #       # #   #         #   #     # # # # # # # #   
# ##### ##### ####### # # # ####### # # # ### # # # # # # # # ##
# #   #       #   #   # # #   #   # # # # # #   #   # # # # # # 
# # # ####### # # # ##### ### # # # # # # # # ####### # # ### # 
# # #           # # #     #   # # # # #   #   #       # #   #   
# # ##### ### ##### # ##### ### ### # ### ##### ######### # ### 
#   #     #     #     #   #   # #   # #   #   # # #     # #   # 
######### # # ### ##### # ### # # ### ##### # # # # ### # ### # 
# #       # # #   #     #     # # #       # # # # # # # #   #   
# # ### ### # # ### ########### # # # ### # # # # # # # ### ####
#   #   #   #     # #     #   # # # #   #   #     #   # # #   # 
### ##### ####### # ##### # # # # # ################### # # # # 
#   #     #   #   #   #     # #   #   #   #     #       # # #   
##### ##### # # ##### ####### ######### # # ### # ####### # # ##
#     #   # # #   # #   #             # # # # #   #     #   #   
# ##### # # # # # # ### # ##### ##### ### # # ##### ### ####### 
#     # # # # # # #   # #     #     #     #         # # #     # 
##### # # ### # ### # # ##### # ### ####### ##### ### # ##### # 
#   # # # #   #   # # # #   # #   #             #     # #   #   
# # # # # # ##### # # # # # # ### ### ######### ### # # # # ### 
# # # # #   #   #   # # # # #   #   # #         #   # # # #   # 
# # ### ##### # ##### # # # ### ##### # ######### ##### ##### ##
# #   #   #   # #   # #   #     #   # # #       # #   #     #   
# ### ### ##### # ### ########### # # # # ##### # # # ### ##### 
#   #   #   #       #     #     # #   #   #     #   #   #   #   
### ### ### # ##### ##### # ### # ######### ##### ##### ### # ##
# #   # #   # #   #       # # # #   #       #     #       # # # 
# ##### # ### # # ######### # # # # # ####### ##### ##### # # # 
# #   # #     # #      G#   #   # # #   #     #   # #   # #   # 
# # # # ##### # ####### # ######### # # ##### # ### # ### ##### 
#   #   #     #   #   #   #         # #   #   # #   #   #       
# ####### ### ### # # ##### ### # ### ### # ### # ##### # # # ##
#     #   # # #   # #       #   #   #   # #     # #   #   # #   
##### # ### # # ############# ##### ##### ####### # # ##### # # 
#     #     # #   #   #   #   #   # #   #   #     # #       # # 
# ########### ### # # # # # ##### # # # ### # ####### ### ##### 
# #     #   #   #   #   # #       # # # #   #       # #   #   # 
# ##### # # ### ######### ### ##### # # ########### # # ### # # 
#     #   #     # #     #   # #     # # #   #   #   # #   # #   
##### ######### # # ####### # # ##### # # # # # # ####### ######
#   #     #   #   #   #   # # #       #   # # # # #     # #     
# ####### # # ### ### # # # # ############# # ### # ### # # ### 
#     #   # #         # # # # #     #     # #   # #   #   # #   
# ### # ####### ##### # # # # # ### # ### # ### # ### ##### # # 
#   # #       #S#   #   # # # #   # # # #   # # #   #   #   # # 
### # ####### ### # ##### # ##### # # # ##### # ### # # # ### ##
#   #   #         #       # #     #   # #     #     # #     #   
# ####### ### ########### # # ######### # ########### ######### 
# #       # # #       #   #   #       # # #     #     # #       
# ##### ### # # ##### # # ##### ####### # # ##### # ### # ######
#       #     #     #   #                         #     #       
