################################################################
#           #                 #   #                   #         
# ### ##### # # ####### ### # # # # # ########### ### # ### ####
#   # #     # # #       #   # # #   #   #       #   #   # #     
##### ##### ### # ####### ### ########### ##### ### ##### ##### 
#     #   #     # # #   #   #   #       #   # # #   #   #   #   
# ##### # ### ### # # # ####### # ##### ### # # # ### # # # # # 
#   #   #   # #   # # #       # #   # #     # # #   # #   # # # 
### # ##### ### ### # ####### # ### # ####### # ### ##### ### # 
#   # #   #   #     #   #   # #     #             #     # #   # 
# # # # # ### ######### # # # ######### ######### ##### # # ####
# # # # #   # # #       # # # #     #   #       #         #     
# ### # ### # # # ######### # # ### # ### ##### # ############# 
#     #   # # # #           # #   #   #   #     #   #   #     # 
# ####### # # # ############# # ####### ### ##### # # # # ### # 
#   #   # #   #   #         # # #   #   #   #     # # #   #   # 
### # ### ##### # # ####### # ### # # ### ### ### # # ##### ### 
#   # #   #     #     #   # # #   # # # # #   # # # # #     # # 
# ### # ### ##### ##### # # # # ### # # # # ### # ### # ##### # 
# #   # #     # # #   # # # # # #   # # #       #     #   # # # 
# # ### ##### # # # # # # # # # ##### # ### ############# # # # 
# # #     #   #   #S# # #   # # #   # #     #         #   #     
# # ##### ##### ### # ##### # # # # # # ##### ####### # ####### 
# #       #     # # #   #   # #   #   # #   # #     # # #   #   
# ######### ##### # ### ##### ######### ### # ##### # # ### # # 
# #         #     #   #       #             #     #   #   # # # 
# # ######### # ##### ########### ############### ####### # # # 
# #           #     # #     #   # # #     #     # #   # #   # # 
# # ########### # ### # ### # # # # # ### # ### # # # # ####### 
#   #         # #   # #   #   # # # #   #   # # # # # #         
##### ####### ##### # ### ##### # # ### ##### # # # # # ####### 
#     #   #   #     # #   # #       #   #     #   # #   #       
# ####### # ### ##### # ### # ####### ####### ##### ##### ### # 
# #     # # # #     #   #       #     #         # #   #   #   # 
# # ### # # # # ############### # ####### ##### # ### ##### ### 
# # #   #   #   # #     #     # #   #     # #   # #   #     #   
# # # ######### # # ### # ### # ### ### ### # ### # ### ########
#   # #       #   #   #   # #   # #     #   # # #   #       #   
##### ### ### ### ######### ### # ####### # # # ##### ##### # # 
#   #   # #     # #   #                 # # # #       #     # # 
# # ### # ##### ### # # ########### ### # # # ####### # ####### 
# # #   #   # #   # # #         #   # # # # #   #   # # #     # 
# ### ##### # ### # # ######### # ### # # # ### # # ### # ### # 
#   #   #   #   #   #         # # #       #     # #   #   # # # 
### ### # ### # ############# ### ### ######### # ### # ### # # 
#     #   #   #         #   #   #   # #         # #   #   # # # 
# ### ##### ##### # # # # # ### ### # # ####### # # ##### # # # 
#   #       #     # # #   #       # # # #   #   # # #   #   # # 
# # ######### ##### # ########### # # # # ### ### # # # ### # # 
# #     #   #   #   #   #   #   #   # #   #   #G  #   #   # #   
# ##### # # ##### ##### ### # # ########### # # ######### # ####
#     #   # #     #   # #   # #         #   # # #   #   # #     
# ########### ####### # # ### ######### # ### # # # ### # ##### 
# #     #     #     # #   #   #   #   # # #   #   #   #   #   # 
# # ### # ##### ### # ##### ### ### # # # # ######### ##### # ##
#   #   #     #   #   #   #   #     #     #                 #   
# ### ####### ### ##### ##### ##### # ####### # # ### ######### 
# # #       #   #   # #     #     # #   #   # # # #   #       # 
# # ### ##### ##### # # ######### # ##### # ### # ##### ##### # 
#   # # #     #     # # # #   #   # #     #   # #     # # #   # 
# ### # # ### # ##### # # # ### ##### ####### # ##### # # # ### 
#   # # #   # #     # # # #   #     # #   # # #   #   #   # #   
# # # # ### ####### # # # ### ##### # # # # # ### # ####### # # 
# #   #   #                 #       #   #   #     #       #   # 
