################################################################
#   # #   #   #       # #     # #               #             # 
### # # # # # ####### # # # # # # # # # ##### ### ######### # # 
#   # # # # #     # # #   # # #   # # #     #     #       # #   
# ### # ### ##### # # ##### # # ### # ### # ##### # ##### # ### 
# #   #   #     # # #       # # #   #   # #     # # # #   #   # 
# ### ### ##### # # ######### # ####### ####### ### # # ##### # 
# #   # #       # #     #     #   #   #       # #     # #     # 
# # # # ######### # ##### ##### # # # # ##### ### ##### # ##### 
#   # # # #                     #   # # #   #   # #     # #     
##### # # # ########### ########### # ### # ### # ####### ##### 
#     #   #       #   #   #       # #     # # # #   #       #   
# ##### ### ####### # ##### ##### ######### # # ### # ### # # ##
# #     #   #       #G  #   #   # #   #   # # #   # #   # # #   
# # ### # ### ######### # ### ### # # # # # # ### # ### # # ### 
# #   # #   # #   #   # # #     #   # # # # #   #   #   # # #   
# ### # ### # # # ### # ### ### ##### # # # ### ########### # # 
# #   #   # #   # #   #   # # #   #   # #   #       #       # # 
# # ####### ##### # # ### # # # ### ### ##### ##### # ####### ##
#   #       #   #   # # # #   #   # # # #   # # #   # # #   #   
# ### ####### # ##### # # ### ### # # # # ### # # ### # # ##### 
#     #     # # #   # # # #   #   # #   # #   # #   # # # #     
# ##### ### # # # # # # # # ### ### ##### # ### ### # # # # ### 
#       #   # #   # # # #   # #     #   #   #   # #   # # # #   
######### ### ##### # # ##### ######### ####### # ##### # # # ##
#       # #   #     #             #   #             #     # #   
### ##### # ##################### # # # ########### # ##### ### 
#   #     #       #             # # # #   # #     # # #       # 
# # # ########### # # # # ### # # ### ### # # ### # # # ### # # 
# # #           #   # # # #   # #   # # #   # # # # # # # # # # 
# # ########### ##### # # # ### ### # # ### # # # ### # # # # ##
# #         #   #     # # #   # # # # #   # #   #     # # # #   
########### # ### ##### # ### # # # # # ### ### ####### # # ### 
#       #   # #   #     #   # #   # # #   #   # #       #   #   
# ##### # ### # # # ### ##### ### # # # # ### # ############# # 
#   # # #       # # #   #     #   # # # #     #           #   # 
### # # ##### ##### ##### ##### ### # # ################# # ### 
#   #         #     #     #     #   #       #   #   #   #   #   
# ##### ####### ##### ### # ### # ##### ### # # ### # ####### # 
# #     #       # #   #   # #     #   #   #   # #   #     #   # 
# ### ### ####### # ####### # ### # # ### ####### # ##### ##### 
#   #   #         # #       # #     #   #         #     #       
# # # # ########### # ######### ### # # ####### ##### # ####### 
# # # #   #     #   # #   #     #   # #   #     #   # #         
### # ##### ### # ### # # # ### # ####### ##### # # # ##### # # 
#   # #     # # # # #   # #   # # #   # # #   # # # #     # # # 
# ### # ##### # # # ##### ### # # ### # # # # ### ####### ### # 
# #   #   # #   #   #   #   # # #     # #   #   #         #  S# 
# ####### # ######### # ##### ######### ####### ######### # ### 
#       # #   #   #   # #   #       #   #       #   #   # # # # 
# ### ### ### # # # ##### # ####### # ### ####### # # ### # # # 
#   #     # #   # # #     #         # # # # #     # #     # #   
# ######### ##### # # ############### # # # # # ### ##### # ####
# #           #   #   #         #       # #   # #     #   #     
# # ##### # ### ############### # ####### ##### ##### # # ##### 
#   #   # # #   #   #       #   #     #   #   #   # #   # #     
# ### # # ### ##### # ##### # ### ##### ### # ### # ### # # ####
# #   # #     #   #   #   # #         # #   #     #   # # # #   
# # ### ######### ##### ### ##### ### # ############# # # # # # 
# #   #                   # #   # # # #     #       #   # # # # 
# ### ### ########### ### # # # # # # ##### # ##### ##### # ### 
# #   # # #   #     # #   #   # # # #     # #     #   #   #   # 
# # ### # # # # ### # ######### # # ##### # ##### ### # ##### # 
#       #   #   #   #             #       #       #   #     #   
