################################################################
       #       #       #   #       #         #   #       #   # #
## ### ### # # ### ##### ### ##### # ### ### # # # ####### # # #
   # #   # # #   #       #   #     # #   #     #           #   #
 ### ### ### ### # ####### ### ##### # ####################### #
     #   #   # # # #   #   #   #   # # # #   #               # #
###### ### ### # # # # # ######### # # # # # # ############# # #
     # #     #   # # # #     #   #   #   # # # #         #   # #
 ##### # ### # ### # # ##### ### ######### # # # ######### ### #
       # #   #   #   # #   #   # #     #   #   #   #       #   #
 ######### ##### ### ### ##### # # ### # ######### # ######### #
           #   #   #     #     # # #   # #         # #       # #
######## ##### ### ##### # ##### # # ##### ### ### # ####### # #
         #   #     #   # #   #   # # #   #   #   # #       # # #
 ######### # ##### # # # ### ### ### # # ### ### ######### # # #
 #       # #     # # # # # #   #   # # # #     #     #     #   #
## ##### # ##### # ### # # ### ### # ### # ### ##### # ####### #
   #     #   #   #   # #     # #             #     #   #   #   #
 ### ####### # ##### # # ##### # ########### ##### ####### # ###
   #   #     # #   # #   #   #   #     #     #             # # #
## ### # ##### ### # ### # # ### # ### ####### ##### # ##### # #
 #   # # #   # #   #   # # #   # #   #       # #   # #       # #
 ### # # # ### # ##### # # ##### ### ####### # ### # ######### #
   # # # #     #   #   #             #   #   #     #     #     #
 # # # # ####### ### ########### ####### # ########### ### #####
 #   #   #         # #         # #   #   # #         #  G      #
 ######### # ##### # ### ##### # # # # ### # ####### ######### #
           # #     #   #     # # # #   #   # #   # #     #     #
###### ### # ##### ### ##### # # ##### # ### # # # ##### # #####
     #   # #   #     #   #   # # #     #   # # #   #   # #   # #
#### # # ### # ######### # ### # # ### ##### # ##### # # # # # #
     # #   # # #       # # # # # # #     #   #       # # # #   #
 ##### ### ### # ##### # # # # # ### ##### ### ######### # #####
   #     # #   # #   #   # # # #     #         #         #     #
## ####### # ### # ####### # # ##### # ######### ######### ### #
   #   #   #     # #   #   #       # #   # #   # #       # #   #
 ### # # ### ##### # # ########### # ### # # # # ####### # # # #
     #   #         # #         # # #   #   # # #         # # # #
########## # # ##### ######### # # # # ### # # ########### # # #
           # #     # # #       # # # #     # #   #         # # #
## ### ##### # ### # # # ####### # # ####### ### ######### # ###
   # # # #   #   #   #   # #   #   #   #     #   #       # #   #
 # # # # # ####### ####### # # # ### ### ##### ### ##### ##### #
 # # #   # #     #         # # # #   #   #   # #   # #   #     #
 # # ##### # ### ##### # ### # # # ### ### ### ##### # ### ### #
 # #     #   # #     # #     #     #   # #   #   #   # #   #   #
 ####### ##### ##### ########### ### ### ### ### ### # # ##### #
     #   #   #     #   #   #   #   # # #   #   # #   #   # #   #
 ### # ### # ### ##### # # # # # # # # ### ### # # ####### # ###
 #   # #   #     #   # # #   # # #   #   # #   # # #     # #   #
 # ### # # ####### # # # ##### ####### ### # ### # # ##### ### #
 #     # #       # # #   #   #       #     #   # #       #   # #
 ####### ####### # ####### # # ##### ##### ### # ####### ### # #
   #   # #     #   #   #   # # #   # #   # # #   #     #   #   #
 # ### # # ######### # # ### # # # # # # # # ##### ### # # ### #
 #     #   #         #   #   #   # #   # #           # # #     #
 ######### # ##################### ##### ### # ##### # # ### # #
 #         # #   #         #         #   #   #   # # # # #   # #
 # ######### # # # # ##### # ####### # ### ##### # # # ### #####
 # #   #   # # #   #   # # # #     # # #   #   #   # #     #   #
 # # # # ### ##### ### # # ### ### ### # # # # ##### ######### #
 # # # #   #   #     # #   #   #S#     # #   #     # #   #   # #
 # # ##### ### ####### # ### ### ############### # # # # # # # #
             #         #     #                   # #   #   #   #
