################################################################
################################################################
   #   #         #                                             #
 # # # # ##### # # ################# ##### # ####### ##### # ###
 #   #   #     #   #         #       #     # #   #   #     #   #
 ############### ### ####### # ####### ##### # # # ### ####### #
   #   #   #     # #   # #   # #       #   # # # # # # #   # # #
 ### # # # ### # # ### # # ### # ### ### # # # # # # # ### # # #
     # # #   # #     #   # # # #   #   # #   # # # # #   # # # #
 ####### ### # ########### # # ####### ######### # # ### # # # #
         #   # #           # #     # # #       # # # # #   #   #
 ############### ########### ##### # # # ##### # # # # ####### #
   #       #     #   #     # #     # # # # #   #   #           #
## # ##### # ####### # ### # # ##### # # # # ####### ####### # #
   #     # #         # # # #   #   # #     #   #   # #     # # #
 ####### ##### ####### # # ##### ### ######### # # # # ### # # #
   #   # #   # #       # #   # #   #           # #   # # # # # #
## ### # # # # # ####### ### # ### ############# ##### # # ### #
 #   # # # #   # #       #   #           #           # # #     #
 ### # # # ##### # ##### # ######### ### ### ####### # # ##### #
   #   # #     # # #   # #         #   #   #   #     # #   #   #
## ### # ##### # # # ### ######### ####### ### # ### # ### # # #
   #           #   #   #     # #   #     # #   #   # #   #   # #
 ### ####### ######### ##### # # ### ### # # ##### ##### # ### #
     #     #   #     # #   #   #     # # # # #   # #   # # #   #
###### ### ### # # # # # # ### ####### # # # # # # # # # # # # #
   #   # # #   # # #   # #   # #     #   #   # #   # #   # # # #
 # # ### # # ### # ### # ### # # # ########### ##### ##### # # #
 # # # # # # #   #   # #   # # # # #     #   #     # #   # # # #
 # # # # # # # ##### ##### # # # ### ### # # ####### # ### # # #
 # # # #   # #     # #     #     #   # # # #     #   #     # # #
 # # # ##### ##### # # ########### ### # # ##### # ##### ### # #
 # #   # #     #   # # #           #   # # #   #   #     #   # #
 # ### # # ##### ### # # ########### ### # # ####### ##### ### #
 #     #       #   #   # #   #     #     # #     #       # #   #
 ######### ### ### ##### # # ##### ####### ##### ####### # ### #
 #       #   #  S  #     # #       #       #   #   #   # #   # #
 # ##### ### ####### ##### ####### # # ### # # ### # # ##### # #
 #     # #       #   #   #   #   #   #   # # #   #   #       # #
 # ### # # ####### ### # ### ### ### ### # # ### ############# #
 #   # # #   #     #   #   #   # #   #   # # # # #   #     #   #
 ##### # ### # ####### ### # # # ##### # # # # # ### ##### # # #
 #     # #   # #       # # # #   #   # # # # # #   # #   #   # #
 # ##### # ### # ####### # ####### # # # # # # ### # # # ### # #
 # # #   #     # #     #   #       #   # #       # #   #   # # #
 # # # ### ####### ### # ### ##### ############# # ####### ### #
 # # # #   #       # # #     #   # #   #       # #    G#       #
 # # # # # # ####### # ####### # # # # # ##### ####### # # #####
 # #   # # # #   #       #     #   # #   #   #     #   # # #   #
 # # ### # # # # ####### ########### ##### ####### # ### ### # #
 # # #   # #   #       #       #   # #   #       # #   # #   # #
 # # # ############### ####### # # # ### # ####### # # ### #####
   #     #   #       #     #   # # # #   #     #   # #   #     #
#### ##### # ### ######### # ### # # # ####### # ### ### ##### #
 #   #   # #   # #       # # #   # # #       # #   #   #       #
 # ### # ##### # # ####### # # ### # # ####### ### ##### #######
     # #   #   # #   #     #   #   # #       #   #     # #     #
#### # ### # ### ### # ######### ### # ##### ### ##### # # # ###
     # # #   #     #   #   #   #     # #   #   # #     #   #   #
 ### # # ######### ##### ### # ####### # # ##### # ########### #
 #   #     #     #     # #   #       #   # # #   #   # #     # #
 # ####### ### # # ### # # ############### # # ##### # # ##### #
 #             #   #                                 #         #
################################################################
