################################################################
# #     #         #         #   #       #       #   #   #       
# # ### # # ##### ### ####### ### ##### # ##### # ### # ##### # 
# #   # # # #     #   #       #       #   #   # #     #     # # 
# ### # # # ##### # # # ####### ##### ##### ### ########### ### 
#     #   # #   #   #           #   #     # #   #     #   #     
######### # # # ################# # ##### # # ### ### # # ##### 
#   #     #   #         #         #   # # #   #     # # #     # 
# # ##### ############### ########### # # ######### # ####### # 
# #     # #               # #   #   # # # #         #       #   
# ##### ### ############### # ### # # # # ### ############# ### 
# #   #   # #     #     #   #     # # #       #     #   #   #   
# ### ### # ##### # ### # # ####### # ####### # ### ### # ### # 
#   #   #   #     #   # # #   #     #   #   # #   # #   #   # # 
### ### ##### ### ### ### ### # ####### # # # ##### # ##### ### 
# # #           #   #   #   #     #     # # # #     #           
# # # ##### # # ### ### ### ####### ##### # # # ##### ######### 
#   #   #   # # # #   #   # #       #     # # #   #   #   #   # 
######### ##### # ### ### # # ####### ##### ##### ##### # ### # 
#         # #   #   # #     # #       #   #   #   #   # # #   # 
# # # ##### # ##### # # ### # ### ##### # ### # ### # ### # ### 
# # #       # #         #   #     #     #       #   #   # # #   
# ########### # ######### # ####### # ####### ### ##### # # # ##
#           # # #   #     #         # #   #   #   #   #   # # # 
# ########### ### # # ######### # # # # ### # # ##### ##### # # 
# #       #   #   #   #         # # # #   # #   #   # #       # 
# # ##### # ### ####### ########### # ### # ##### # # # ####### 
#   #   # #   #     #   #   #       # #   # #     # # #   #     
# ### # # ### ##### # ##### # ####### # ### ####### # ### ##### 
# #   # # # # # #   #       #   #     # # #   #     #   #       
### ### # # # # # ############# ##### # # ### # ####### ####### 
#   # #   # #   #       #     # #   # # #   # #       #         
# ### ### # ########### # # ### # # # # # # # ####### ##### ####
#   #     #   #   #   #   #   #   # # # # # # #     #     #   # 
# # ######### # # ### ####### ##### ### # # # # # ####### ### # 
# #           # #   # #     #     #     # # # # #       # #   # 
# ############# ### # # ### ##### ######### # # ####### # # ### 
#   #         # #S#   # #       #   #       #   # #   #   # #   
# # # ####### # # ##### ########### # ### # ##### # # ##### ### 
# #   #     # #   #     #         # # #   #   #     #           
# ######### # ### # ### # ##### # # # # ### # # ################
#   #     # #   # # # #   #   # # #   # #   #   #   #     # #   
# # ##### # # ### # # ##### # # # ##### # ####### # ##### # # # 
# #   #   # # #   # # #   # # # #    G# #   #   # #     # # # # 
# ### # ### # # ### # # ### # # # # ### # # # # # ##### # # # # 
#   #   #   #   #   # # #   # # # #   # # # # # #     #     # # 
# ####### # ##### ### # # ##### # ### # ### # # # ### ##### # # 
#       # #         # #   #     #   # # #   # # #   #     # # # 
# ##### # ### # ### # # ### ####### # # # ##### ### ##### ### # 
#     #   # # #   #     #   #       # # # #     #   # #   #   # 
# ######### # # # ### ### ### ######### # # ##### ### # ### ### 
#   #     # # # #   # #   #   #   #     #         # #   #   #   
### # ### # # ##### # # ####### # # # ##### ### ### ##### ######
#   #   #   #   #   # #       # #   # #   #   #         #     # 
# ##### ####### ############# # ####### # ### ############### # 
# #       #   #       #     # #       # # #   #               # 
# # ####### # ####### # ##### ####### # # # ### ############### 
#   #   #   #       # #   #         # # # #   #   #         #   
# ##### # ######### # ### # ### ##### # # ### ### ######### # # 
#       #         # #   #   #   #     # #   #   #         # # # 
# # ############# # ### ##### ### ##### ### # ########### # # ##
# #         #   # # #   #   #   # #   #   # # #     #     # #   
# ######### ### # ### ### # ### # # # ### # ### # ### ##### ### 
#         #     #     #   #     #   #     #     #               
