################################################################
# #       #           #     #       #   #         #   #         
# # ##### # ######### # ### ### ### # ### ### ### # ### ##### # 
# #     #   #     #   #   # #   #         #   #   #   # #   # # 
# ##### ##### ### # ##### ### # ##### ##### ##### ### # ### # ##
#       #   # # #   #   #   # # #     #   # #   #           #   
# ######### # # ##### # ### # ### ##### # # ### ##### ######### 
# #     #   #   #     #   # # #   #   # # #     #   # #     #   
# # # # # # ######### ### # # # ##### # # ####### # # # ### # ##
# # # # # #     #   # #   #   # #     # #     #   # # # # # # # 
# ### # ##### # # # ### # ### # # ##### ##### # ### # # # # # # 
#   # #     # #   # #   #     #   #   # #     #   #   #   # #   
### # ##### # ##### # ####### ##### # # ######### ### ##### ### 
# #   #   #   #   #   #             # # #   #     #   #   #   # 
# ####### ####### ##### # # ######### # # # ####### ### # ### ##
#           #       #   # # #         #   #   #     #   #   #   
########### # ##### # ##### # # ############# # ##### ##### ### 
# #     #   #   #   # #     # # #           # #     #     # #   
# # # ### ##### # ### # ##### # # ######### # # ### ##### ### ##
# # # #   #   # # #   # #     # #     #   #   #   #     #   # # 
# # # # ### # # # ##### # ##### ##### # ####### # # # ##### # # 
# # #   #   #   #       # #         #           # # #     # # # 
# # ##### ############### ### ######### ####### # # ##### # # # 
# #   # # #     #   #   #   # #     #         # # #   # #   # # 
# ### # # ### # ### # # ### ### ### ######### # # # # # ##### # 
#   # # #   # #       # #   #   # #   #       # # # #       #   
# ### # ### ######### ### # # ### ### # ####### # ##### # ##### 
#     #   #   #     #   # # #   #     # #   #   #     # #     # 
# ##### ##### # ### ### # ##### ####### # # # ####### ####### # 
#     #     #   # #   # #     #       # # # # #     #     #   # 
##### ##### ##### # # # ### # ####### ### # # ##### ##### ##### 
#   #     # #   # # # #     #   #   #   # # # #     #   # #     
# # ##### # # # # ### ####### # ### ### # # # # ##### ### # ####
# # #     #   # #     #     # #     # #   #   #     #   # # #   
# ### ######### ####### ### # ####### ######### ### ### # # ### 
#   #   #             #   #   #     # #   #     # #   # #   #   
# # ### # ####### # # # # ### # # ### # # # ##### ### # ##### ##
# # #   # #   #   # # # # #     #     # # # #   #     #     #   
# ### ### ### # # # # ### # # ######### # # ### ########### ### 
#   # #       # # # # #   # #         # # #   #   #   # #   #   
### # # # ##### # # # # ### ### # # ### # ### # ### # # # ##### 
#   # # #     # # # #   #   # # # #   # # #     #   #   #     # 
# ### # ####### ### ##### # # # ##### ### # ##### ########### # 
# # # #   #     #   # #   #  G# #   #     #         #     #   # 
# # # ##### ##### ### # # ##### # # # ##### ####### ##### # ### 
#   #     #   #   # #   #     #   # # #       #   #       #   # 
### ##### ### # ### ### ##### ##### # # # ##### # ### ####### # 
#             # #         #   #     #   # #     #   #      S#   
# ### ######### # # ####### ### ######### # ####### ########### 
#   # #         # # #   #   # # #       # # #   # #     #       
### # # ######### ### # # ### # # ##### # # # # # ##### # ######
#   # #       #       # #     #   #     # # # #   #   #   # #   
# ### ####### # ####### ########### # ##### # ####### ##### # # 
# # #   #   # # #   #   #       #   # #   # # #         #   # # 
# # ##### ### ### # # # # ##### # ### # # # # ### ##### # # ### 
# #   #   #   #   # # # #     #   #   # #   # #   #   # # #   # 
# ### # ### ### ### # # ##### ######### ##### # ### ### # ### # 
# #   #   # #   # #   #     #     #     #   #   #   #   # # #   
# # ##### # ##### ##### # # ##### # ##### # ##### # # ### # ####
# # #   # #   #   #   # # #     # #     # # #     # # #   # #   
# # # ### # # # ### ### # ####### ##### # # # ##### # # ### # ##
# # # #   # # # # #     # #   #   #     # # #     #   # #   #   
# # # # ##### # # ####### # # # ### ####### # ######### # ### # 
#     #       #             # #                               # 
