################################################################
################################################################
#     #               #         # #     #   #   #   #           
# ### # ### ######### # ####### # # ### # # # # # # # # ########
# #   #   # #       # # #       # # #  G# #   # # #   # #   #   
# ### ### # # ####### ### ####### # ##### ##### ##### # # # # # 
#   #     # #   #   # #   #       #     # #     #   # # # #   # 
### ####### # # # # # # ### # ######### # ####### # # # ####### 
#   #     # # #   #   #   # # #       # #       # # # # #       
# # # ### ### ########### # # # ####### ####### # # # # # ######
# # #   # #   #       #   # # #     #   # #   #   # # #   #     
# ####### # ######### # ##### # ##### ### # # ##### # ##### ####
#     #   # #     #   #       # #   # #   # #       #   # #     
##### # ### # ### # ### ####### # # # # ### ########### # ##### 
#   # #   # #   #       #       # #   #   #     #       #       
# # # ### # ### # ####### ####### ##### # ##### # ############# 
# #   # # #     # #       #       #   # #   #   #             # 
# ### # # ####### # ####### ####### # # ##### ############### # 
# #     #       #         #     #   # # #   #     #     #   # # 
# ############# # ####### ##### ##### # # # ##### # ### # # # # 
#     #       #   #   #   #   #  S  #     #     # #   #   #     
# ### # # ### ##### # # ### ####### ##### ##### # ### ######### 
#   #   #   # #   # #   #   #     #       #   #   #   #   #   # 
# ######### ### # # ### # ### ### ####### # # # ### ### # # # # 
# #         #   # # #     # #   #   #     # # #     #   #   # # 
# # ######### ### # ##### # ### ### # ##### # ### ### ####### ##
# # #   #     #   # #   #   #   # #   #   # #   #   #       #   
# # # # # ##### ##### # ### # ### ##### # # ### ### ####### ### 
# #   # # #   # #     # #   # #   #     # #   #   # #     # #   
# ##### # # # # ####### # ### # # # ######### ### ### ##### # ##
#     # # # # #     #       #   # # # #     #   # #   #   # #   
##### # # # # ##### ### ######### # # # ### ### # # ### # # ####
#     # # # # #   # #   #       # #   # # # #   #     # #   #   
# ### # # # # ### # # # # ##### # ### # # # # ######### ##### # 
# #   # # # #   #     # #   #   #     #   #     #     # #   # # 
# ##### # # ### ####### ##### ####### ### ####### ### # # # ### 
# #   # # #   # #     #       #   # # # # #   #   # #   # #   # 
# # # # # ### # # ### ##### ### # # # # # # # # ### ##### ### # 
# # # # #     # #   #         # #   #   # # # #   #     # # #   
# # # ######### ### ####### ### ####### # ### ### ##### # # ####
# # #       #     #       # #   #     # #   #   #               
# # ####### # ############# # ##### ### ### ### ######### ##### 
# #   #   # #   #       #   #     #   # # # #         #     #   
# ### # ### ##### ##### # # ##### ### # # # # ### ### ##### ####
#   # #     #   #   # #   #     #     # # # #   #   # #   #     
### # ##### # # ### # ######### ### ### # # ####### # # # ##### 
#   #     #   #   #   #       #   # #   # #         #   #   #   
# ####### ####### ##### ##### ### # # ### ################# # # 
# #     #     # #     # #   #   #   #     #     #       #   # # 
# # # ####### # ##### # ### ### ### ##### ### # # ### # # ### # 
# # # #   #   # # #   # #     # #       #     # #   # # #     # 
# # ### # # ### # # ### # ##### # # ### ####### ##### # ####### 
# # #   #   #     #     #   #   # # #   #     #       #   #     
# # # ####### ########### ### ### ### # ### # ########### # ### 
# # # # #     #         #   # #   #   #     # #   #     #   #   
# # # # # # ### ##### ### # # ##### ######### # # ### ####### ##
#   # # # #     #   #     # #   #   #         # # #   #     #   
##### # # ####### # ####### ### # ### ######### # # # # ####### 
#     #   #       #       #   # #   #   #       #   # # #   #   
# ####### # # ######### ####### # # ### # ########### # # # # ##
# #     # # # #         #       # #   # # # #   # #   # # # #   
# # ### # # # # ####### # ########### # # # # # # # ### # # ### 
#   #   #   # #       #               #   #   #           #     
################################################################
