################################################################
################################################################
#       #                       #   #   #   #           # #G    
# ##### ##### # ##### ##### ### # # ### ### # ######### # # ####
#   # #       #   #   #   #   #   #     #   #     #     # # #   
### # ####### ##### ### ##### # ######### ######### ##### # # # 
# # #         #     #   #     # #   #   #                 # # # 
# # # ##### # # ##### ### ##### ### # # ##### ####### ##### # # 
#   # #   # # #   #   # #   #       # #       #     #       # # 
####### # ### ### # ### ### ### ##### ######### ### ### ##### # 
#   #   # #   #   # #     #   #     #   #     #   #   # #     # 
# ### ##### # # # # # # # ### ##### ### # ####### ### ### ##### 
#   #     # # # # # # # # # # #   #     # #     # # #   # #   # 
# # ##### # # # ### # # # # # # # ### ### # ### # # ### # # ### 
# # #   #   # #     # # # # #   #   #         # # #   #   # #   
# # # ####### ######### # # ####### # ######### # ### ##### # ##
# # #   #           #   # # #   # # # #   #     #   #   #   #   
# ##### # ####### # # ### # # # # # ### # # ### ### ### # ##### 
# #   #   #     # # # # #S#   #   # #   # # #     # #   # #     
# # # ##### ### # # # # # # ####### # ### # ####### # ### # ### 
#   # #     # # # # # #   #       #   #   # #   #   # #   # #   
# ### # ##### # # # ### ### ### # ##### ##### # # ### # ### ####
# #   # #     #   #     #     # #     # #   # #         #   #   
# ##### ##### ##### ##### ### ####### # # # # ########### ### # 
# #   # #   #             # #     #   #   #   #   #     #   # # 
# # # # # # ##### # ####### ##### # # ######### # # ### ### # # 
# # #   # #   #   #       # #   # # #           # #   #     # # 
# # ##### ### ##### # # ### # # # # ### ### # ####### ####### ##
#   #   # #   #     # #   # # # # #   # #   #       # #     #   
##### # # # ### ##### # # # # # # ### # ########### # # ### ### 
#   # # # # #   #     # #   # # # #   # #         # # #   #     
### # # ### ### # ### # ##### ### ##### # ####### # # ### ######
#   # # #   #   # #   #     #   #   #   # #   #   # #   # #   # 
# ### # # ### ### # ### # ##### ### ##### # # # ### # ### # # # 
#     #   #   #   # # # #       # # #     # # # #   #   # # # # 
# ######### ####### # # ######### # # ####### # ### ### # ### # 
#           #     # # #           #           # #     #   #     
############# # # # # # # # ############# ##### # ######### ####
#     #       # #   #   # #   #   #     # #     #       #       
# ### ### # ### ######### ### # # # ### ### ##### ##### # ##### 
#   #     #   #   #     #   # # # #   #   # #     #   #   #   # 
# ########### ### # ### # # ### # ### ### # # ##### # # ##### # 
# #   #     # #   #   # # # #   #   #   #   # #     # # # #   # 
### # # ### # # ##### # ### # ##### ### ####### ##### # # # ### 
#   #   # #   # #     #     # #   #   #   #   #   # # # # #   # 
# ####### ### # # ######### # # # ### ### # # ### # # # # ### # 
# #           # # #     # # # # #       #   #   #   # # # #   # 
# # ########### # # ### # # # # ############### ### # # # # ### 
# #       #     #   #   #   # #           #     #   # #   # #   
# # ##### # ################# ########### # ##### ### ##### # # 
# #     # #                 # #   #   #   #   #   # #     # # # 
# ##### # ################# # ### # # # # ### # ### ##### # # # 
#   #   #                 #   #   # # # #   #   #       # # # # 
### ############# ##### # ##### ##### # # # ##### ##### # # ### 
#   #       #   #   # # # # #   #     # # #   #     #   # #     
# ### ##### # # ### # # # # # ##### # # ### # # ### ##### ######
#   #   # #   # #   #   # # # #   # # # #   # # # #   #   #     
### ### # ##### # ####### # # # # # # # # # ### # ### # ### ### 
#   #     #     #       #   # # # # # # # # #   #     # #   #   
# ### ##### ########### ##### # # # # # # ### ######### ##### ##
#   # #     #         #       # # # # # # #   #   #     #     # 
# # # # ##### ####### # ######### ### # ### ### # # ##### ##### 
# #   #       #       #               #         # #             
################################################################
