################################################################
# #     #           #           #   #     #               #   # 
# # ### # ##### ### # ########### # # ### # ####### ### # # # # 
#   # # # #   # #   # #     #     #   #   #     # # #   #   #   
##### # # ### # ##### # ### # ######### ####### # # ####### ####
# #   # # #   #   #   # #   #     #       #   # # #       #     
# # # # # # # ### # ### # ####### ####### # ### # ####### ##### 
#   # # # # # # # # #   # #     # #     # #   # #     #   #     
# ### # # ### # # # # ### ### # # # ### # ### # ### ### ########
#   #   # #   # # #   # #     #   # # # # #   #   #   #   #     
### ##### # ### # ##### ########### # # # # ##### ### ### # ### 
#   #   # # #   #     #     #  G    # #               # #   #   
# ### # # # ### ##### # ### # ####### ### # ##### ##### ##### ##
#   # # # #     #   #   #   # #   # #   # #     #       # #   # 
# # # # # ##### # # ######### # # # # ### ##### ### # # # # ### 
# # # # #   # # # #       #   # # #       #   # # # # #   # #   
# # # ##### # # # ####### # ##### ######### ### # # # ##### # ##
# # #   # # #   # #     #   #   #   #     #     #   #   #   #   
# # ### # # # ### # ### ### # # ### # ### ############# # ##### 
# #     # #   #   #   #     # #   # # #       #       # # #     
# ####### # ### ########### # ### # ### ##### # ##### # # # ####
#   #   # # #   #       #   #   # # #   #     # #     # #   #   
### # # # # # ### ##### # ##### # # # ### ##### # ##### ##### # 
# # # # # # #     #   # #     # # # #   #   #   #   #         # 
# # ### # # ######### # ##### # # # ####### # ##### # ####### # 
# # #     #     #     # #     # #   #     # # #   # #       # # 
# # # ######### # ### # # ### # ##### ### # # # ### # ##### # # 
#   #       # #   #   # #   # # #   # # #   # # #   #     # # # 
# ### ### # # ##### ### ### ### ### # # ### # # # ######### # # 
#   # # # #   #   #   #   #   #   # #   # # #   # #       # # # 
### # # # ##### # ### ### ### ### # ##### # ### ### ##### # # ##
#   # #   #   # #   #   #   # #   #   #   #   # #   #   #   #   
# ### ##### # # ### ### ### ### ##### # # ### # # ### # ####### 
#   # #     #   #     # # #   #   # # # # #   #   # # # #     # 
### # # ############### # ### ### # # # # # ####### # # # ### # 
#   # #           #     #   #S    #   # #         #   # #   # # 
# ### ########### # ##### ########### ########### # ####### ### 
#   #     #       #   #   #   #     #           # # #       #   
### ### # # # ### ### ### # ### ### ########### # # # ####### # 
#   #   #   # #   # #     #     # #         # #     # #       # 
# ### ######### # # ##### ####### ######### # # ##### # ### # # 
#   #     #     #               #   #       # # #   # #   # # # 
### ####### ######### ##### ### # ### ####### # # # # ### # # # 
# #       # #   #     #   #   # #   # #   #     # # #   # # # # 
# ####### # # # ####### # ### # ### # # # ##### # ##### ### # ##
#       #   # #         #     #     #   # #   #       #   # #   
# ### # ### # ######### ########### ##### # # # ##### ### ##### 
# #   #     #     #   # #     #   #   #   # # # #   #   # #   # 
# # ############# # # ### ### # # # # # ### # ### # ### # # # # 
# #   #   #       # #     #   # #   #       # #   #   # #   #   
# ### # # # ####### ####### ######### ####### # ##### # ####### 
#   # # # #   #     #       #         #     #   #   #           
### # # # ### # ##### ######### ##### # ### ##### # ####### # ##
# # # # #   # #     #     #     # #   #   # #   # #       # #   
# # # # ##### ##### ####### ##### # # ### # # # # ####### # ### 
#   # #     #     # #     #     #   #   # # # #   #     # #   # 
### # ##### ##### # ### # ##### ### ### # # # ##### ##### ##### 
# # #     # #   # #   # #   #   # # #   # #   #       #   #     
# # ##### # # ### ### # ### # ### # # ### ########### # ### ### 
#       #   # #     # #   # # #   # #   #       #     #     #   
### # # ##### # ##### ### # # # ### ######### # # ### ####### ##
# # # # #     # #   # #   # # #   # #       # # #   #       #   
# # # ### ### # # # # # ### # ### # # ##### ### ### ####### ### 
#   #     #   #   # #   #     #     #     #     #   #           
