################################################################
#           #             #       #           #             #   
####### ### ############# # ####### # ### ### # ### ### ### # ##
#       # #   #     #   # #       # #   #   #   # #   # #   #   
# # ##### ### # ### # # # # ##### # ### ### # ### ### # # ##### 
# # #   #   #   # #   # # #     #   #   #   # #     # # #       
# ### # # # ##### ##### # ##### ##### ### ### # ### # # ########
#   # # # #   # #       #         #   #     # #   # # #   #     
### # # # ### # # ####### ####### # ##### # # ##### # ### # ### 
# # # # #   #   # #       #     # #   #   # #       #   # # #   
# # # # ### ##### # ##### # ### ##### # # # # ######### ### # # 
# # # # # # #   # #   #   #   # #     # # # #   #     #     # # 
# # # # # # # # # ##### ### ### # ##### # # ### # ### ####### # 
# # # # #     #         #   #   #   #   # # #   #   #   #     # 
# # # # ##### ########### ### ##### ### ### ### ### ### ########
#   # #     # #   #     # # #   # #   #   #   #   # # #         
##### ##### # # # # ### # # ### # ### ### ### ##### # ######### 
#   # #   # #   # #   #   # # # #   # #     #       #           
# # # ### # ##### ### ##### # # ### # # ########################
# # # #             # #   #   #   #   #             #   #       
# ### # ### ##### ### # ### ##### ##### ####### ##### # ### ### 
# #   #   # #           #   #   # #   #     #   #   # #   # #   
# # ### # ### ####### # # ### # # # # ### # # ### # ##### # # ##
# # # # #   #G  #   # # #   # #   # #   # # #     #   #   # #   
# # # # ### ### # # # # ### # ##### ### # # ######### # ### ####
#   #   #     #   # # # #   #   #   # # # #   #     #   # # #   
######### ######### # ### ##### # ### # ### # # # # ##### # # # 
#   #   #   #     # #   #     # # #   #   # #   # #     # #   # 
# # # # ### # ### # # # ##### # # # # ### # ##### # # ### ##### 
# # # #     #   # # # #     # # #   # #   # #     # #     #   # 
# # # # ####### # # # ##### # # ##### # ### # ##### # ##### # # 
# # # # #   #   # # # #   # # # #   # #   # #     # #     # # # 
### # # # # # ### # # # # # # # # ### ##### ##### # ####### # # 
#   # # # #   # #   #   # #   # #   # #     #     # #   #   #   
# ### # # ##### ############# # ### # # ##### ##### # # # ######
#   # # # #     #           # # #   #   #   # #       #   #     
### # ### ### ### ######### ### ### ####### # # # # ####### # ##
#   # #   #   #   #       #     #   #   #   # #S# # #   #   #   
# ### # ### ### ####### # ####### # ### # ### ### # # # # # ### 
#     # # # # # #     # #   #     #   # # #   #   #   #   #   # 
##### # # # # # # ### # ### # # ##### # # # ### ############# # 
#     # #   # #   #   # # #   #     #     #   #       #   #   # 
##### # # ### ##### ### # ############# ##### ####### # # # ### 
#   # # #     #   #   # #     #   #   #     #   #     # # #   # 
# # ### # ##### ##### # ##### ### # # ##### ### ######### ### # 
# # #   #       #   # #     # #   # #     # # # #       #   # # 
# # # ### ####### ### # ### # # ### ##### # # # # ##### ### # # 
# # # #   #     #   # # #   # #   # #         #   #     # #   # 
### # # ### ####### # # # ### ### # ####### ####### ##### ##### 
#   # # #         #   # #   # # # #     # # #     # #     #     
# ### # ######### ##### ### # # # ##### # # # ##### # ##### # # 
# #   #         #   #     #   #   #   # #   #     # #   #   # # 
# # ########### # # ##### ##### ### # # # ####### # ### # ### # 
#   #   #     #   #             #   #   # # #   #   #   # #   # 
##### ### ### ########### # ##### ####### # # ####### ##### ### 
#   # #   #   #     #     # #     #     # #         #       #   
# ### # ### ### ##### ##### # ##### ### # ### ### # ####### # ##
#   # #   #   #     # #     #       # # # #   #   #   #     # # 
### # ### ### ##### # # # ########### # # # # # ##### ### # # # 
# # #     # #     #   # # #   #     #   #   # # #   #     # #   
# # ####### ##### ####### # # ### ############# # # ####### ####
# # #                     # # #   #             # # # #     #   
# # # # # ####### ########### # ### ############### # # # # # # 
#     # #       #                 #                 #   # #   # 
