################################################################
   #       #             #       #   #               #         #
 # # ##### # ####### ##### ##### ### # # ########### # ### #####
 #       # # #   #   #     #   #     # # #         # # # #     #
###### # ### # ### ### ####### ######### # ##### ### # # ##### #
   #   # #       #   #   #               # #     #   #   #   # #
 # # # ### ##### ### ### ####### # ####### # ##### ##### # # # #
 #   # #   #   #   #   #     #   # #       #       #   # # # # #
 ##### # ### # ##### # ##### ##### # ################# # # ### #
   #   # #   # #     #     #     # # #       #   #     #   #   #
#### ### # ##### ### ########### ### # ####### # # ### ### # # #
 #   # # #   #   #   #   #       #   #   #     # #   #   # # # #
 # ### # ### # ##### # # # ####### ##### # ##### # # # ### # # #
 #     # # # # #     # # #   #         #   # #   # # # #   # # #
 ### ### # # # # # ### # ### # ####### ##### # ### # ### ### # #
 #   #   # # # # #   # #     #       #       #G#   #       # # #
 # ### ### # # ##### # ####### ##### ##### # # # ######### # # #
   # #     # #   #   #   #   # #   #     # #   #     #   # # # #
 ### ##### # ### # ##### # # # # # ##### # ######### # # ### ###
           #     #     # # #   # # #     #   #       # #   #   #
## ##### ####### ####### # ####### # ##### ### ####### ### # # #
   #   #     #   #   #   #     #   #     #   # #     # #   # # #
#### # # ### # ### # # ####### # ### ### # # # # ### # # ##### #
   # #   #   #   # # # #   #   # #   #  S# #   # # #   #     # #
 # # # ########### ### # # # ### # ### ### ##### # ######### # #
 #   # #     #     #   # # #   # # # # #     #             # # #
 ##### # ### # ##### ### # ### # # # # ##### # ########### # # #
 #     #   # # #     #   #     # #   # #     # #     #     # # #
 # ####### # # # ##### ######### ##### # ##### # ### ####### # #
 # #     # #   #   #   #       #       #     # #   #         # #
## # # ### ####### # ### ##### ######### ### # ############### #
   # #     #     # #   #   #   #         #   #     #           #
 ### ####### ### # # ##### # ### ####### # ####### ##### # #####
 # # #   # # # # # #     # # #   #       #     # #     # # #   #
 # # # # # # # # # # ##### # ######### # ##### # ##### ### # # #
   # # #   # # #   #     # #   #     # #   #   #     #     # # #
## # ##### # # ######### # ### ### # # ### # ####### ####### # #
   # #   # # #     #   # #   #   # #   #   #   # #   #     # # #
 ### # # # # ##### # # # ### ### # ##### ##### # # ### # ### # #
       # # #   #   # #   #   # # #   # # #   # # # #   # #   # #
 ####### # ### # ### ##### ### # ### # # # ### # # # ### # #####
 #     #     # # #       # #   # #   #   #     #   #   # #     #
 # ### ####### # # ### ### # # # # ##### ####### ##### # ##### #
 #   #               # #   # # # # # #     #           # #     #
 ### ############### ### ### # # # # # # # # # ### # ##### #####
   #     # #   #   # #   #   #   # #   # # # #   # #       #   #
 # ##### # # # # ### # ### ####### ##### # # ### # ########### #
 #     #   # # #     #   #   # #   #     #     # #   # #       #
 ##### # ### # ############# # # ### ######### # # # # # # #####
 #   # # #   # #       #     # # # # #       # # # #   # # #   #
 # # # # # ##### ##### # ##### # # # ####### ### # ##### # # # #
 # #   # #     # #   #   #   #   # #       #   # #       #   # #
 ##### # ##### # # ######### ##### ####### ### # # ########### #
 #   #       # # #                       #     # # #     # #   #
 # # ##### # # # ### ##### ##### ####### ####### # ##### # # ###
 # # #   # #   #   #   # # #   #   #     #     # #     #   #   #
 # ### # ### ##### ### # # # # ### # ### # # # # # ### # ##### #
 #     #     #   #   #   # # #   # #   #   # #   #   #   #     #
############ # # ### # ### # ### # ####### # ####### ##### #####
     #   #     #     # #   #   # # #     # # #   #     #   #   #
 ### # # # # ### ####### ##### # ### ### ### # # ####### ### # #
   #   #   #   # #     # #   # #   #   #     # #   #   #     # #
 # ########### ### ### # # # # ### ### ####### ### # # ####### #
 #           #     #   #   # #   #     #         #   #         #
