################################################################
################################################################
             #     #             #             #     #   #     #
 # ######### # # # # ####### ### # ########### # # # # # ##### #
 # #     # # # # # # #     #   # #   #       #   # #   #       #
 # # ### # # # # ### # # ##### ##### ####### ##### # ###########
 #   #   # #   # #     #     #     # #     #       #           #
 ######### # ##### ######### ##### # # ### ########### ####### #
 #     #   # #     #       # #   #   # #   #       #   # #   # #
 # ### # ### # ##### ##### ### # ##### # ##### # # # ### # # # #
 # #   #     #   #   #   # #   #   #   # #   # # # #   # # #   #
 # # ####### ### # ### ### # ##### # ##### # ### # ### # # ### #
 # # #           # # #   # # #     # # #   #   # #     #  S#   #
## # ######### ### # ### # # # ##### # # ##### ############# # #
   #           #   #     #   #   #   # # #   #           # # # #
 ############# # ### ######### # # ### # ### ########### # # # #
     #     #   #     #       # # #     #   #         # # # # # #
 ##### ### ### ##### # ##### ### ##### ### ### ##### # # # # # #
 #     #     # #     # #           #   # # #   #   # # # # # # #
 # ######### # # ##### ############# ### # # ### # # # # # # # #
 #   #   #     # #   #       #     # #   # #   # # #   # #   # #
 ##### # ##### # # ######### # ### # # # # ### # # ##### ##### #
 # #   #     #           #   # #   #   # #     # #       #     #
 # # ####### # ########### ### # ####### ##### ########### ### #
 # #     #   #   #       # #   # #   #   #   #   #         #   #
 # ##### ####### # ##### ### ### # # # ### # ### ##### ### #####
 # #   #   #     #     #   # # #   # # #   # # #     # #   #   #
 # # # ### # # ####### ### # # ##### # # ### # ##### # # ### # #
 #   # # # # #       # #   # # #     #   #   #     # # #   # # #
 ##### # # ### ####### ##### # # ######### ####### # # ### ### #
         #   # #   #   #   # #   # #     #         # #   #     #
#### ####### # # # # ### # # ##### # ####### ####### # #########
   #   #   # #   # #   # # #   #             #       # #   #   #
 # ##### # # ##### ### # # ### ### ####### ### ####### # # # # #
 #   #   #   #       #   # # #     #     #   #  G#     # #   # #
 ### # ####### ##### ##### # ##### # ### # ##### ####### ##### #
 # # #         #         #         #   #   #   #         #   # #
 # # ### ####### ### ### ##### ########### # ############# # # #
 # # #   #     # #   # #       #     #                     # # #
 # # ##### ### # # ### ####### # ### # ########### ### # ### # #
   #     # #   # # #           #   # #   #         #   #   # # #
######## # # ##### ##### # # # ### ##### # ######### # ##### # #
       #   # #   # #   # # # #   #       # #         # #     # #
 # ######### # # # # # ### # ### ######### # ### ####### ### # #
 #     # #   # #   # #     # # #   #   #   #   # #       #   # #
 ##### # # ### ##### ####### # ##### # # ##### # # ####### ### #
     #   #     #     # #       #     # # #   # # #   #   # # # #
#### ############# # # # ### ### ##### ### # # ##### # # # # # #
     #             # # # #   # # #   # #   # # #     # #     # #
 ##### ############# # # # # # # ### # # ### # # ########### # #
 # #     #           #   # # # #     # #   #   #     #   #   # #
 # # # # # ############# # ### ##### # ############### # # ### #
 #   # # #     #   #   # #     #   # #     #   #     # # #   # #
 ##### # ##### # # # ### ####### # # ##### # # # ### # # # # # #
     # #     #   # #         # # # # #   #   # # #   # # # # # #
#### # ### ####### ##### # # # # # # ### ##### ### ### # # # # #
   # # #   #     #     # # #   # # #         #   # # # # # # # #
 # # # # ### ### ##### # ####### # ######### ### # # # # # ### #
 #   # #   #   #   #   #   #   # #     #   #   #   #   #   #   #
 ######### ### ##### ### # # # # ##### # # ### ########### # ###
         #   # #   #   # #   # # # #   # # # # #       #   # # #
######## ### # # # ### # ##### # # # ### # # # ### ### # # # # #
             #   #     #     #     #     #   #     #     #     #
################################################################
