################################################################
               #         #                 #           #   #   #
 ##### ####### # # # ### # ################# ##### # # ### # # #
 #     #         # # # #   #         #     #   # # # # #   # # #
 # # ####### ##### # # ### # ####### # ### ### # # ### # ### # #
 # # #     # #   # # #   # # #       #   # #     #   #     # # #
## # # ### ### # ### ### # # ############# # ####### ####### # #
   # # #   #   #   #   #               #   # #       #     # # #
 ##### # ### ##### ### # ############# # ### ######### ### ### #
       #   # #         # #         #               # # #   #   #
 ########### ######### ### ####### # # ########### # # # ### ###
   #       #         # #   #     #   #   #   #     # # #     # #
## # ##### ######### ### ### ############# # # ### # # ####### #
   # #   #         #   #   #       #       #     #   #       # #
 # # ### ######### ### ### ####### # ####### ### ########### # #
 # #   # #       # #     #   #     #       #   #       #     # #
 # ### # # ####### # ####### # ############# # ##### # # ##### #
 #   #   # #   #   #       #   #     #     # # #     # #   #   #
 ### ##### # # # ######### ##### ### # ### # # ####### ### # ###
 #       # # # #       #   #   #   # # #   # # #   #     # #   #
 ######### # ######### # ### # ### # # # ### # # # # ##### ### #
           #       # #   # # #     # # # #   #   # #   #   #   #
 ################# # ##### # ######### # # ####### ##### ### # #
     #     #     # #   #     #         # #       #     # #   # #
 # ### ### ##### # # # # ##### ######### ####### ##### # ##### #
 #   #   #     #     # # #     #       #   #     #   # #   #   #
#### ######### # ####### # ##### ##### ### # ##### # # ### # # #
     #   #   # #         # #     #   #   # # # #   # #     # # #
 ##### # # # # # ######### # ##### ##### # # # # # # ######### #
       #   #   #   #     # # #   #   # # # # #   # #         # #
 ########### ##### # ### # # # # # # # # # # ##### ######### # #
 # #       # #     # # # # # # # # # # # # #       #   #     # #
 # # ##### # # ##### # # # # # # # # # # # ######### # ### ### #
   # # #   #   #       #   # # #   #   # # #         #   #     #
#### # # ####### ########### # ######### # # ########### ##### #
   # # # #   #   #   #     # #     #   #   #   #   #   #   # # #
 # # # # # # # ### # # ##### ##### ### ####### # # # # ### # # #
 # # #   # #   # # # #     # #   #   # #   # # # #   # #   # # #
 # # ##### ##### # # ##### # # # ### # # # # # # ####### ### # #
 #   #     # #     #     #   # #   # #   #   #   #     # #   # #
 ##### ##### # # ##### ########### # ##### ####### ### # # # # #
 #       #     # #   #             #     # #     # #   # # # # #
 ####### # ##### # # ########### ####### # # ### # # ### ### # #
     #         #   # #         #     #       #   # # #   #   # #
#### ### ##### # ##### ####### # ### # ####### ### # # ### ### #
   #   #   #   # #     #       #   #   #   #   #   #   #       #
 # ### # # ####### ############### # ### # ##### ####### #######
 #   # # # #     # # #       #     # #   #       # #     #     #
 ##### # ### ### # # # ##### # # ##### ########### # ##### #####
       #   # #   # # #   #S  # # #   # #                       #
 ####### # ### ### # ### ##### # # # # # ##### ### # ######### #
 #       #     #       # #   # # # #   #   # # # # #     #   # #
 ####### ####### ####### # # # # # ####### # # # # ### # # # # #
 #   #   #     #   #   # # # # # #     #     # # # #   #   # # #
 # # # ### ### # ### # # # # ### ##### # ##### # # # # ####### #
 # # #   #   # # #   #   # #   # #     #   #   #   # # #   #   #
 # # # ##### # # # ####### ### # # ##### # # ####### ### # # ###
   # # #     #   #       #   #G#       # # # #     # #   # # # #
#### # # ############# ##### # ####### # # # # # # # # ### # # #
     #   #   #   #   # #   # #   #     # # # # # # #     # # # #
 ####### # ### # # ### # ### ### # ##### # # ### # ####### # # #
 #     #   #   # # #   #     # # # #     # #   # #         # # #
 # ### ### # ##### # ######### # # # ##### ### # ########### # #
   #                             #   #     #   #           #   #
