################################################################
#       #       #       #   #             #       #           # 
# ##### # ##### # # ### ### # ######### ### ### ### ######### # 
# #   #       #   #   #   #   #       #     #   #   #       # # 
# # # ### ### # ##### ### ### # ##### # ####### # ### # ##### # 
# # # #   # # #     #   #     #   #   #   #   # #   # #       # 
# # ### # # # # ### ### ######### # ####### # # ##### ######### 
# #   # #   # # #     #           #         # # #     #   #   # 
# ### # ##### # ############################# # # ####### # # # 
#   #   #     #           #     #           # # #   #     # #   
### ### # ############# # # ### # ######### # # ### # ##### ####
# # #   # # #     #     # # # #   #   #   # # #   # #       #   
# # ### # # # ### # ##### # # ##### # # # # # ##### ### ##### # 
# #   # # #   #   # #   # #   #     #   #   #     #   #     # # 
# ### # # # ####### # # # ##### ################# ### # ### # # 
#     # # #         # #   #     #   #           #     #   #   # 
### ##### ########### ##### ##### # ### ### ### ####### # ######
#   #   #S#       #   #     #   # #   # #   # # #       # #     
# ### # # # ##### # # # ##### # ##### ### ### # ##### ### # ### 
# #   #   #   #     # # #     #   # #     #   #     # # #   #   
# # ######### ####### # # ####### # ####### ####### # # ##### ##
# #         #   #   # #   #     # #     #   #     # #     # #   
# ######### ### # # # ######### # # ##### ##### ### ##### # ####
#         #   #   # #           # #   #   #     #   #   #       
# ########### ### # ####### ### # ### # ### ### # ### # ####### 
# #   #     #   # #       #   # # # # #   # # # #   # # #   #   
### # # ####### ####### ##### # # # # ### # # # ### # # ### # ##
#   #   #     # #     #     # # # #     #   # #   #   #   #   # 
# ####### ### # # ####### # # ### ##### ##### ### ####### # ### 
#         # # # # #     # # #     #   #           # #     #   # 
########### # # # # ### # # ####### # ### ##### ### # ####### # 
#       #   # # #   # # # #   #   # #     #   #               # 
# ### ### # # # ##### # # ### # # # ####### # ##### ### ####### 
# # # #   # #   #   #   #   #   # # #     # #     #   #     #   
# # # # ######### # # ##### # ### ### ### ####### # # ### # ### 
#   # #         # # # #     #   #   # # #       # # #   # #     
# ### ######### # ### # # ### # ### # # ##### ### # ### # ######
# #                 # # #   # #   # # # #   # #   #   # # #     
### ##### ####### # # ##### # ### # # # # # # # ##### # ### ### 
#   # #   #     # # #     # #   # #   # # # #   #     # #   # # 
# ### # # # ### # ####### # # # ####### # ####### ####### ### # 
# #   # # # #   #     # # # # #                         #     # 
# # ### # # ######### # # # # ####### # ### ########### ####### 
# # #   # #     #   #   # # #   #     #   # # #           #     
# # # ######### # # ### # # ##### ####### # # # # ######### ####
#   # # #       # #     # # #     #     # #   # # #         #   
##### # # ############# # # # ######### # ### # # # ######### # 
#     # # #             #   # #     #   #   # # # # #   # #   # 
# ##### # # # ######### ##### # ### # ##### ### # # # # # # ### 
# #   # # # #       #     # #   # #   #     #   # # # #       # 
# # # # # # ####### ##### # ##### ##### ##### ### # ######### ##
# # #   # #       #   #   #   #     #   #     #   #         #   
# # ##### ##### ##### # ### # # ##### ### # # ### ######### ### 
#       #     # #     #     # # #     #   # #   #     # #   #   
# ##### ##### # # ########### # # ##### # # ### # ### # # ### # 
# #   # #     # # # #         #   #     # # #   #   #   #     # 
# # # ### ####### # # ############# ##### # # ##### # ######### 
# # #     #       # #     #       # #   # # # #     # #       # 
# # ########### ### ##### # ####### # # # # # ### ##### # ### # 
# #       #     #   # #   #   #     # # # # #   # #     #   # # 
######### # ##### ### # ##### # ### # ### # ### ### ####### ### 
#G        #   #   #   #     #   #   #   # #   #     #     #     
# ########### # ### # ##### ####### ### # # ############# ######
#             #     #                 #   #                     
