################################################################
################################################################
 #   #   #       #   #                 #   # #       #   #     #
 # ### # ##### # # ### ### ### # ##### # # # # ##### # # # ### #
 # #   # #   # # #     #   #   # # #   # #   #   #   # #   # # #
 # # ### # # ### ####### # # ### # # ##### ##### ##### ##### # #
 #   #   # #             # #   #   #       #   #     # #       #
 ##### ### ### # ### ################# ##### # ##### # ####### #
 # #   #   #   # # #     #     #   #   #     # #     #       # #
 # # ### ##### # # ##### # ### # # # ### ####### ########### # #
   #     #   # # # #     #   # # #   #   #   #   #       #   # #
## ####### # # # # # ######### ##### # ##### # ####### # ##### #
   #       #   #   #   #     # #   # #     # #         # #   # #
 # # # ####### ####### # ### # # # # ##### # ##### ##### # # # #
 #   # # #       #   # # #   # # # #     #         #   #   #   #
 ##### # # # ##### ### # # ### # # ### # ####### ### # ####### #
     # #   # #   #     # # #     #     #   #   # #   #     #   #
 ### # ####### # ####### # ####### ####### # # # # ####### # # #
   # #         # #   #   #   #     #     #   #   #     # # # # #
#### ########### ### # ##### ####### ### ##### ####### # # # # #
             # #     # #     #       #   #     #     #S# # # # #
 ######### # # ####### # ##### ####### ######### ### # # # ### #
 #   #   # #   #   #   # #   #   #   #           # #   # #   # #
 # # # # ####### # # ### # ##### # # ############# ##### ### # #
   #   # #       # # # #   #     # #             #     #   # # #
 ####### # ####### # # ##### ########### ##### # # # ### # # # #
       #   #     # # #     #   #       # #   # # # #     # # # #
## # ####### ##### # # ### ### # ##### # # # # ### ####### # # #
 # #     #   #     #   # #     #     #   # # #       #     # # #
 # ### ### ### ######### ################# # ####### ####### # #
   #   #     #       # # #     #           #       # #     #   #
#### ### ########### # # # ##### ################# # # ### ### #
         #       #   #   # #   #       #       #   # #   # # # #
 # # ##### ##### # ##### # # # ####### # ####### ### ### # # # #
 # # # #   #   # #     # # # # #   #   #         # #   # # # # #
 # # # # ### ### ##### # # # ### # # ##### ####### # # ### # # #
 # #   # # #     #     # # #     # # #   #     #     #       # #
 ####### # ####### ##### # ####### ### # ##### ### ########### #
 #     # #   #     # #           #   # #     #   #             #
 # # # # # # ### ### # ############# ####### ### # ##### ##### #
 # # # #   #     #       #         # #       #   #     # #   # #
 # # # ########### ####### ##### ### # ####### ### ### # # # ###
   # # #     #     #     #     #     # #         # #   #G# #   #
 ### # # ### # # ### ### ##### ####### # ##### # # # ##### ### #
   # # #   #   # #   #   #     #   #   #     # #   # #     #   #
 ### ### ######### ### ### ##### # # ##### ### ##### # ##### # #
   #     #         #   #   # #   #   #     #   #   #   #     # #
 # ####### ######### ### ### # ####### ##### ### # ########### #
 #   #   #   #     # # # #   # #     #     #   # #       #   # #
#### # # ### # ### # # # # # # ##### ##### ### # ####### # ### #
   # # #   # # # # # # # # #       #   #   #   #   # #   # #   #
 # # # ### # # # # # # # ######### ### # ### ##### # # ### # # #
 #   # #   # # # # # #     #     #         #     # # # # #   # #
 ### # # ### # # # # ##### # ### # ####### ####### # # # ##### #
 # # # # #   #   # # #   #   # # # #   #   #       # # # #     #
 # # # ### ##### ### # # ##### # # # # ##### ####### # # # ### #
 #   #   #       #   # #   #       # #     #     #   # #   #   #
 ####### ####### # ### ### # ####### ##### ##### # ### ### # ###
 #     #   # #   #   # # # #   #     #   #     # # #   # # # # #
 # # ##### # # ####### # # ### # ##### ##### # # # # ### # # # #
 # # #     # # #       # # #   # #   #     # # # # #   #   # # #
 # # # ##### # ##### ### # # # # # # # ### # ### # ### ### # # #
   #         #       #       #     #   #   #     #     #   #   #
################################################################
