################################################################
################################################################
# #       #             #         #     #     #             #   
# # ####### ####### ### # ####### # ### ### ### ####### ##### # 
# # #     # #     # # # # #   #   #   #   #   #     # #   #   # 
# # ### # # # ### # # # # ### # ######### # # ##### # ### # ### 
# #     #     #   # #   #     #       #   # #     # # #   #   # 
# ### ######### ### ########### ##### # ### ##### # # # ### ### 
#   # #   #     #   #     #   # #   #           # # # #     #   
# ### # # ##### ##### ### # # # # # ####### # # ### # ####### ##
#     # #     #   #     # # #     #   #  S# # #   #   #   # #   
####### ##### ### # ### ### ######### # ### # ### ### # # # ### 
#       #   #   #   #   #   #         #     #   #   #   #   #   
# ####### ##### ##### # # ### ############### # ### ##### ### ##
# #     #     #       # # # # #   #     #     # # #   #   #   # 
# # ######### # ####### # # # # ### ### ### # # # ### # ### ### 
# #         #   #       #   # #     #   #   # # # #   # # # #   
# ######### ### # ##### ##### ####### ### ### # # # ### # # # ##
#   #     #   # #   #   #   #   #     #     # #   #       # #   
# # # ### # # # ### # ### # ### # ####### # # ############# ### 
# #   #   # #     # #     #   #   #       # #   #   #   #     # 
# ##### ### ####### ######### ####### ##### # # ### # ### ##### 
#   #   #   #     #   #   #   #       #     # #     # #   #     
##### ##### # ### ### ### # ####### # # ### # ### ### # ### ####
#     #   # #   #     #   # #       # # #   #   #     #   #   # 
# ####### ############# ### # ####### # # ##### ##### ### ### # 
#   #   #   #     #     # #   #       # # #   # #   #   #     # 
# # # # ### # ### ##### # ##### # ##### ### # # # ### # ####### 
# #   #     #   #     #         #     #     # # #   # # #       
# ########### ####### ####### # ##### ######### ### # # ####### 
#       #     #   #   #   #   #     #     #     # #   #         
# # ### # ##### ### ### ### # ### # ####### ##### ##### ########
# #   # #     #   #   #     #   # #   #     #   #       #     # 
##### # ##### ### ### ### ####### ### # ##### # ##### # ##### # 
#     # #   #   # #   #   #       #   # #   # #     # #     # # 
# ##### # # ### # # ### # # ####### ### # # # ##### ### # ### # 
# #       # # # #   #   # # #         #   #   #   #   # # #   # 
# ####### # # # ####### # # ### ##### ######### # ### # # # ### 
#   #   # # # # #     # # #   # #     #     #   #   # # #   #   
# # # # ### # # ##### # # ### # # # ### # # # ##### # # ####### 
# #   #   #   #    G# # # # # # # # #   # # # #   #   #         
# ####### ######### # # # # # ### ### ### ### # # ##### ########
# #       #         #   #   #   # #   #   #   # #               
# # ##### # ################### # # ### ### ######### # ####### 
# # #     #   #     #           #   # #   # #   #   # #     #   
### # ####### # ### # ########### ### ##### ### # # # ##### # ##
#   # #   #   #   #   #   #           #     #   # #     #   #   
# ### # # # ############# # ##### ##### ##### ### ### # # ##### 
# #     # #             #   #     #   #     #     #   # #   #   
# # # ### ############# ##### ##### # ##### ######### # ##### # 
# # # #       #         #   #       #     #   #       #   #   # 
# ### # ##### # ######### # ############# ### # ####### # # ### 
#   # #   #   #   #       # #             #   # #       # #   # 
### # ### ####### ##### # # ############### ##### ####### ### ##
#   #   #       #   #   # #       #         #   #   #     # #   
# ####### ##### ### # ### ####### # ######### # ### ##### # ### 
# #     # #   # # # #   #     # #   #       # #   #     # # #   
# ##### # ### # # # ######### # ##### ### # # ### ### # # # # ##
#     # #     #   # #         #     #   # #   #     # # #   #   
# ### # ####### ### # ######### ### ### # ######### ### ####### 
# #   #       # #   # #     #     #   # #   #   # #   #       # 
# # ######### # # ### # ### ### # ### # ### # # # ### ######### 
# #           # #     #   #     #   #     #   #   #             
################################################################
