################################################################
       # #       #           #       #         #     #   #     #
###### # # ##### # ######### ####### # ####### # ### # ### ### #
     # # #   # # # #         #       # # #       #   # #   #   #
 ### # # ### # # # ##### ##### ####### # # ##### ##### # #######
 # # #     # #   #     #     #     #   #   #     #     # #     #
 # # # ##### ### ##### ##### ##### # ##### # ### # ##### ### # #
 #   # #   #   #     # #   #       # #   # # # # #     #     # #
 ##### # # ### ##### # # # ####### # ### # # # # ##### ####### #
   #   # #   # #     # # # #   #   #     # #   #               #
## # ### # ### # ##### ### # # # ######### ##### ########### ###
 # #   # #   # # #   #     # # #               # #         #   #
 # ### # ### # # ### ####### # ### ########### # # ####### ### #
 #     #   # # #       #     #     #   #       # #       #   # #
 ##### ### # # ####### # ### # # ### # # ####### ####### ### # #
 #     # # # # #     #   #   # # #   # #   #   #   #   # #   # #
 # ##### # ### ##### ##### ### ### ### ##### # # # # # ### ### #
 #           #     #   # #   #   #   # #     #   # # #     #   #
 ####### ### ##### ### # ### ### ### # # ######### # ####### ###
         #       # #   # #     # #   #   #       # #       #   #
## # ##### ##### # # ### # ##### # ####### ##### ######### # # #
   # #     # #   #   # # # #     #   #     #   # #   #   # # # #
 ### # ##### # ####### # # # ####### # ##### # # # # ### # # # #
 # # #   # #   #   #   #   #       #   #   # # # # #   # # # # #
 # # ### # # ### # # ##### ####### ####### # # # # ### # # # # #
   #   # # #   # # #     #     # # #     #   # # # # #   # # # #
 ####### # ### # # ##### # # # # # ##### # ##### # # ##### ### #
 # #     # #   # # #   #   # #   #     # # #     #   #   # #   #
 # # ##### # ### ### # ##### ####### # # # # ####### # # # # ###
   #     #     # #   #         #   # # #   #         # # #   # #
######## ##### # # ##### ### # # ### ##### ########### ####### #
   #   #   #   #   #     #   # # #   #   # #           #       #
 # # # ### # ####### ##### # # # # ### # # # ####### # # ##### #
 # # # # # #   #     #     # #   #     # # #       # #   #     #
 # # # # # ### # ##### ##### ########### # # ##### ####### #####
 #   #   #   #   #   #     #       #   #   # #   #   #   # #   #
 ########### ##### ### ### ##### ### # ##### # # ### # # ### # #
           # #   #   # #       # #   # #       #   #   #   # # #
########## # # ##### ### ##### # # ### # # ### # ######### ### #
     #   #   # #   #   # #   # # #   #   #   # #       #   #   #
#### # # ##### # ##### # # # # # ### ####### # ######### ### ###
   # # #       # #     #   # # #     #     # # #       # #   # #
 # # # ### ### # # ######### # ########### # ### ##### # # ### #
 # # #   #   #   #   #       # #         # #     #   # #   #   #
 # # ### ### ####### # ####### # ####### # ####### # # # ### ###
 #     #   #         # #         #   # # # # #     # # #   #   #
 # ### ### ########### # ##### ### # # # # # # ##### # ### # # #
 # #     #   #         # #   #     # # #   #   #   # #   #   # #
 ### # ##### # # ####### ### # ##### # ##### ### # ##### #######
 #   # #     # #   #   #   # #     # # # #       # #   #      G#
## ### # ######### # # # # # # # ### # # # ##### ### # ####### #
   #   #   #     # # # # # #   #   # # #   #   # #   #   #     #
 ### ##### # ### # # # # # ####### # # # ### # ### ##### # ### #
   #   # #   # #   # #   # #   #   #   # #   # #   #   # #   # #
## ### # ##### ##### ##### ### # ####### # ### # ### # # ### # #
   #   #             #   #   # #         # # # # #   # #     # #
 ### ##### ##### # # # # ### # ##### # ### # # # # ### ####### #
   # #     #     # #   # #   #       # #   # # #     #     #   #
 # # ####### ##### ##### # ########### # ### # ########### #####
 # # #     #     # #     #S  #     #     # # # #         # #   #
 # # # ### ####### # ####### # ### # # ### # # # ####### # # # #
 # #   # # #     # # # #   #     # # #   # #   #     # # #   # #
 # ##### # # ### # # # # ######### # ### # ######### # # ##### #
 #       #   #     #   #           #   #           #   #       #
