################################################################
################################################################
   #           #   #     #   #   #         #     #   #   #     #
 # # ######### # # # ### # # ### # ####### # ### # # # ### ### #
 #   # #     #G# # # #   # #     # #       #   # # # # #   #   #
###### # ##### # ### # ### ####### # ##### ### ### # # # ### ###
     #         #     #   # #       # #   #   #   # #   #   # # #
 ### ######### ######### # ### ##### # # ### ### # ####### # # #
   #     #   # #         #   #   #   # #         #         #   #
## ##### # # # # ####### ### ### ##### ######### ### ####### ###
 # #   #   # #   #         #   # #     #     #   #   #     #   #
 # ### ##### ##### ##### ##### # # ##### ##### # ### # ### # # #
 #   # #   #       #   # #   #   #   #   #   # # #   # # # # # #
 ### # # ########### # # # ##### ### # ### # # # # # # # # # ###
   # # # #   #     # #   #         #     # #   #   # # #   #   #
## # # # # # # ##### ######### ### ####### ##### ##### # ##### #
   #   #   #       #           #     #     #     #     # #     #
 # ##### ######### ####### ##### ##### ##### ##### ##### # ### #
 # #     #   #             #   # #     # #   #   #   #   # #   #
## # # ### # ####### ####### # # # ##### # # # # ### # ### # ###
   # # #   #         #     # #   # #       #   #   # #   # #   #
 ### ### ########### # ### # ##### # ########### ### ### ##### #
   #   # # #   #   # #   # # #     #   #       # #   # # #     #
## ### # # # # # # # ### ### # ####### # ##### ### ### # # #####
   #   # #   # # # #   #     #   #     #   #   #   #   #       #
 ### # # ##### # ##### ######### ######### # # # ### # # ##### #
 #   # # # #   #   #   #   #     #   #     # # # #   #   #   # #
 ####### # # ##### # ### # # ##### # # ##### # # ####### # # ###
         #     # # # #   # #       #   #     # #   #     # #   #
############## # # # # ### ############# ### ##### # ### # ### #
     #       #   # #   #   #   # #       #   #     #   # # # # #
 ### # ##### # ### # ### # # # # # ####### ### ### ### ### # # #
 # #S  #       #   #   # #   #   #   #       #   #   # #   #   #
 # ##### ####### ####### # ######### # # ####### ##### # #######
   #   # #     #         #   #   # # # #   #   #     #   #     #
#### ### # ### ########### # # # # # ####### # ##### ##### # ###
     #   # # #     #       #   # # #         #     #       #   #
 ##### ### # ##### # ##### ##### # ############### # ##### ### #
   # # #   #   # # # #         #             #   # # #     #   #
## # # # ##### # # # # ##### ########### ### # ### # # #########
     # #     # # #   # #   # #         #   #   #   # # #       #
 ##### ### ### # ####### ### # ####### ### ##### # # # # ##### #
 #   #   #   # #     #   #   # # #   #   # #   # # # #   #     #
 # # ### ### # ### # # ### ### # # # ### # # # # # # ### ##### #
   #     #   #   # # #   # #   #   # #   #   # # # #   # #   # #
 ######### # ### # # ### # # # ##### # ### ##### # ### ### # # #
 #       # # #   # # #   # # # #     # # #   #   #   #     # # #
 ##### # # ### ### # # ### # # # ##### # ### # ############# # #
     # # #   # #   # #     # # #     # #     # #   #         # #
#### ### ### # ##### ##### # # ##### # ### ### # # # ######### #
   # #   # # # #     #     # # #   # #   # #   # # #   #       #
 # # # # # # # # ##### # # # ### # # ### ### # # # ### ### ### #
 # # # #   #   #       # # #     #   #   #   # # #     #   #   #
 ### # # ############### # ########### ### ##### ####### # # ###
       # #     #         #           # #   #     #       # #   #
## ##### # ##### ################### # ### # ################# #
   #   # #       #                   #     # #         #   #   #
#### # # ############# # # ######### ####### # ####### # # # # #
     #     #           # # #       # #     # # #   # #   #   # #
 ####### # ### ######### # # ##### ### ### # # # # # ######### #
 #   #   #   # #   #   # # #     # #   # #   # # # #         # #
 ### # ##### ### # # # # # ##### ### ### ##### ### ######### # #
     #     #     #   #   #     #     #             #           #
################################################################
