################################################################
################################################################
#   #                 #       #     #                     #   # 
# # ### ######### ### ####### # ### ##### ### # # ### ### ### # 
# #     #       #   #   #   # #   #       #   # # # #   #   #   
# ##### # ##### ### ### # # # ### # ####### # # # # ### ### ### 
#   #   #     #   #   # # # #   # # #   # # # # #   #   #   #   
# ### # ##### ### ##### # # ### # # # # # # # # ##### ### ##### 
# #   #     #   #   #   # #     # # # # #   # # #   #   #       
# # ####### ### ### # ### ####### ### # ### # # # ##### ####### 
# #   #   #   # #   # #   #     #   # #   # # #   #     #       
# ### # ##### # # ### # ### ### # # # ### ### ##### ##### ##### 
# #   #       # #   # # #   #   # #   #   #   #   # #   # #     
# # ####### ### ### # # # ### ### ##### ### # # # # ### # ### ##
# # #     #   # #   #   # #     # #   # #   #   # #   # #   #   
# # # ### ### # ######### ##### ### # # ### # ####### # ### ### 
# # #   # # #G#         #   # #   # #   #   # #     # # #   #   
# # ##### # # ######### ### # ### # ##### ### # ### # # # ### ##
# #   #   # # # #   # # #   #   #   #     #   # #   # # # # # # 
##### # ### # # # # # # # ##### ##### # ### # # ##### # # # # # 
#   #   #       # #   # #   #         # #   # #       # #   #   
# # ########### # ##### ### # # # ### # ############### ####### 
# #           #     # #     # # #   # #                     #   
# ########### ##### # ######### ### ######################### # 
# #   #     #   #   #     #       #           #   #           # 
# # ### # # ### # ### ### # ### # ##### # ##### # # ########### 
# #     # #   # #     #     #   # # #   #   #   # #   #   #   # 
# ####### ### # ##### ########### # # ##### # ### # # # # # # # 
# #       # # #   # # #   #   #     #     # # # # # #   # # #   
# # ####### # ### # # # # # # ### ####### ### # # # ##### # ####
# #     #   #   # #   # #   #   #   #   #   # #   # #   # #     
# ##### ### ### # ##### ####### # # # # ### # ####### # # ##### 
#     #   #     # #           # # #   # # # # #       # #   # # 
##### # # # ##### # ##### ##### # ##### # # # # ####### # # # # 
#     # # # # #   # #   # #     #     #   # # # #       # # #   
# ####### # # # ### # # ### ##### ######### # # # ######### # ##
#         #   #     # #     #   #     #   # # # # #       # #   
############# ####### ######### # ### # # # # # # # ##### # ### 
# #       # #       #     #     #   # # # # # # # #   #   #   # 
# # ##### # ####### ##### # ####### # # # # # ### ### # ####### 
# #   # # #   #   #   # # # #     # # # # # # #   # # # #       
# ### # # ### # ##### # # # ### # ### # ### # # ### # # ####### 
#   # # #   # # #   #   #   #   #   # #   # # #   #   # #     # 
# ### # ### # # # # ### ##### ##### # ### # # ### ##### # ### # 
#   #   #   #   # # # # #   # #   # #   #   #   # #   #   #   # 
# # ##### ### ### # # # # # # # ### ########### # ### ##### ### 
# #   # #   #     #   #   #   # #   #           # #     #   #   
# ### # ### # ##### ########### # ### ########### # ##### ### # 
#   #   #   #     # #           # # # #           # #     #   # 
### ##### # # ### # # ##### ##### # # ### ##### ### # ##### ### 
# #   #   #   # # # # #   # #     # # #   #   #       #     #   
# ### # # ##### # ### # # # # ##### # # ### # # ####### # ### # 
#   #   #       # #   # # #   #   #       # # #       # # #   # 
### ##### # ##### # ##### ##### # # ##### # # # # ##### # # ####
#     #   #     #   #     #   # # #     # # #S# #       # #     
# ### # ####### ##### ##### # ### # ### ### # ##### ##### ##### 
# # # #       #     #   #   #     #   #     #     #     #     # 
# # # ##### ##### # ### # ########### ########### ########### # 
#   #       #     #     #   #   #   #   #   #   #   #   #     # 
# ########### ##### ####### ### ### # # # # # # ### # # # ######
# #       #   #           # #   #   # #   #   # #   # # # #     
# # ##### # ####### ### # # # ### ### ######### # ##### # # ### 
# #     #   #       #   #             #         #       #   #   
################################################################
