################################################################
################################################################
#   #   #   #     #   #       #   #               #     #   #   
# # ### # ### ### # ### ##### ### # # ######### # # # # # ### # 
# #   #         #   #   #   #       # #     #   # # # #   #   # 
# ### ######### ##### ### # ######### # ### # ##### # ##### ####
# # #       # #   #   # # # #       #   #   #       # #  S#     
# # # ##### # # ### ### # # # ##### # ### ### ####### # # ##### 
# # #   #   #   #   #     # # # #   #   #   #       #   #     # 
# # ##### ### ### ### ##### # # # ####### # ##### # ##### ### # 
# #       #       #   #     #   # #     # #     # # #     #   # 
# ######### ####### ########### # ### # ##### # # ### ##### ### 
# #       #   #     #           # #   #     # # # #   #   #   # 
# # ##### ### ### ### ########### # ####### ### # # ### # ##### 
# #     # #       #   #         # #   #   #     # #     #   #   
# ####### # ####### ### ######### # # # # ######### ####### # ##
# #             #   #           # # #   #     #   #       # #   
# ### ##### ### # ############# # # ######### # # # # # ### ### 
#   #     #   # #   #   #       # # #       #   # # # #   #   # 
### # ### ### ##### # # ### ##### ### ##### # ### # # ### ### # 
# # # # #   #       # #   # #   # #   # #   # #   # #   #   #   
# # # # ### ######### ### # # # # # ### # ### # ### ### ### ####
#   # #     #   #       # #   # #   #   # # # # # #   #   #   # 
# ### ####### # ####### # ##### ##### ### # # # # ### # # ### # 
#     #       # #     # # #         #     # # # # #   # # #   # 
# ##### ####### # ### # # # ####### ####### # # # # ### ### # # 
# #   # #   # # #   #   #   #     #       #   # #   #   #   # # 
# # # # # # # # # ############# ######### ##### ##### ### ### # 
# # # # # #   # # #   #   #     #   #   # #     #   #   # #   # 
# # # # # ##### ### # # # ##### # # ### # # ##### # ### # ##### 
# # #   #     #     # # #   #   # # #   #   #     #     # #   # 
# # ######### ####### # ### # ### ### # ##### ######### # # # # 
# #         # #       # #   #   #     #           #   # #   # # 
# ######### # # ####### # ##### ############# ### # # # ##### # 
# #         # #   #   # # #   #   #         #   # # #   #   # # 
# # ######### ### # # # # # # ### # ####### ### # ##### # # # # 
# #             # # # # # # #   #   #   # #     # #   #   # #   
# ############# ### # ### ##### ##### # # ##### # # # # ### ####
# #   #   #   #   # #   #   # #       # #   #   # # # # #   #   
# # # ### # # ### # ### ### # ######### # # # # # # # # # ### # 
# # #G    # #   # #   #   # #             #   # # # # # #   # # 
# # ####### ### # ### # ### # # # ### ######### # # # ##### # # 
# # #         # # #   #     # # # # #   #   #   #   # #   #   # 
# # ######### # # # ########### # # ##### # # # ##### # # ##### 
# #           #   # # #     #   #   #     #   #   #   # # #     
# ##### ######### # # # ### # ####### ######### ### ### # # ####
#   #   #   #   # # # # #   #       # # #     # #   #   # #     
# # # # # # # # # # # # ####### ### # # # ### # # ### ### ##### 
# #   # # #   # # # # #     #   #   # # # # #   # #   #         
# ####### ##### # # # ##### # ####### # # # ### # ######### ####
#   #   # #   # # # #   #   #   #     #   #     #       #   #   
### # # # # ### # # # # # ### ### ######### # # ####### ##### # 
#   # # #   #   # # # # #   # #   #       # # # #     #   #   # 
# ##### # ### ### # ### ### ### ######### ### # # # ##### # ### 
#       # #   #   # #     # #   #       #   # #   # #   #   #   
# ####### # ### # # # ##### # # # ##### ### # ##### # # ##### ##
#       # # #   #     #     # # # #   #   #   #   # # #   #   # 
# ####### ### ####### # ##### ### # ##### ### # ### # ##### ### 
# #     #     #         #   #     #       #   # #   #       #   
# # ### ####### ##### ##### ############### ### # ############# 
#   # #     # # # #   #   # #                   #     #       # 
# ### ### # # # # # ##### # ####### # ############# ### ##### # 
#   #     #   #   #       #         #             #         #   
################################################################
