################################################################
################################################################
   #               #   #   #   #         #     # #           # #
 ### # ########### # # # # # # # ### ### # ### # # ######### # #
 #   #           # # #   #   #     # #   # #   # # #   #G    # #
 # ############# # # ####### ####### ##### ##### # # # ####### #
   #   #         #     #   # #     # #   # #     #   #         #
 ##### # ######### ##### # ### ### # # # # # ### ####### ### # #
 #     #         # #   # # #   #   #   # #   #   #   #     # # #
 ##### ######### ### # # # # ### ### ### ##### ### # # # ### # #
         #     #   # #   #   #   #   #     #     # #   #   # # #
 ##### ### ### ### # ######### ### # # ### # ##### ####### # ###
 #   # #   # #   #       #     #   # #   # # #     #       #   #
 # # ### ### ### ######### ####### ##### ### # ####### ####### #
 # # #   #   # #     #     #     # #   #     # #   #   #       #
 # # # ##### # ##### # ##### ### ### # # ##### # # # ### ##### #
 # #   #   #       # # #     # #     # # #     # #   #   #     #
 ####### # ####### # # # ##### ####### ### ##### ### # ####### #
   #     #       #     # # #   #   # #   # #   # #   # #       #
## # ######### # # ##### # # # ### # ### # # ### # ### # #######
   # # #     # # # #     #   #     #   #   # #   #   # #   #   #
 ### # # ### ### # # ####### ####### ####### # ##### # ##### # #
 #   #   #   #   # #       # #   #   #       # # #   # #   # # #
 # ####### ### ### ####### # # # ### # ### ### # # # # # # ### #
 # #   #   #   #         # # # #     # #   #   #   # # # #   # #
 # # # # ### ### ##### ### # # ##### # # ### ####### # # ### # #
   # # #     #   #   # #   # #     # # # # # #   #   #   # #   #
 ### # ########### # ### ### ##### # # # # # ### # ####### #####
 #   # #     #     #     #   #   # #   #   # #   #       #     #
 # ### # ### # ########### ### # ### ####### # ##### ### ##### #
   # #   # # # #   #     #     #   #     #   #   # #   #   #   #
#### ##### # # # # ##### ######### ##### # ##### # ### ### # ###
       #     #   #       #   #   #     # # #   # #   #   # #   #
 ##### # ################# # # # ##### # # # # # ### ### # ### #
     # #   #               #   # #   #   #   #   # #   # #     #
#### # ### # ####### ##### ##### # ##### ######### ### # # #####
 #   #   # #   #     #     #   # #   # #           # #   #     #
 # ##### # ### ##### # ### ### # ### # ### ##### # # ######### #
 # #     #   #   #   # #   #   #           #     #             #
 # ##### ### # # # ### ##### ##### # # ##### ####### # # ##### #
 # #       # # # #   #         #   # #     #   #   # # # #     #
 # # ### # # ### ############# # ### ##### ##### # ### # #######
   # #   #       #           # # #   #       #   #     #       #
#### # ########### ######### # # # ### ####### ##### ######### #
     #   #         #   #   # # # #   # #     # #   # #       # #
 ####### # ########### # ### # # ##### # ### # ### # # ####### #
       # #   #       # #     # # #   # #   # #   #   #   #     #
 ####### ### ##### # # ####### # # # # # ### ### ####### # ### #
   #     #   #     #       #   #   # #   #   #   #       #   # #
## # ##### ### ########### # # ##### ##### # # ### ##### ### ###
 # # #   # # # #   #   #   # #   # # #     # #   # #   #   #   #
 # # ### # # # # # # ### ##### # # # # ######### # # # ### ### #
 # # #   # #   # #     #     # #   # #     #   #   # #   # #   #
 # # # ### ########### ##### # # ### ##### # # ##### ### # # ###
   #   #   #         #     #   # #   #   # # #    S  #   # #   #
 ####### ### # ##### ### # ##### # # # # ### ########### ##### #
 #       #   # #   # #   #       # # # #     # #       #       #
 # ####### ##### # # # ####### ### # # ####### # ##### ####### #
 #   #     #     # # # #   #   #   # #       # # #   # # #     #
 ### ##### # ##### # # # ### ### ### ####### # # ### # # # # ###
   #     # #     # #   #     #   #   #   #   #   #   # # # # # #
 # ##### ####### # ########### ### # ### # ####### ### # # # # #
 #     #         #             #   #     #             #   #   #
################################################################
