################################################################
 #     # #   #     #   #       #         #   #       #   #   # #
 # ### # # # # ##### # ##### # ### # ### # # ####### # ### # # #
 # #   #   # #       #     # #     #   #   #         #     # # #
 # # ### ################# ####### ####### ########### ##### # #
   # #         #         #     #   #     #       #         #   #
#### # ##### ### ##### ####### ##### ### ####### # # ##### #####
     #     #     #   #     # #       # #       #   # #   #     #
 ######### ####### # ##### # ######### ####### # ### # # ### # #
     #   #         #     #   #   #   #       # # #   # #   # # #
#### # # ### ########### ##### # # ######### # ### # # ### ### #
     # #   # #   #             #             # #   # # # #   # #
 ##### ### ### # ######### ########### ##### # # ### # # ### # #
 #   #   #     #   #   #   #   #     # #   # #   # # # #     # #
 # # ### ######### # # ##### # # ### # # # # ##### # # #########
 # #   # #   #   #   #   #   #   # # # # # # #   # # # #       #
 # ### # # # # # ####### # ####### # ### # # # ### # # # ##### #
 #   #   # # # # #     #   # #       #   #   #         #     # #
 ### ##### # ### # # ####### # ####### ##### ### ##### ##### # #
   # #   # #   # # #   #     #       # #   #   # #   #     # # #
## # # # ##### # # ### ##### ####### # # # ### # # # # ### ### #
 # # # #   #   # #   #   #       # #   # #       # # #   #     #
 # # # ### ### # ### ### # ##### # ##### ######### # ### #######
 #   #   #   #     #   # #     #       # #         #   #   #   #
 ####### ### ### # ### # ######### # # # # ########### ### # # #
   #   # # #   # #   # # #     # # # #   #     #     #   # # # #
 ### # # # ### # ### # ### ### # # # ### ##### # ### ### # # # #
     #   # #   # # # # #   # # #   #   #     # # # #   # #   # #
########## # ### # # # # ### # ##### # # ### # # # ### # # #####
 #       # #     # # #   #   #     # # # #   # # # #   # #     #
 # ##### # ####### # ##### # ##### ### # # ### # # # ### ##### #
   #   # #     #   #       # #   # #   # # #   #   #     #     #
#### ### ##### ### ######### # # # # ### # # ############# #####
   #   #     # #           # # # #   #   # # # #   #     # #   #
 # ### ##### # # ####### ### # # ### ####### # # # # # ### # # #
 #           #   #       #   # # #   #     # #   # # #   # # # #
 ####### ### ### ####### # ### # ### # ### # ##### # ### # # ###
 #       #       #     # #   # #     # # # #   #   #   #   #   #
## # ##### ####### ### # ### # ####### # # ### # ##### ####### #
   # #   # #   #   #   #   #   #       # #     #     # #     # #
 ### # # ### # # ######### ### # ####### ####### ##### # ##### #
   # # #     #   #         #   #   #     #       #     # #   # #
 # ### ############# ##### # # ### # ######### ### ##### # # # #
 #   #     #   #     #   #   # # # #         #   # #     # #   #
#### ##### # # # ##### # ##### # # ######### # # # # # ### #####
       #   # #   #     #     #   #  G# #     # # #   # #   #   #
 ####### ### ##### ######### ####### # # ##### # # ##### ##### #
 #       #   #   # #         #       # # #     # # #   #     # #
 # ######### # # # # ##### ### ####### # # ### ### # # ##### # #
 #   #     # # #   #     # #   #         # #   #   # #       # #
 ### ### # # # ######### # # ### ####### ### # # ### ######### #
   #     # #   #   #     # #   # #     #     #       # #   #   #
 # ####### ##### # # ##### ### ### ### ######### ##### # # # # #
 #   #   # #     # #   # #   #     # #         # #   #   #   # #
 ### # # # # ##### ### # # # ####### ######### # # # ######### #
 #   # #   # #   #     #   #         #     #   #   # #       # #
 # ### ##### # # ############### ##### ### # ####### ##### ### #
 # # # #     # # #   #           #     #   #   #     #     #   #
 # # # ### ### # # # ############# ##### ##### # ##### ##### ###
 #   #     #   # # #            S# #   #       #     #         #
 ############# ### ############# # # ############### # ### #####
     #       #   # #           #   #   #         #   #   # #   #
 ### ####### ### # # ##### # ######### # ####### # ### # ### # #
   #             #   #     #                   #       #     # #
