################################################################
#   #   #           #     #       #               #       #   # 
# ### # # ######### ### ### # # ### # # ######### # ##### ### # 
#   # # #     #   #     #   # #   # # # #  S  #   # #           
# # ### ##### # # ####### ### ### # # # # ### # ##### ######### 
# #     #   # # #   #     # #   #   # # # #   #       #       # 
# ####### # # ### ### ##### ### ##### # # # ####### ### ##### # 
#         #       #   #     # # #     # # # #     #   # #   # # 
# ############# ### ### ### # # ######### # # ### ##### # # # ##
#       #     #   #   #   #   #           # #   #       # # #   
####### # ### # ##### # ################### ### ########### ### 
#       # # # #   #   # #   #   #         #   #   #       #   # 
# ####### # # ### # ### # # # # # ####### ### ### ####### # # # 
#   #     # #   # # #     # # #   #     #   #   #     # #   # # 
### # ##### ### # # ### ### # ##### ### ### ### ##### # ##### # 
#   # #   #   # # #   # #   # # #     # #   # #   #   #     # # 
# ### # # ### # # ### # ##### # # ### ### # # ### # ### ### # # 
#     # #   #   # #   # #           #   # #     # # # #   # # # 
# ##### # ######### ### # ############# # ####### # # ### # # # 
#       # #   #   #   #   # #         # # #     #         # # # 
######### # # # # ### # ### # ####### # # # ### ########### # # 
#   #   #   # # #   # #     # #     # # #   # # #         #   # 
# # # # ### ### ### # ### ### # ### # # ##### # # ####### ##### 
# #   #     #   #   # #   #   #   #   # #     # # #   #         
########### # ### # # ### # ##### ##### # ##### # # # ##########
#         # # #   # #   #   #   # #   # #       # # # #   # #   
# ##### ### # # ####### ### ### # ### # ######### # # # # # # ##
#     #   # # #       #   # #   #   #       #   #   #   # #     
# ####### # # ##### ##### # # ##### ####### # # ######### ##### 
# #     #   #     #     # # # #   #       # # # #     #   #   # 
# # ### ######### ### # # # # # ######### # # # ##### # ### # # 
#     #       #   #   # # # # #       #   #   #     # #   # # # 
# ########### # ### # ### # # ####### # ##### ##### # ### # # # 
#   #     # # # #   # #   #           #     # #     # #   # #   
# # # ### # # # # # ### ### ############### ### ### # # ### ### 
# #   #   #   # # # #   #   #     #     # #   # # # # #   #   # 
# ##### ##### # # ### ##### # ### # ### # ### # # # # ### ##### 
# #     #     # # #   #   #   # #   # # #     # #   #   # # #   
# # ######### # # # ### # ### # ##### # ####### ##### ### # # ##
# #         # # # #     #   #       # # #       #   # #   #   # 
# ######### ### # ######### ### ##### # # ##### # # # # ##### # 
# # #     #   # # #         #   #   # # # #   #   #   # #   #   
# # # ### # # # # # ######### ### # # # ### # ######### ### ### 
# # # # # # #   # #   #   #   #   # # #     #   #     # #   #   
# # # # # ####### ### # # ### # ### # ######### # ### # # ##### 
# # #   #         #   # #     #   # #   #     #   #   #   #     
# # ############### ##### ####### # ### # ### ##### # ##### ### 
#   #             # # #   #       # # #   # #   #   #     #   # 
# ### ########### # # # ### ####### # ##### ### # ### # ####### 
#   #   #       #   # #   # # #     #   # #   #   #   # #       
# # ### ####### ##### ### # # # ##### # # ### ##### # # # ######
# #   #   #     # #   #   #   #   #   #   #         # #   #     
# ####### ### ### # # # ######### ### ### # # ##### ####### ### 
#       #   #   #   # #     #       # # #   #     #       #   # 
# ######### ### ##### ##### # ### # # # ######### ##### ##### # 
#         #   # #   #   #   #   # # #   #     #   #   #       # 
####### # ### # # # # # # ##### # # # ### ##### ### # ######### 
#       # #   #   #   #     #   # # #   #       # # #  G#       
# ####### # ##### ######### # # # # ### ######### # ##### ######
# #   # # # #     #       #   # # # #             #       #     
# ### # # # ####### ##### # ##### # ####### # ### ######### ### 
#     #   #         #   # # #     #     # # #   # #           # 
####### ############# ### ### ######### # # ### # # ########### 
#                             #         #   #   #   #           
