################################################################
################################################################
#     # #   #   #           #               #   #       #   #   
# ### # # ### # ########### # # ####### ### # # # ##### # # ### 
# # # # # #   #         #     #   #   #   # # # #     # # # #   
# # # # # # ########### # ######### # ### # # # ##### # # ### # 
#   #     #           # # # #       #     #   #     # # #   # # 
######### ########### # # # # ################### # # # ### # # 
#      S#   #   #     # #   # #       #           # # #   # # # 
# ##### ### # ### ##### # ### ####### # ########### # ### # # # 
# #   #       #   #     #   #         # #     #     #   #   # # 
# # ####### ### ### ##### # ########### ##### # ####### ##### # 
# #         #   # # #     #     #     #     # #   #   #       # 
### ######### ### # ####### ### # ### ##### # ### # ########### 
#   #   #   # #   #     #   #   #   #     #   #     #         # 
# ##### # # # # # ##### # ### # # ##### ####### ##### ####### # 
# #     # #   # #       #   # # # #   # #       #   # # #       
# # ##### ##### ########### # ### # # ### ##### # # # # # ##### 
#     #   #   #       #     #     # #   #   #   # # # #   #   # 
# ##### ### # ####### ####### ##### ### ### # ### ### # ### # # 
#     # #   #       #   #   #     # # #   # #   #     # #   #   
# ### # ########### ### # ### # # # # ### ##### ####### # ##### 
# #   #     # #   #   # # #   # # # #   #     #         #     # 
# # ####### # # # ### # # # ##### # # ####### ####### ######### 
# #       # #   #     # #   #     # #     #   #     # #  G  #   
# ##### ### ######### # ########### # ##### ### ### ### ### # # 
#     #   #         #     #         # #   #     # #     # # # # 
### ##### ######### ##### # ######### # # ####### ####### # ### 
#   #   # #   #   # #   #   #   #   #   #         #   #   #   # 
# ### # # # # # # # # # ##### ### # # ############# # # # ### # 
# #   # #   #   # # # # #   #     # # #           # #   # #   # 
# # ### ### ##### # # # # # ####### # # # ####### # ##### # ### 
# #   #   # #     #   #   #       # # # #   #   # #   #   # #   
# ### ### # # ################### # # ##### # # # ### # ### ### 
# #   #   # # #       # #       #   #     # # # #   # #     #   
# # ##### ### # ##### # # ##### ######### # # ### ### ####### ##
# # #   #   #     #   # # #   # #   #   #   #   # #   # #   #   
# # # # ### ####### ### # # # ### # # # ####### # # ### # ##### 
# #   # # #       #     #   #   # # # # #           #           
# ##### # ####### # ########### # # # ### ####### ######### ####
#     #   #   #   # #   #     #   # #     #   #     #     #     
# ### ##### # # ##### # # ######### ####### # # # ### ### ##### 
# #       # #   #     #   #       #       # #   #     # # #   # 
# ##### ### ##### ######### ### ######### # ##### ##### # # # # 
#     # #   #   #   #     # # #     #   #   #           # # # # 
# ### ### ##### ### # ### # # ### ### # ##### ### ####### # # # 
#   #       #   #   # #   # # #   #   #       # #     #   # # # 
# ######### # ### ### # ### # # ### ########### # # # # # ### # 
#         # # # # # # #     # #   # #   #   # #   # # # # #   # 
# ####### # # # # # # ####### # # # ### # # # ##### # # ### ### 
# #   #   #     # # #       # # # #     # # #       # #     # # 
# # # # ######### # ####### # ### ####### # ####### # ####### # 
# # #   # #       #     #   #   # #       #         # #       # 
# ####### # ####### ### # ##### # # ################# # ##### # 
#     #   #     #     # #     #   #     #               # #   # 
##### ### ##### ### # # ##### ######### ######### ### ### # ### 
# #   #   #   #   # # #     #   #       #   #   # #       #   # 
# # ### # # # ### ### ##### ### ### ##### # # # # # ### # ### # 
#   #   #   #   #   # #       #     #   # # # #   #   # #   #   
# ### ######### ### # # ##### ######### # ### ####### ### ######
#     #   #   # # # # # # #     #     # #   #   #   # #   #     
####### # # ### # # # # # # ### ### # # ### ### # ### # ### ### 
#       #             #   #   #     #           #     #     #   
################################################################
