################
################
#     #     #   
# ### # # ### # 
#   #   # #S# # 
### ##### # # # 
# #   #   #   # 
# ### # ####### 
# #   #   #   # 
# # # ### # # # 
#   #   # # #  G
####### # # ####
#       #   #   
# ### ####### # 
#   #         # 
################
