################
################
#   #     #     
# ### ##### ### 
#   #       #   
### ######### ##
#   #       # # 
# # # ##### # # 
#S# # #   #G  # 
# # # # ####### 
# # # # #     # 
# ### # # # ### 
#   # #   # #   
# # # # ##### ##
# #             
################
