################
################
#     #     #   
# ### # ### ### 
#   # # #     # 
##### # ##### # 
#     #     # # 
# ######### # # 
# #         #   
# # ########### 
# #   #      G  
# ##### ########
#  S    #   #   
# ####### # # # 
#         #   # 
################
