################
#     #       # 
# ### # # # # # 
# #     # # #   
# ####### # ####
# #S    # #   # 
# # ##### ### # 
#   #  G    #   
# ### ##########
#   #         # 
# # ######### # 
# # #       # # 
### # ##### # # 
#   # # #   #   
# ### # # # ####
#     #   #     
