               #
###### # ##### #
       # #     #
 ####### # #####
     #   # #   #
#### # ### ### #
   # #   #   # #
 ### # # ### # #
 #   # #   #   #
 # ##### # #####
 # #   # #     #
 # # # ##### # #
 #S# # #  G  # #
 # # # # ##### #
   # #   #     #
################
