################
         #     #
 ####### # # ###
 #     # # #   #
 # ### # # ### #
 #G#   # # #   #
 # # ##### # ###
 # #       #   #
 # ########### #
 # #   #     # #
 # # ### ### # #
 # # #   #S# # #
 # # # ### # # #
 # # #   # # # #
 # # ### # # # #
   #     #     #
