################
# #       #   # 
# # ##### ### # 
# # #   # #   # 
# # # ### # ### 
# # #   #   #   
# # ### ##### ##
#   #   #   # # 
# ### # # # # # 
#   # # # #     
### # # ####### 
# # # #      S# 
# # # ####### # 
# # # # #      G
# # # # # ### ##
#     #   #     
