################
#             # 
# ########### # 
#  G        # # 
# ######### # # 
#     #   # # # 
# ##### # # # # 
#    S  # # # # 
# ####### # # # 
#       # # # # 
# # # ### # ### 
# # # #   #     
### # # ########
#   # #   #   # 
# ####### ### # 
#       #       
