################
 #       #     #
 # ##### # ### #
 #     # # # # #
 ####### # # # #
 # #   #   # #S#
 # # # ##### # #
   # #       # #
 ### ####### # #
 #   #   # # # #
 # ### # # # # #
 #   # #   #   #
 ### # ### #####
 # #G#   # #   #
 # # ### # ### #
         #     #
