################
#   # #   #     
### # # # # ### 
#   # # # #   # 
# ### # ##### # 
#   # # #   # # 
### # # # # # # 
#     #   #   # 
# ############# 
# #     #  S  # 
# # ### # ### # 
#  G# #   # #   
# ### ##### ####
# #         #   
# ####### # ### 
#         #     
