################
################
 #           # #
 # ### ##### # #
   #S#    G#   #
 ### # ### ### #
 #   #   #   # #
## ### # ### ###
   #   # # #   #
 ####### # ### #
 #     # # #   #
 # ### # # # ###
   # # #   #   #
#### # ####### #
               #
################
