################
################
            S# #
###### ##### # #
     # #   # # #
 ### # # ### # #
 #   # # #   # #
## ### # # ### #
   #   # #  G# #
 ### ### ### # #
   # #     #   #
## # ##### ### #
 # #     #     #
 # ##### # #####
         #     #
################
