################
#             #S
# ########### # 
# # #       #   
# # # # ### ####
# #   # #   #   
# # ### # ### # 
# # #   #     # 
# ### ####### # 
#     #     # # 
####### ### # # 
#   # # #   # # 
# # # # # ### ##
# #   # #G#     
# ##### # ##### 
#       #       
