################
     #       # #
 ### # # ### # #
   # # # # #   #
 # # ### # #####
 # #     #  G  #
 # ########### #
 #         # # #
 ####### # # # #
     #  S#   # #
#### # ### ### #
     # # # #   #
 ##### # # # ###
 # #   #   # # #
 # # ####### # #
   #           #
