################
################
 #       #   # #
 # ##### # # # #
 #   # #   #   #
 ### # #########
     # #       #
 ##### # ##### #
G    # # #    S#
#### # # # #####
     #   # #   #
 # # ##### ### #
 # #     #   # #
 ####### ### # #
       #       #
################
