               #
 ####### ### # #
 #     #   # # #
 # ### ### ### #
S#   #   # #   #
#### ### # # ###
     # #   #   #
 ##### ####### #
 #             #
 ############# #
   #         # #
 # # ####### # #
 #   #     # # #
 ##### ##### # #
     #      G# #
################
