################
#   #     #     
# # # ##### ### 
# #     #   #   
# ### # # ### # 
#   # #   # # # 
### ####### # ##
# #     #   #   
# ##### # ##### 
#S G  # # #     
##### # # # ####
#   #   # # #   
# # ##### # # # 
# #       #   # 
# ############# 
#               
