################
################
 #         #   #
 # ####### # # #
 # #     # # # #
 # # ### # ### #
 # # #   #   # #
 # # # ##### # #
 #   #   #   # #
 # ##### # ### #
 #     # #   # #
 ####### # # # #
 #S      # #G  #
 # ####### #####
   #           #
################
