################
################
# #       #     
# # ##### # ### 
# # #   #S# #   
# # # # # # # # 
#     # #   # # 
####### ##### # 
#    G#   #   # 
# ### ### # ### 
# # #   # #   # 
# # ### ##### # 
# #     #     # 
# ####### ##### 
#         #     
################
