################
################
 #             #
 # # ### # ### #
   #   # #   # #
###### # ### # #
     # # #   # #
 ##### # # ### #
G    # # # #   #
#### # # # ### #
       # #   # #
 ########### # #
 #      S  # # #
 # ####### # # #
 #       #   # #
################
