################
################
#   #          G
### ### # # ####
#   #   # #     
# ### # # ##### 
#     # #   # # 
####### ### # # 
#       #   # # 
# ##### # ### # 
# #   # #S#   # 
### # ### # ### 
#   # #   #   # 
# ### # ##### # 
#   #   #       
################
