################
   #           #
 # # ######### #
 # # #   #    G#
 # # # # # #####
 #   # #       #
 ##### ####### #
   # # #     # #
## # ### ### # #
 # #     #  S# #
 # ####### ### #
 #         #   #
 ########### ###
   #         # #
 # # # ####### #
 #   #         #
