################
#   #   #       
# ### # # ### # 
#     # #   # # 
# ######### # ##
#         # #   
####### # # ### 
#       # # #   
# ####### # # ##
#       # # #G  
####### ### ### 
#     # #     # 
# ### # # ##### 
# #S# #   #   # 
# # # ##### # # 
#   #       #   
