################
   #           #
 # # ##### ### #
 #   #G#   #   #
 ##### # #######
 #   # #   #   #
 # # # ##### # #
   #   # #   # #
###### # # ### #
         # #   #
 ### ##### # # #
 #   #     # # #
 # ### ##### # #
 # #S  #   # # #
 # # ##### # # #
 #       #   # #
