#               
# ##### # ##### 
# # #   #     # 
# # # ####### # 
# # #     #   # 
# # ##### # ### 
# #       #   # 
# ######### # # 
# #   #   # #S# 
# ### # # # # # 
#   #   # # # #G
### ##### ### ##
# # #   #   #   
# # # ##### ### 
#   #           
################
