################
#   #   #       
# # # # ####### 
# # # #       # 
### # ####### # 
#   # # #     # 
# ### # # ##### 
# #   # # #   # 
# # ### # # # # 
#   #       #   
####### # ######
#       # #   # 
# ### ### # # # 
# # #S# #  G# # 
# # # # ##### # 
#   #       #   
