################
#             # 
# ##### # # # # 
#   #   # # #   
### ##### # ####
#   #   # # #S  
# ### # # # ### 
#   # # # #   # 
# # # # # ### # 
# # # # #   # # 
# # # ####### # 
# #G# #   #   # 
### # # # # ### 
#   #   # #   # 
# ####### ### # 
#           #   
