               #
## ##### ##### #
 #     #     # #
 ##### # ### # #
 #    S# #   # #
 # ####### ### #
   #     #   # #
#### ### ##### #
     # #     # #
#### # ##### # #
     # #   #   #
 ##### ### ### #
     # #       #
#### # # # #####
    G#   #     #
################
