################
################
           #   #
 # ####### # # #
 # #    G#   # #
## # ### ### # #
   #   #   # # #
 ##### ### # ###
   #   # #S#   #
#### ### # # # #
     # #   # # #
 # ### # ### ###
 # #   #   #   #
 ### ### # ### #
     #   #     #
################
