################
################
     #         #
 ### # ### ### #
   #   #   #   #
## ##### ### ###
   #  S# #   # #
 ### ### # ### #
     #   #     #
 ##### #########
G#   #     #   #
## # ##### # # #
   #       # # #
 ########### # #
             # #
################
