################
################
#   #   #     # 
# ### ### ### # 
#   #   # # #   
### ### # # ### 
#     #   # #   
# ### ##### # ##
#S# #       #   
# # ##### ##### 
# #       #   # 
# # ####### # # 
# #      G# # # 
# ######### # # 
#           #   
################
