################
################
 #   #   #   # #
 # # ### # # # #
 # # #   # #   #
 # # # ### #####
   #   #G  #S  #
 ##### # ##### #
 #     #   #   #
 # ### # # # ###
 # # #   #   # #
## # ### ##### #
   # # #       #
 ### # # # #####
     #   #     #
################
