################
     # #       #
#### # # ##### #
   #       # # #
 # ####### # # #
 #       #   # #
 ############# #
   #       #   #
## # # ### # ###
   # #   # #   #
 ### ### # ### #
 #   #   #     #
 ##### ####### #
 #   # #   #   #
 # # # # ### # #
   #  G#     #S#
