################
################
   #     #   #G#
 # # ### # # # #
 # # # # # #   #
 # # # # # ### #
 #   #     # # #
 ########### # #
 #     #   # # #
 ##### # # # # #
       # #   # #
######## ##### #
         #     #
 ####### # #####
       #S      #
################
