################
#   #         # 
# # # ####### # 
# # #   #   #   
### ### # # ####
#   #   # #     
# # # ### ### # 
# # #     #   # 
# # ####### ### 
# #      S  #   
# ########### ##
# #   #       # 
# ### # ##### # 
# #   # #     # 
# # ### # ##### 
#   #G  #       
