################
 #G        #   #
 # ####### # # #
   #       # # #
 ### ####### # #
 #   #   # # # #
 ##### # # # # #
     # # #  S# #
#### # # ##### #
   #   # #     #
 # ##### # ### #
 # #   # # #   #
## # # # ### # #
   # # #   # # #
 ### # ### ### #
     #         #
