################
################
#       #G  #   
# # ##### # # ##
# # #   # # #   
# # # # ### ### 
# # # #     #   
### # ####### ##
#   #     #   # 
# # ### # # ### 
# # #   # # #   
# # # ### # ### 
# # #   # #   # 
# # ### # ### # 
# #     #S      
################
