################
################
#     #         
# ##### ##### # 
#       #     # 
##### ### ##### 
#   # #  G#     
# # # ##### ### 
# #    S#   #   
# ##### ########
# #   #     #   
# # # ##### # # 
# # #     #   # 
# # ########### 
# #             
################
