################
#           #   
# ######### # # 
#     #     # # 
##### ####### # 
#     #   #   # 
##### # # ##### 
#S  #   #  G    
# # ########### 
# # #   #       
### # # ####### 
#   # #         
# ### ######### 
# #   #         
# # ##### ### ##
#   #     #     
