################
#        S#     
# ######### ####
# #       #     
# # # ### ##### 
#   # #   #   # 
# ##### # # # # 
# #     # # # # 
### ##### # ### 
#   #     #     
# ### ### ### ##
#   #   #   #   
# ##### ### # # 
# #     # # #G# 
# # ##### # ### 
# #       #     
