################
################
#   #   #       
# ### # # ##### 
# #   # #   #   
# # ######### ##
# #G#   # #     
# # # # # # ####
# #S  #   # #   
# ##### ### # # 
# #   # #   # # 
# # ### # ### # 
#   #   # #   # 
# ### ### # ### 
#           #   
################
