################
################
   #   #       #
 # ### # ##### #
 #   # #    G# #
 ### # ### ### #
 #   #     #   #
## ####### # ###
   #       #   #
 ### ####### # #
 #       #   # #
 # ##### # ### #
 #S#   # # #   #
 ### # # # # ###
     #   # #   #
################
