################
#   #       #   
### # ### ### # 
#   #   #     # 
# # ### ########
# # # # #       
# # # # # # ### 
# #   #G# # #   
# ### # ### # ##
# #   #S    #   
### # ######### 
#   #           
# ##### ########
# # #   #     # 
# # # ### ### # 
#   #       #   
