################
#               
# ########### ##
#   #       #  G
### # ##### ### 
#   #   #   #   
# ####### ### # 
# #     #   # # 
# # ### ### # # 
#   # #     # # 
##### ####### # 
#             # 
# ############# 
# #    S#       
# ##### # ######
#       #       
