################
################
  G#   #S  #   #
 # # ### # # # #
 #   #   # # # #
 ### # ### ### #
   # #   # #   #
#### ##### # ###
   #       #   #
 # ### ####### #
 #   # #   #   #
 ### # # # # ###
 # #   # #   # #
 # ### # ##### #
   #           #
################
