################
           #   #
 # ##### # # ###
 #   #G  # #   #
 ### ######### #
   #         # #
## ####### # # #
 # #S  #   # # #
 # ### # ##### #
 #     #       #
 ##### #########
 #   #   #     #
 # ##### ### # #
 # #   #     # #
 # # # ####### #
     #         #
