################
################
     #         #
 ### ######### #
 #   #         #
 # ### #########
 #  G# #   #   #
 ### # # # ### #
 #   #   #     #
 # ########### #
 #     #       #
 ##### # ##### #
 #   # #   #   #
 # # # ### # ###
   # #     #  S#
################
