################
#    G#     #   
# ### ##### # ##
# # #   #   #   
# # ### # ##### 
# #   # # #     
# ### # # # ####
#   #   # #     
# # ### # ##### 
# #   #         
# ### ##### ### 
#   # #   #  S# 
### # # # ##### 
# # # # # #     
# # # ### # ####
#   #     #     
