################
   #       #   #
 # # ### # ### #
 #   #   #   # #
###### ##### # #
       #   #   #
 ####### ##### #
   #      S  # #
#### ####### # #
   # #   #G# # #
 # # # # # # # #
 #     #   #   #
 ###############
 #   #         #
 # # # ####### #
   #   #       #
