################
#         #     
####### # # ### 
#   #   #   #   
# # # ####### ##
# # #   #       
# # ##### ##### 
# #     #    S# 
# ##### ##### # 
#     # #     # 
##### # # ######
#  G# # #       
# ### # ####### 
#     #   #     
######### # ### 
#           #   
