################
################
 #   #       # #
 # # # # # # # #
   # # # # #   #
 ### # ### ### #
 #   #   # # #S#
 ####### # # # #
 #     # # #   #
 # ### ### # ###
 #   #   # #   #
 ### ### ##### #
 #   # #G#   # #
 # ### # # # # #
   #       #   #
################
