################
#   #           
# # # # ####### 
# #S# #     #   
### # ##### ####
#   #     # #   
# ####### ### # 
# #G      #   # 
# ### ##### ### 
# #   #   #   # 
# # ### # ### # 
#   #   #     # 
# ### ######### 
#   # #   #     
# # # # # # ####
# #     # #     
