               #
###### ### # ###
   #   #   # # #
 ### ### # # # #
     #   #S#G  #
###### # #######
       # #   # #
 ##### # # # # #
 #   # # # # # #
 # # # # # # # #
 # # # #   #   #
 ### ###########
   #   # #     #
 # ### # # ### #
 #         #   #
################
