################
 #           # #
 ### # ##### # #
 #   #     #   #
 # ### ### #####
   #     #     #
######## ##### #
   #   #   #   #
 ### # ### # # #
 #   #   # # # #
 # ##### # # ###
 #   #  S#G#   #
 ### ######### #
 # # #   #   # #
 # # # # # # # #
       #   #   #
