################
   #     #     #
 # ### ### # ###
 #   #     #   #
 ### # ####### #
 #   # #G  #   #
 # ### # # #####
 #       # #   #
 ### ####### # #
   # #       # #
#### # ####### #
   #     #     #
 # ####### ### #
 #   #    S#   #
 ### # ##### # #
   #   #     # #
