################
################
 #   #   #     #
 # # # ### ### #
   # #     # # #
 ##### ##### # #
     # #     # #
#### # ##### # #
   # #    S  # #
 # # ######### #
 #   #     #   #
 ##### ### # # #
       # #G# # #
######## # # # #
             # #
################
