################
################
         #   # #
 ##### ### # # #
 #   #     #   #
 # # ######### #
 # #   #     # #
 # ### # ### # #
 #   # #   #   #
 ##### # #######
 #     # #     #
## ##### # ### #
G  #   #   #   #
 ### # # ### ###
     #    S#   #
################
