################
################
         #     #
######## # ### #
   #     #S#   #
 # # ####### ###
 # #   #   #   #
 ##### # # ### #
       # #   # #
 ####### ### # #
 #        G#   #
 # ####### # ###
 # #   #   #   #
 # # ### ##### #
   #     #     #
################
