################
################
           #   #
########## # ###
   #     # #   #
 # # ### # ### #
 #   #   #     #
 ### ######### #
   # #S  #    G#
## # # # # #####
   # # #   #   #
 ##### ####### #
 #   #   # #   #
 # # ### # # ###
   #           #
################
