################
#   #    S# #   
### # ### # # # 
#   # # # #   # 
# ### # # # ### 
#     #   #   # 
######### ### # 
#   #         # 
# ### ##### ### 
#   # #   #   # 
### # ### ### # 
#   #   # #G  # 
# ##### # ##### 
#   # #   #     
### # ##### ### 
#           #   
