################
################
# #             
# # ##### # ### 
# # #   # #   # 
# # # # # ### ##
#     # #   #   
# # ####### ### 
# #   #G  #   # 
# ##### # ### ##
#   #   #   #   
### # ##### # # 
#   #   #   # #S
# ####### ##### 
#         #     
################
