################
################
#   #       #   
# ### # ### # # 
# #   # #   # # 
# # # # # ### ##
# # # # # #   # 
# # # # # # ### 
# # # # #   #   
# # # # ### # ##
#   # # # # #S  
##### # # # ### 
#     # #   #   
# # ### ##### ##
# #   #        G
################
