################
   #     #     #
 # ##### # ### #
 #     #   #   #
 ##### ##### ###
 #   #   #   # #
 # # # # # ### #
 # #   # #   # #
 # # ####### # #
 # # #  S  # # #
 # ### ##### # #
 #     #     # #
 # ##### ##### #
 #G#   #   #   #
 ### # ### # # #
     #       # #
