#               
# ############# 
#     #   #     
##### # # # ### 
#     # # #   #S
# ####### # # ##
#         # #   
############### 
#       #     # 
# ##### # ### # 
#   #   # # # # 
### ##### # # # 
# # #    G# #   
# # # ##### ### 
#     #         
################
