################
################
               #
 ########### # #
     #   # # # #
#### # # # # # #
     # #   # # #
 ##### # ### # #
 #   # # #  G# #
 # # ### # ### #
   #     # # # #
########## # # #
   #   #   # # #
 ### # # ### # #
     #   #S    #
################
