################
################
         #     #
 ######### ### #
     #  G#   # #
#### # # ### # #
     # #     # #
 ### # ####### #
   #       #   #
## ####### #####
   #     #     #
#### ### ##### #
  S  # # #   # #
 ##### # # # # #
       #   #   #
################
