################
################
# #         #   
# # ####### # # 
# # #     # # # 
# # # ### # # # 
#   # #   # # # 
# ### # ### # # 
# #   #     # # 
# # ####### # # 
# #     #   # # 
# ##### ### # # 
# #   #   # # # 
# ### ### ### # 
#      G#  S  # 
################
