#               
####### ##### # 
#   #   # #   # 
### # ### # ### 
#   #     #   # 
# ### ####### # 
#   #     # # # 
### ##### # # # 
# # #   #   # # 
# # # # ##### # 
# #  S#G  #   # 
# ####### # ### 
# # #   #   # # 
# # # ####### # 
#               
################
