################
#     #   #   # 
# ##### # # # # 
# #     #   # # 
# ########### # 
#           #G# 
### ######### # 
#   #   #S    # 
# ### # # ##### 
#     # # #   # 
# ##### # # ### 
#     #   #   # 
# ### ##### # # 
# #       # # # 
# # ####### # # 
# #         #   
