################
################
           #   #
 ######### # ###
     #   # #   #
#### # # ##### #
G      # #   # #
 ####### # # # #
 #     # # # # #
 # ### # # # # #
 #   # #   #S  #
 ##### #########
 #   #     #   #
 # # ##### # # #
   #         # #
################
