################
#       #       
# ##### ####### 
# #     #    G  
# # ##### ######
# #   #   #     
##### # ####### 
#   # # #       
# # # # ### ### 
# # # #     #S  
### # ######### 
#   #           
# ############# 
# #       #   # 
# # ##### # # # 
#       #   #   
