################
     #         #
#### # ##### # #
   #   #     # #
 # ### # # ### #
 # #   # # #   #
 # ##### # # ###
 #  G#   # #   #
 ### # ####### #
   #   #     # #
## ##### ### # #
   #  S# #   # #
 ### # # # ### #
 #   #   #   # #
 # ######### # #
 #         #   #
