################
#               
# ### ####### # 
# #   #       # 
### ### # # ### 
#  G#   # #   # 
# ### ####### ##
# #   #     #   
# # ### # ##### 
# #     #     # 
# ######### # # 
# #   #     #S# 
# ### # # ##### 
#   # # # #     
### # # # # ####
#   #   # #     
