################
# #   #   #   # 
# # # # # # # # 
#  G#   # # #   
# ####### # ### 
# #     # # #   
# ### # # # # ##
# #  S# # # #   
# # ### # # ### 
#   #   # #   # 
####### # ##### 
# #     # #     
# # ##### # ####
# #   #   #   # 
# ### # ##### # 
#     #         
