################
################
 #   #         #
 # # # ### ### #
   #G  #     # #
######## # # # #
         # # # #
 # ####### # # #
 # #   #   # # #
 # # # # ##### #
 #   # #   #   #
 ##### ##### ###
 # #   #     #S#
 # # ### ##### #
   #   #       #
################
