################
################
 #             #
 # ####### # # #
 # #     # # # #
 # # ### # ### #
   # #   #   # #
 ##### ##### # #
   #    G  # # #
## # # ##### # #
 #S  # #   # # #
 ##### # # # # #
       # # # # #
###### # ### # #
       #     # #
################
