################
   #   #G  #   #
 # ### # # ### #
 #   # # # #   #
 ### # # ### # #
   # # #  S  # #
#### # ####### #
 #   # #       #
 # ### # # ### #
   # #   # #   #
 ### ##### # # #
   #     # # # #
## ##### # # ###
 #   #     #   #
 ### ######### #
               #
