#               
# ####### ### # 
#   #     #   # 
### # ##### ####
#   #   # # #   
# # ### # # ### 
# #   #   #     
# ### ##########
# #   #         
# ### # # ##### 
#  S#   # #   # 
### ##### # # # 
# #   # # # #G# 
# ### # # # ### 
#     #   #     
################
