################
     #         #
 ##### ####### #
 #     #     # #
 # ##### ### # #
 # #   # #   # #
 # ### # ##### #
 #     #       #
 ##### #########
     #  G#     #
 # ##### ### # #
 #       #   # #
 ######### ### #
   #   #   # # #
 # ### ##### # #
 #S            #
