################
################
#     #         
# ### # ####### 
# # #   #  G    
# # ############
# #       #     
# ##### # # ### 
# #     # # #   
# # ##### # # ##
# # #     # # # 
# # # ####### # 
#   # #   #  S# 
##### # ### ### 
#               
################
