################
 #       # #   #
 ####### # # # #
       # #   # #
## ##### ##### #
   #  S  #     #
 ### ####### ###
   #   #   #   #
 # ### # # ### #
 #   # # #   # #
 ### # # ### # #
 # #   #   # # #
 # ######### # #
 # #   #    G# #
 # # ### ##### #
               #
