################
   #   #   #   #
 ### # # # ### #
   #S# # # #   #
 # ### # # # ###
 #     # # #   #
 ######### ### #
 #   #   #     #
 # # # # ##### #
   # # # #    G#
#### # # # #####
     # #   #   #
 # ### ##### # #
 #   #   #   # #
 ### ### # ### #
   #       #   #
