################
################
   #   #G      #
 # ### # ##### #
 #     # #     #
###### # #######
     # #S      #
 ### # ####### #
 # #   #     # #
 # ####### # # #
     #   # # # #
#### # # # # # #
   #   #   #   #
 # ########### #
 #             #
################
