################
################
       #       #
 ### # # ##### #
   # # #     # #
#### # ##### ###
     #   #     #
 ####### # ### #
   #       #   #
## ######### ###
 #  S  #   # # #
 # ### # # # # #
 # #   #G#   # #
 ### # # ##### #
     # #       #
################
