################
    S#     #   #
#### ##### # # #
     #     #G# #
 ##### ### # ###
 #   # #   #   #
 # # ### ##### #
 # #   #       #
 # ### ### #####
 # # #   #   # #
 # # ### ### # #
   #     # # # #
#### ##### # # #
     #     # # #
 ##### # ### # #
       #       #
