################
#   #           
# # # # # ##### 
# # # # #   #   
### # # ### # ##
#   # # #   #   
# ### # ########
#   # #G        
### # ######### 
# # #    S#   # 
# # # ##### # # 
# # #   #   # # 
# # ### # ##### 
# #   #   #   # 
# ### ##### # # 
#           #   
