################
   #   #   #   #
 # # # # ### # #
 #   # # #   # #
 ##### # # #####
 # #   # #     #
 # # ### ##### #
   #        S# #
###### # ##### #
     #G#     # #
 ### # # ### # #
 # #   #   #   #
 # ##### #######
 # #   #       #
 # # # ####### #
   # #         #
