################
################
         #     #
 ####### # ### #
 #     #   #   #
 # ### ##### ###
G#   #     #   #
########## ### #
  S  #   #   # #
 ### # # ### # #
 #     #   #   #
 ####### # ### #
       # #   # #
###### # ### # #
       #   #   #
################
