################
#   #G          
# ### ##### ### 
# #   #   #   #S
# # ##### ### # 
# #     #   # # 
# ##### ### ### 
# #   # # #     
# # ### # ######
# # #   #       
# # # ### ##### 
#   # #   #   # 
# ### # ### # ##
#   # #     #   
### # # ####### 
#       #       
