################
#     #         
# ##### ####### 
#     # #     # 
##### # # ### # 
#     #   # # # 
# ######### # # 
#G#       #   # 
# ##### # ##### 
#     # #       
##### # ####### 
#   # # #       
# # # # # ######
# # #  S# #     
# ####### ##### 
#               
