################
################
#   #  S#       
# # # # ### ### 
# #   #     #   
############# # 
#             # 
# ############# 
# #       #   # 
# ####### # ### 
#   #   # #     
# # # # # ##### 
# #G  # # #   # 
# ##### # # ### 
#     #   #     
################
