################
################
   #   #       #
 ### # ####### #
   # #       # #
## # ####### # #
   # #     #G# #
 ### # ##### # #
 #  S#       # #
 # ########### #
 # # #         #
 # # # ####### #
 #     #   #   #
 ### ##### # ###
           #   #
################
