################
#G#   #         
# # # # ####### 
# # # # #   #   
# # ### # ### ##
# #S    #     # 
# ####### ##### 
#   #   # #     
# # # # # # # ##
# #   #   # #   
# ######### ### 
# #   #     #   
# # # # ##### # 
#   #   #   # # 
######### ### # 
#             # 
