################
################
# #   #   #     
# # # # # # ### 
# #G#   # # #   
# # ##### ### ##
# #   #  S#   # 
# # ### ### ### 
# # #   #   #   
# # # ### ##### 
#   # #   #   # 
# ### # # # # # 
# #   # # # # # 
# ##### # ### # 
#       #       
################
