################
 #   #        G#
 # ### #########
               #
############## #
             # #
 ########### # #
 #     #       #
 # ##### #######
 #     # #    S#
 ##### # ##### #
     # #     # #
#### # ##### # #
     #   #   # #
 ####### # ### #
         #     #
