################
################
# #            G
# # ####### ####
# # #     #  S  
# # ##### ##### 
# #     # #   # 
# ##### # # # # 
#     # # # # # 
# ### # # # ### 
#   #   #   #   
# ####### ### ##
#       #   # # 
##### # # # # # 
#     #   # #   
################
