################
   #           #
 ### ####### # #
 #   #   #   # #
 # ### ### ### #
 # #   #   #   #
 # # # # ### # #
 # # # #   # # #
 # ### ### ### #
 # #G    #   # #
 # # ### ### # #
 # # #     # # #
 # ### ### # ###
 #     #S  #   #
 ############# #
               #
