#        G      
# ### # ########
#   # #   #     
##### # ### ### 
#     # #   # # 
# ##### # ### # 
#   #   #     # 
### # # ####### 
#   # #   #     
# ### ##### ####
# #   #   #   # 
# # ### # ### # 
# #   # #   # # 
# ##### ### # # 
#        S#     
################
