################
#     #         
# ### # ####### 
#   # # #   #   
##### # # # # ##
#   # #   # #   
# # # ##### ### 
# #   # #S  # # 
# ### # # ### # 
#   #   #   #   
# # ### ### ####
# #G  #   #     
# ### ### ##### 
#   #   #       
### ### ##### ##
#     #     #   
