################
################
  G# #   #     #
 # # # # # # # #
 #     # # # # #
 ### # # # # ###
   # # # # #   #
## # # ### ### #
 # # #     # # #
 # # ####### # #
   #     #   #S#
#### ##### # # #
   #       # # #
 # ########### #
 #             #
################
