#               
# ### # ##### # 
# #   #   #   # 
# # ##### # ####
# # #   # #     
# # ### # ##### 
# #G S#   #   # 
##### # ##### # 
#     # #   #   
# # ##### # ####
# # #     #     
# # # ######### 
# # #     # #   
# ####### # # ##
#           #   
################
