################
################
#   #       #   
### # ##### # # 
#   #   #S#   # 
# ##### # ##### 
#     # # #     
# ### # # # ####
# #   #   #   # 
# ########### # 
#           # # 
# ########### # 
#     #   #   # 
##### # # # # # 
#G      #   #   
################
