################
################
# #     #       
# # ### ##### # 
#   # # #   # # 
# ### # # # # # 
#S#   #   # # # 
# # # ####### # 
# # #G#     # # 
# # ### # # # ##
# #     # # #   
# ####### # # # 
#   #   # # # # 
### # # # # ### 
#     #   #     
################
