################
#           #G  
# ########### # 
# #   #     # # 
# # # # ### # # 
# # #     #   # 
# # ########### 
# #   #S        
# ### ##########
#   # #   #     
### # # # ##### 
#   #   # #     
# ####### # ####
# #       #     
# # ####### ### 
#           #   
