################
#   #   #       
### # # ####### 
#   # #       # 
# ### ####### # 
# #   #     #   
# # # # ### ####
# # # # # #     
# # ### # ##### 
#S#   # #   #   
# ### # ### # ##
#     #     #   
##### ######### 
#     #G        
# ### ##### # ##
#   #       #   
