################
 #     #     # #
 # ### # ### # #
   #   #   # # #
#### ##### # # #
     #     #   #
 # ### # #######
 # #   # #     #
 ### ### # ### #
     #G# # #   #
 ##### # # # ###
       #  S# # #
 ########### # #
 #         #   #
 # ####### #####
   #           #
