################
################
 #       #     #
 # # ### ### # #
   # #G#     # #
#### # ### ### #
   # #   # #   #
 # # ### # # # #
 # #     # # # #
 # ######### # #
 #    S      # #
############## #
     #         #
 ### # #########
   #           #
################
