################
################
     #         #
 ##### ### #####
   #   # # #   #
## # ### # # # #
   #   # # # # #
 ##### # # ### #
     # # #   # #
 ### # # ### # #
 # # # #   #   #
 # # # # #######
   #  S#       #
 ####### ### # #
         #   #G#
################
