################
           #   #
 ####### # ### #
 #     # #     #
 # ### # #######
   #   #       #
#### ######### #
   #     # #   #
 # ##### # # ###
 #       # # # #
 ######### # # #
    S    # #G  #
######## # #####
         #     #
 ##### ####### #
     #         #
