################
#       #       
# ####### ##### 
#         # #   
# ######### # ##
# #   #   #G  # 
# # # ### ##### 
# # #         # 
# # ##### # ### 
#   #   # #    S
##### ### ######
#   # #   #     
# # # # # ##### 
# #   # # #   # 
# ##### # # # # 
#       #   #   
