################
################
#   #     #G    
# # ### ### # # 
# #       # # # 
# ##### # # # # 
# #   # #   # # 
### # # ##### ##
#   # # #   #   
# ### # # # ### 
# #     # #     
# ### ##########
# #    S  #     
# # ##### # ### 
# #     #   #   
################
