################
         #   # #
 ####### ### # #
 #   # # #   # #
 # # # # # ### #
G  #   #   #   #
###### ##### # #
     #   #   # #
 # ##### ### # #
 #  S  # #   # #
 ##### # # ### #
     # #   #   #
#### ######### #
   #           #
 # ########### #
 #             #
