################
################
#   #   #S      
# ### ### ### # 
#     #   #   # 
##### # ### ####
#   # #   # #   
# # # ### # ### 
# # #     #   # 
### # ####### # 
#   #     #   # 
# ### ### # ### 
#     #   #     
####### # ######
#G      #       
################
