               #
 ############# #
  S        #   #
 ######### # ###
   #   #   #   #
 # # # # ##### #
 #   # #   #   #
########## #####
G    #   #     #
 ### # # ##### #
 #     #       #
 # #############
 # #     #   # #
 ### ### # # # #
       #   #   #
################
