################
################
   #           #
 # # ### ##### #
 #   # # #  S# #
 ##### # # # ###
     #   # #   #
#### ##### ### #
   #       #   #
 # ######### ###
 #         #   #
 ######### # # #
     #   # # # #
 ### # # # ### #
   #G  # #     #
################
