################
################
     #         #
 ### # #########
 # # #   #G    #
 # # ### # ### #
   #     # #   #
## ####### # ###
 # #       #   #
 # # ######### #
   # #       # #
 ### # ##### # #
   # #     #   #
 # ####### #####
S#             #
################
