################
#     #     #   
# ### # ### ### 
#   # #S  # #   
### # ### # # ##
# # # #   # #   
# # ### ### ### 
#   #   # #     
# ### ### ##### 
#   # #   #   # 
# # # # ### # # 
# # #   #   # # 
# ####### ### # 
# #   #   #G  # 
# # # # # # ### 
#   #   # #     
