################
################
     #         #
 ### # ####### #
 # # #       # #
 # # ### ### # #
 #     # # # # #
 ##### # # # ###
   #       #   #
 # ########### #
 #G# #       # #
 # # # ##### ###
 # #   #   #   #
 # ##### ##### #
 #S            #
################
