################
################
           #   #
 ### ### # ### #
 # # #   #   # #
 # # ##### # # #
 # #     # # # #
 # ##### # # # #
 # #     # #S  #
 # # ##### #####
 # # #   # #   #
 # # # # # # ###
   #   # # #   #
######## # ### #
        G#     #
################
