################
################
#               
######### ##### 
#   # #   #   # 
# # # # # # # # 
# # #   # # #   
# # ##### # ### 
# #   #   #S#   
# ### ##### # # 
# #   #   # # # 
# # ### # # ### 
# #     # # #   
# ####### # # ##
#       #   #  G
################
