################
################
   #           #
 # # ##### #####
 # #G#     #   #
 # # ### ### # #
 #   #   #   # #
 ##### ### ### #
 #   #S    # # #
 ### ####### # #
   # #     # # #
## # # ##### # #
   # # #   #   #
 ### # # # #####
         #     #
################
