################
   #   #     # #
 # # # # ### # #
 # # #   #  G# #
 # ####### ### #
 #     # # #   #
 ##### # # # # #
 #     #   # # #
 # ##### ### ###
 #   #   #     #
#### # ####### #
     # #  S  # #
 ##### ##### # #
       #   #   #
## # ### # ### #
   #     #     #
